Player,Nation,Pos,Squad,Age,Born,90s,Tkl,TklW,Def 3rd,Mid 3rd,Att 3rd,Tkl.1,Att,Tkl%,Lost,Blocks,Sh,Pass,Int,Tkl+Int,Clr,Err,Matches,Season,League
Patrick van Aanholt,nl NED,DF,Crystal Palace,29.0,1990.0,19.7,35,22,18,17,0,19,43,44.2,24,18,6,12,30,65,40,2,Matches,2020-2021,Premier-League
Tammy Abraham,eng ENG,FW,Chelsea,22.0,1997.0,11.6,7,5,3,3,1,1,7,14.3,6,6,0,6,5,12,17,0,Matches,2020-2021,Premier-League
Che Adams,sct SCO,FW,Southampton,24.0,1996.0,29.6,25,16,4,15,6,6,17,35.3,11,20,2,18,4,29,19,1,Matches,2020-2021,Premier-League
Tosin Adarabioyo,eng ENG,DF,Fulham,22.0,1997.0,32.8,37,19,30,6,1,19,40,47.5,21,26,20,6,42,79,197,2,Matches,2020-2021,Premier-League
Adrián,es ESP,GK,Liverpool,33.0,1987.0,3.0,0,0,0,0,0,0,0,,0,0,0,0,0,0,3,1,Matches,2020-2021,Premier-League
Sergio Agüero,ar ARG,FW,Manchester City,32.0,1988.0,6.2,4,1,0,2,2,2,11,18.2,9,2,0,2,2,6,0,0,Matches,2020-2021,Premier-League
Ola Aina,ng NGA,DF,Fulham,23.0,1996.0,29.6,37,20,22,7,8,21,43,48.8,22,22,6,16,45,82,94,2,Matches,2020-2021,Premier-League
Rayan Aït-Nouri,dz ALG,DF,Wolves,19.0,2001.0,15.6,29,16,18,10,1,13,27,48.1,14,14,1,13,15,44,25,0,Matches,2020-2021,Premier-League
Semi Ajayi,ng NGA,DF,West Brom,26.0,1993.0,30.9,40,14,34,6,0,23,41,56.1,18,51,32,19,42,82,122,2,Matches,2020-2021,Premier-League
Nathan Aké,nl NED,DF,Manchester City,25.0,1995.0,8.9,10,5,3,6,1,3,4,75.0,1,2,1,1,9,19,23,0,Matches,2020-2021,Premier-League
Marc Albrighton,eng ENG,"DF,FW",Leicester City,30.0,1989.0,19.4,33,19,14,15,4,16,45,35.6,29,29,3,26,17,50,27,1,Matches,2020-2021,Premier-League
Thiago Alcántara,es ESP,MF,Liverpool,29.0,1991.0,20.6,61,36,20,30,11,17,49,34.7,32,26,0,26,30,91,14,0,Matches,2020-2021,Premier-League
Toby Alderweireld,be BEL,DF,Tottenham,31.0,1989.0,24.9,35,22,22,11,2,18,30,60.0,12,40,28,12,10,45,121,0,Matches,2020-2021,Premier-League
Rúnar Alex Rúnarsson,is ISL,GK,Arsenal,25.0,1995.0,0.2,0,0,0,0,0,0,0,,0,0,0,0,0,0,0,0,Matches,2020-2021,Premier-League
Trent Alexander-Arnold,eng ENG,DF,Liverpool,21.0,1998.0,33.7,56,33,31,18,7,36,56,64.3,20,24,3,21,49,105,50,3,Matches,2020-2021,Premier-League
Ezgjan Alioski,mk MKD,"DF,MF",Leeds United,28.0,1992.0,27.3,74,31,38,28,8,32,74,43.2,42,17,2,15,23,97,50,2,Matches,2020-2021,Premier-League
Alisson,br BRA,GK,Liverpool,27.0,1992.0,33.0,3,2,3,0,0,3,4,75.0,1,0,0,0,2,5,26,7,Matches,2020-2021,Premier-League
Allan,br BRA,MF,Everton,29.0,1991.0,22.8,80,45,39,37,4,28,95,29.5,67,31,12,19,19,99,25,1,Matches,2020-2021,Premier-League
Dele Alli,eng ENG,MF,Tottenham,24.0,1996.0,6.9,18,11,8,6,4,7,19,36.8,12,9,0,9,7,25,3,0,Matches,2020-2021,Premier-League
Miguel Almirón,py PAR,"MF,FW",Newcastle Utd,26.0,1994.0,27.0,49,29,21,25,3,14,56,25.0,42,23,4,19,25,74,20,1,Matches,2020-2021,Premier-League
Marcos Alonso,es ESP,DF,Chelsea,29.0,1990.0,10.7,13,3,6,4,3,7,14,50.0,7,12,1,11,12,25,30,0,Matches,2020-2021,Premier-League
Steven Alzate,co COL,MF,Brighton,21.0,1998.0,10.0,17,8,10,4,3,6,15,40.0,9,8,1,7,8,25,10,0,Matches,2020-2021,Premier-League
Daniel Amartey,gh GHA,DF,Leicester City,25.0,1994.0,8.0,11,7,6,4,1,8,12,66.7,4,8,4,4,12,23,26,0,Matches,2020-2021,Premier-League
Ethan Ampadu,wls WAL,"DF,MF",Sheffield Utd,19.0,2000.0,23.2,57,36,31,24,2,20,46,43.5,26,40,19,21,49,106,87,3,Matches,2020-2021,Premier-League
Joachim Andersen,dk DEN,DF,Fulham,24.0,1996.0,30.3,33,19,18,11,4,15,28,53.6,13,24,13,11,44,77,151,1,Matches,2020-2021,Premier-League
Elliot Anderson,eng ENG,MF,Newcastle Utd,17.0,2002.0,0.0,0,0,0,0,0,0,0,,0,0,0,0,0,0,0,0,Matches,2020-2021,Premier-League
Felipe Anderson,br BRA,"FW,MF",West Ham,27.0,1993.0,0.0,1,1,0,1,0,0,0,,0,0,0,0,0,1,0,0,Matches,2020-2021,Premier-League
Michail Antonio,jm JAM,FW,West Ham,30.0,1990.0,21.9,7,4,1,5,1,1,7,14.3,6,20,3,17,7,14,7,0,Matches,2020-2021,Premier-League
Alphonse Areola,fr FRA,GK,Fulham,27.0,1993.0,36.0,1,0,1,0,0,1,5,20.0,4,0,0,0,1,2,13,3,Matches,2020-2021,Premier-League
Stuart Armstrong,sct SCO,MF,Southampton,28.0,1992.0,30.7,60,41,19,32,9,27,75,36.0,48,26,1,25,24,84,19,0,Matches,2020-2021,Premier-League
Kepa Arrizabalaga,es ESP,GK,Chelsea,25.0,1994.0,6.5,0,0,0,0,0,0,1,0.0,1,0,0,0,0,0,0,3,Matches,2020-2021,Premier-League
Pierre-Emerick Aubameyang,ga GAB,FW,Arsenal,31.0,1989.0,25.9,12,8,7,4,1,3,20,15.0,17,18,0,18,7,19,17,0,Matches,2020-2021,Premier-League
Serge Aurier,ci CIV,DF,Tottenham,27.0,1992.0,17.8,55,33,33,17,5,15,40,37.5,25,28,5,23,19,74,44,3,Matches,2020-2021,Premier-League
Charlie Austin,eng ENG,"FW,MF",West Brom,31.0,1989.0,1.5,4,2,1,2,1,1,3,33.3,2,0,0,0,3,7,4,0,Matches,2020-2021,Premier-League
Jordan Ayew,gh GHA,"FW,MF",Crystal Palace,28.0,1991.0,23.3,38,26,8,16,14,16,44,36.4,28,28,2,26,16,54,12,0,Matches,2020-2021,Premier-League
Luke Ayling,eng ENG,DF,Leeds United,28.0,1991.0,37.8,108,61,69,30,9,49,87,56.3,38,53,36,17,36,144,96,5,Matches,2020-2021,Premier-League
César Azpilicueta,es ESP,DF,Chelsea,30.0,1989.0,24.3,53,28,22,24,7,19,37,51.4,18,30,5,25,28,81,62,2,Matches,2020-2021,Premier-League
Eric Bailly,ci CIV,DF,Manchester Utd,26.0,1994.0,10.2,5,5,3,1,1,0,1,0.0,1,13,11,2,13,18,36,2,Matches,2020-2021,Premier-League
Fabián Balbuena,py PAR,DF,West Ham,28.0,1991.0,13.3,24,12,23,1,0,14,23,60.9,9,23,6,17,25,49,63,0,Matches,2020-2021,Premier-League
George Baldock,gr GRE,DF,Sheffield Utd,27.0,1993.0,31.0,47,34,28,14,5,21,50,42.0,29,26,7,19,25,72,70,1,Matches,2020-2021,Premier-League
Gareth Bale,wls WAL,FW,Tottenham,31.0,1989.0,10.2,17,10,4,9,4,7,14,50.0,7,13,2,11,8,25,16,0,Matches,2020-2021,Premier-League
Patrick Bamford,eng ENG,FW,Leeds United,26.0,1993.0,33.9,21,9,2,11,8,8,27,29.6,19,14,4,10,10,31,37,0,Matches,2020-2021,Premier-League
Phil Bardsley,sct SCO,DF,Burnley,35.0,1985.0,3.0,6,5,4,2,0,3,6,50.0,3,3,1,2,6,12,12,0,Matches,2020-2021,Premier-League
Ross Barkley,eng ENG,MF,Aston Villa,26.0,1993.0,17.0,6,2,2,4,0,3,15,20.0,12,9,1,8,5,11,6,1,Matches,2020-2021,Premier-League
Ross Barkley,eng ENG,"FW,MF",Chelsea,26.0,1993.0,0.5,0,0,0,0,0,0,0,,0,0,0,0,0,0,0,0,Matches,2020-2021,Premier-League
Ashley Barnes,eng ENG,FW,Burnley,30.0,1989.0,14.8,12,6,2,6,4,3,13,23.1,10,14,2,12,5,17,11,0,Matches,2020-2021,Premier-League
Harvey Barnes,eng ENG,"FW,MF",Leicester City,22.0,1997.0,21.6,19,9,11,3,5,5,22,22.7,17,16,3,13,8,27,11,0,Matches,2020-2021,Premier-League
Kyle Bartley,eng ENG,DF,West Brom,29.0,1991.0,28.7,27,16,14,10,3,11,23,47.8,12,50,35,15,38,65,159,1,Matches,2020-2021,Premier-League
Chris Basham,eng ENG,"DF,MF",Sheffield Utd,32.0,1988.0,28.6,69,42,41,23,5,41,67,61.2,26,36,15,21,49,118,105,1,Matches,2020-2021,Premier-League
Michy Batshuayi,be BEL,FW,Crystal Palace,26.0,1993.0,8.1,5,3,1,2,2,1,9,11.1,8,5,1,4,4,9,5,0,Matches,2020-2021,Premier-League
Jan Bednarek,pl POL,DF,Southampton,24.0,1996.0,34.4,37,19,25,11,1,25,49,51.0,24,44,27,17,84,121,132,0,Matches,2020-2021,Premier-League
Donny van de Beek,nl NED,"MF,FW",Manchester Utd,23.0,1997.0,5.8,15,10,2,11,2,7,15,46.7,8,10,1,9,6,21,7,0,Matches,2020-2021,Premier-League
Héctor Bellerín,es ESP,"DF,MF",Arsenal,25.0,1995.0,23.2,29,19,14,12,3,12,41,29.3,29,26,8,18,33,62,33,0,Matches,2020-2021,Premier-League
Saïd Benrahma,dz ALG,"FW,MF",West Ham,24.0,1995.0,15.5,24,15,8,11,5,8,28,28.6,20,10,0,10,8,32,8,0,Matches,2020-2021,Premier-League
Josh Benson,eng ENG,MF,Burnley,20.0,1999.0,2.9,5,1,3,0,2,1,6,16.7,5,3,0,3,3,8,2,0,Matches,2020-2021,Premier-League
Christian Benteke,be BEL,FW,Crystal Palace,29.0,1990.0,20.2,15,7,1,7,7,2,9,22.2,7,17,6,11,4,19,39,0,Matches,2020-2021,Premier-League
Gaetano Berardi,ch SUI,DF,Leeds United,31.0,1988.0,1.3,2,2,1,0,1,0,0,,0,2,1,1,1,3,2,0,Matches,2020-2021,Premier-League
Jóhann Berg Guðmundsson,is ISL,MF,Burnley,29.0,1990.0,15.1,19,11,6,9,4,11,23,47.8,12,11,2,9,17,36,19,0,Matches,2020-2021,Premier-League
Sander Berge,no NOR,MF,Sheffield Utd,22.0,1998.0,12.4,16,7,8,5,3,7,15,46.7,8,11,2,9,4,20,18,0,Matches,2020-2021,Premier-League
Steven Bergwijn,nl NED,"FW,MF",Tottenham,22.0,1997.0,13.4,15,7,8,3,4,7,20,35.0,13,7,1,6,5,20,9,0,Matches,2020-2021,Premier-League
Bernard,br BRA,"MF,FW",Everton,27.0,1992.0,5.1,8,3,3,3,2,7,15,46.7,8,5,0,5,8,16,6,0,Matches,2020-2021,Premier-League
Bernardo,br BRA,"DF,MF",Brighton,25.0,1995.0,2.3,10,8,8,1,1,4,6,66.7,2,2,0,2,1,11,1,0,Matches,2020-2021,Premier-League
Ryan Bertrand,eng ENG,DF,Southampton,30.0,1989.0,28.9,60,32,26,27,7,30,48,62.5,18,19,1,18,30,90,41,1,Matches,2020-2021,Premier-League
Yves Bissouma,ml MLI,MF,Brighton,23.0,1996.0,34.6,104,68,50,48,6,33,67,49.3,34,42,6,36,64,168,67,0,Matches,2020-2021,Premier-League
Jayden Bogle,eng ENG,"DF,MF",Sheffield Utd,20.0,2000.0,12.3,33,23,21,10,2,20,39,51.3,19,14,4,10,14,47,22,0,Matches,2020-2021,Premier-League
Willy Boly,ci CIV,DF,Wolves,29.0,1991.0,20.9,33,20,26,7,0,13,24,54.2,11,18,12,6,32,65,84,1,Matches,2020-2021,Premier-League
Jarrod Bowen,eng ENG,"FW,MF",West Ham,23.0,1996.0,28.5,26,15,12,7,7,10,29,34.5,19,19,1,18,22,48,10,0,Matches,2020-2021,Premier-League
Robbie Brady,ie IRL,MF,Burnley,28.0,1992.0,11.7,22,15,12,6,4,12,35,34.3,23,16,0,16,9,31,29,1,Matches,2020-2021,Premier-League
Rhian Brewster,eng ENG,"FW,MF",Sheffield Utd,20.0,2000.0,12.5,8,5,1,4,3,1,13,7.7,12,15,2,13,5,13,5,0,Matches,2020-2021,Premier-League
Nathan Broadhead,wls WAL,FW,Everton,22.0,1998.0,0.0,1,1,0,1,0,0,0,,0,0,0,0,0,1,0,0,Matches,2020-2021,Premier-League
Josh Brownhill,eng ENG,MF,Burnley,24.0,1995.0,31.3,45,27,9,29,7,15,44,34.1,29,33,11,22,69,114,39,0,Matches,2020-2021,Premier-League
Joe Bryan,eng ENG,"DF,MF",Fulham,26.0,1993.0,7.4,15,8,7,5,3,7,12,58.3,5,8,2,6,14,29,16,0,Matches,2020-2021,Premier-League
Kean Bryan,eng ENG,DF,Sheffield Utd,23.0,1996.0,11.2,20,10,9,11,0,9,19,47.4,10,16,10,6,13,33,39,1,Matches,2020-2021,Premier-League
Oliver Burke,sct SCO,FW,Sheffield Utd,23.0,1997.0,14.1,16,8,6,9,1,5,24,20.8,19,24,0,24,2,18,6,0,Matches,2020-2021,Premier-League
Dan Burn,eng ENG,DF,Brighton,28.0,1992.0,22.9,50,26,33,14,3,27,53,50.9,26,30,7,23,31,81,75,0,Matches,2020-2021,Premier-League
Jack Butland,eng ENG,GK,Crystal Palace,27.0,1993.0,1.0,0,0,0,0,0,0,0,,0,0,0,0,0,0,0,0,Matches,2020-2021,Premier-League
David Button,eng ENG,GK,West Brom,31.0,1989.0,1.0,0,0,0,0,0,0,0,,0,0,0,0,0,0,0,0,Matches,2020-2021,Premier-League
Oskar Buur,dk DEN,DF,Wolves,22.0,1998.0,0.2,0,0,0,0,0,0,2,0.0,2,0,0,0,0,0,0,0,Matches,2020-2021,Premier-League
Willy Caballero,ar ARG,GK,Chelsea,38.0,1981.0,1.0,0,0,0,0,0,0,0,,0,0,0,0,0,0,0,0,Matches,2020-2021,Premier-League
Gary Cahill,eng ENG,DF,Crystal Palace,34.0,1985.0,20.0,13,9,10,3,0,7,11,63.6,4,27,22,5,13,26,88,0,Matches,2020-2021,Premier-League
Tom Cairney,sct SCO,MF,Fulham,29.0,1991.0,8.4,9,3,1,4,4,1,4,25.0,3,6,0,6,0,9,3,0,Matches,2020-2021,Premier-League
Dominic Calvert-Lewin,eng ENG,FW,Everton,23.0,1997.0,31.9,17,8,1,8,8,6,12,50.0,6,22,6,16,6,23,33,0,Matches,2020-2021,Premier-League
João Cancelo,pt POR,"DF,MF",Manchester City,26.0,1994.0,25.5,68,41,42,19,7,43,83,51.8,40,23,2,21,41,109,33,2,Matches,2020-2021,Premier-League
Andy Carroll,eng ENG,FW,Newcastle Utd,31.0,1989.0,4.4,3,1,1,1,1,1,8,12.5,7,1,0,1,0,3,14,0,Matches,2020-2021,Premier-League
Scott Carson,eng ENG,GK,Manchester City,34.0,1985.0,1.0,0,0,0,0,0,0,0,,0,0,0,0,0,0,0,0,Matches,2020-2021,Premier-League
Fabio Carvalho,pt POR,"MF,FW",Fulham,17.0,2002.0,2.8,9,6,4,4,1,5,9,55.6,4,2,0,2,1,10,1,1,Matches,2020-2021,Premier-League
Matty Cash,pl POL,DF,Aston Villa,22.0,1997.0,26.4,71,40,43,22,6,41,74,55.4,33,50,11,39,60,131,95,0,Matches,2020-2021,Premier-League
Kiko Casilla,es ESP,GK,Leeds United,33.0,1986.0,3.0,0,0,0,0,0,0,0,,0,0,0,0,0,0,0,0,Matches,2020-2021,Premier-League
Timothy Castagne,be BEL,DF,Leicester City,24.0,1995.0,26.1,52,32,29,18,5,24,44,54.5,20,29,5,24,29,81,62,1,Matches,2020-2021,Premier-League
Jonny Castro,es ESP,"MF,DF",Wolves,26.0,1994.0,5.5,11,5,6,4,1,6,13,46.2,7,9,3,6,9,20,7,0,Matches,2020-2021,Premier-League
Ivan Cavaleiro,pt POR,FW,Fulham,26.0,1993.0,27.5,23,14,9,11,3,12,34,35.3,22,25,1,24,19,42,14,0,Matches,2020-2021,Premier-League
Edinson Cavani,uy URU,FW,Manchester Utd,33.0,1987.0,15.3,12,8,1,8,3,2,13,15.4,11,2,0,2,6,18,11,0,Matches,2020-2021,Premier-League
Dani Ceballos,es ESP,MF,Arsenal,23.0,1996.0,17.9,37,22,20,11,6,21,51,41.2,30,23,6,17,35,72,14,1,Matches,2020-2021,Premier-League
Calum Chambers,eng ENG,DF,Arsenal,25.0,1995.0,8.4,7,3,3,2,2,3,8,37.5,5,6,2,4,10,17,37,0,Matches,2020-2021,Premier-League
Ben Chilwell,eng ENG,DF,Chelsea,23.0,1996.0,25.4,42,22,16,22,4,15,33,45.5,18,28,3,25,24,66,58,0,Matches,2020-2021,Premier-League
Hamza Choudhury,bd BAN,MF,Leicester City,22.0,1997.0,3.5,8,7,3,5,0,4,10,40.0,6,4,1,3,4,12,9,1,Matches,2020-2021,Premier-League
Andreas Christensen,dk DEN,DF,Chelsea,24.0,1996.0,15.2,11,6,8,3,0,0,8,0.0,8,19,14,5,20,31,51,1,Matches,2020-2021,Premier-League
Carney Chukwuemeka,eng ENG,"MF,FW",Aston Villa,16.0,2003.0,0.2,2,2,1,0,1,1,3,33.3,2,0,0,0,0,2,0,0,Matches,2020-2021,Premier-League
Ciaran Clark,ie IRL,DF,Newcastle Utd,30.0,1989.0,21.0,24,14,15,6,3,6,13,46.2,7,27,20,7,29,53,104,1,Matches,2020-2021,Premier-League
Nathaniel Clyne,eng ENG,DF,Crystal Palace,29.0,1991.0,12.7,17,10,8,8,1,9,16,56.3,7,7,2,5,18,35,25,1,Matches,2020-2021,Premier-League
Conor Coady,eng ENG,DF,Wolves,27.0,1993.0,36.7,35,23,25,10,0,19,35,54.3,16,40,32,8,27,62,134,2,Matches,2020-2021,Premier-League
Séamus Coleman,ie IRL,"DF,MF",Everton,31.0,1988.0,17.9,39,26,21,14,4,21,30,70.0,9,22,6,16,13,52,37,2,Matches,2020-2021,Premier-League
Aaron Connolly,ie IRL,FW,Brighton,20.0,2000.0,8.8,6,3,1,3,2,0,2,0.0,2,4,0,4,0,6,2,0,Matches,2020-2021,Premier-League
Liam Cooper,sct SCO,DF,Leeds United,28.0,1991.0,24.3,68,45,39,27,2,37,59,62.7,22,39,32,7,61,129,70,1,Matches,2020-2021,Premier-League
Theo Corbeanu,ca CAN,FW,Wolves,18.0,2002.0,0.1,2,1,0,2,0,1,1,100.0,0,0,0,0,1,3,0,0,Matches,2020-2021,Premier-League
Jack Cork,eng ENG,MF,Burnley,31.0,1989.0,15.0,26,10,5,17,4,11,31,35.5,20,15,4,11,16,42,20,0,Matches,2020-2021,Premier-League
Hélder Costa,ao ANG,"MF,FW",Leeds United,26.0,1994.0,12.8,25,11,12,5,8,11,32,34.4,21,11,0,11,3,28,5,1,Matches,2020-2021,Premier-League
Vladimír Coufal,cz CZE,DF,West Ham,27.0,1992.0,33.9,73,36,50,15,8,52,89,58.4,37,41,7,34,41,114,102,1,Matches,2020-2021,Premier-League
Aaron Cresswell,eng ENG,DF,West Ham,30.0,1989.0,35.2,32,13,15,15,2,18,32,56.3,14,29,14,15,32,64,79,2,Matches,2020-2021,Premier-League
Patrick Cutrone,it ITA,FW,Wolves,22.0,1998.0,0.3,0,0,0,0,0,0,0,,0,0,0,0,0,0,0,0,Matches,2020-2021,Premier-League
Stuart Dallas,nir NIR,"MF,DF",Leeds United,29.0,1991.0,37.9,74,45,46,22,6,30,88,34.1,58,41,3,38,44,118,52,1,Matches,2020-2021,Premier-League
Scott Dann,eng ENG,DF,Crystal Palace,33.0,1987.0,15.0,6,4,5,1,0,4,11,36.4,7,16,14,2,18,24,59,1,Matches,2020-2021,Premier-League
Karl Darlow,wls WAL,GK,Newcastle Utd,29.0,1990.0,25.0,0,0,0,0,0,0,0,,0,0,0,0,0,0,17,0,Matches,2020-2021,Premier-League
Ben Davies,wls WAL,DF,Tottenham,27.0,1993.0,15.0,27,17,10,11,6,13,30,43.3,17,10,5,5,18,45,49,2,Matches,2020-2021,Premier-League
Tom Davies,eng ENG,MF,Everton,22.0,1998.0,15.8,31,18,17,12,2,16,39,41.0,23,15,9,6,34,65,21,2,Matches,2020-2021,Premier-League
Keinan Davis,eng ENG,"FW,MF",Aston Villa,22.0,1998.0,3.1,2,1,1,0,1,0,1,0.0,1,1,0,1,0,2,2,0,Matches,2020-2021,Premier-League
Leif Davis,eng ENG,DF,Leeds United,20.0,2000.0,0.4,0,0,0,0,0,0,3,0.0,3,1,0,1,1,1,0,0,Matches,2020-2021,Premier-League
Craig Dawson,eng ENG,DF,West Ham,30.0,1990.0,21.4,11,8,7,4,0,5,12,41.7,7,26,22,4,32,43,88,3,Matches,2020-2021,Premier-League
Kevin De Bruyne,be BEL,MF,Manchester City,29.0,1991.0,22.2,34,21,6,18,10,13,48,27.1,35,26,1,25,9,43,10,0,Matches,2020-2021,Premier-League
Bobby De Cordova-Reid,jm JAM,"MF,FW",Fulham,27.0,1993.0,26.4,31,15,17,10,4,18,39,46.2,21,19,5,14,21,52,39,0,Matches,2020-2021,Premier-League
Liam Delap,eng ENG,FW,Manchester City,17.0,2003.0,0.4,0,0,0,0,0,0,0,,0,0,0,0,0,0,0,0,Matches,2020-2021,Premier-League
Fabian Delph,eng ENG,"MF,DF",Everton,30.0,1989.0,3.0,5,2,3,2,0,1,3,33.3,2,2,0,2,4,9,8,1,Matches,2020-2021,Premier-League
Leander Dendoncker,be BEL,"MF,DF",Wolves,25.0,1995.0,27.8,54,29,29,22,3,31,60,51.7,29,38,15,23,27,81,52,2,Matches,2020-2021,Premier-League
Mbaye Diagne,sn SEN,FW,West Brom,28.0,1991.0,13.2,4,3,3,0,1,1,4,25.0,3,2,1,1,1,5,16,0,Matches,2020-2021,Premier-League
Amad Diallo,ci CIV,FW,Manchester Utd,18.0,2002.0,1.8,3,3,1,2,0,0,0,,0,2,1,1,0,3,1,0,Matches,2020-2021,Premier-League
Ibrahima Diallo,fr FRA,MF,Southampton,21.0,1999.0,11.3,29,16,11,17,1,9,16,56.3,7,10,1,9,10,39,12,2,Matches,2020-2021,Premier-League
Grady Diangana,cd COD,"MF,FW",West Brom,22.0,1998.0,13.7,35,19,19,9,7,19,43,44.2,24,16,2,14,16,51,9,0,Matches,2020-2021,Premier-League
Rúben Dias,pt POR,DF,Manchester City,23.0,1997.0,31.6,24,13,13,8,3,4,16,25.0,12,31,23,8,35,59,92,0,Matches,2020-2021,Premier-League
Eric Dier,eng ENG,DF,Tottenham,26.0,1994.0,28.0,23,14,13,10,0,11,18,61.1,7,37,31,6,23,46,123,3,Matches,2020-2021,Premier-League
Lucas Digne,fr FRA,"DF,MF",Everton,27.0,1993.0,29.8,63,38,40,16,7,29,54,53.7,25,42,4,38,31,94,87,0,Matches,2020-2021,Premier-League
Issa Diop,fr FRA,DF,West Ham,23.0,1997.0,15.3,20,14,12,8,0,7,18,38.9,11,32,22,10,22,42,59,0,Matches,2020-2021,Premier-League
Moussa Djenepo,ml MLI,MF,Southampton,22.0,1998.0,13.8,52,27,27,17,8,28,63,44.4,35,24,2,22,10,62,14,0,Matches,2020-2021,Premier-League
Matt Doherty,ie IRL,DF,Tottenham,28.0,1992.0,13.8,29,15,15,10,4,13,33,39.4,20,20,5,15,23,52,46,0,Matches,2020-2021,Premier-League
Abdoulaye Doucouré,ml MLI,MF,Everton,27.0,1993.0,27.1,52,32,25,19,8,14,43,32.6,29,24,7,17,39,91,31,1,Matches,2020-2021,Premier-League
Martin Dúbravka,sk SVK,GK,Newcastle Utd,31.0,1989.0,13.0,0,0,0,0,0,0,0,,0,0,0,0,0,0,3,0,Matches,2020-2021,Premier-League
Paul Dummett,wls WAL,DF,Newcastle Utd,28.0,1991.0,13.9,16,7,11,5,0,13,21,61.9,8,12,7,5,16,32,74,0,Matches,2020-2021,Premier-League
Lewis Dunk,eng ENG,DF,Brighton,28.0,1991.0,32.6,30,15,20,8,2,16,23,69.6,7,29,20,9,32,62,106,0,Matches,2020-2021,Premier-League
Jimmy Dunne,ie IRL,DF,Burnley,22.0,1997.0,3.0,3,3,2,1,0,1,2,50.0,1,3,2,1,6,9,16,1,Matches,2020-2021,Premier-League
Ederson,br BRA,GK,Manchester City,26.0,1993.0,36.0,3,1,3,0,0,3,4,75.0,1,0,0,0,0,3,11,4,Matches,2020-2021,Premier-League
Kyle Edwards,eng ENG,"MF,FW",West Brom,22.0,1998.0,1.3,3,2,1,1,1,0,0,,0,2,0,2,1,4,0,0,Matches,2020-2021,Premier-League
John Egan,ie IRL,DF,Sheffield Utd,27.0,1992.0,29.2,41,21,29,12,0,22,39,56.4,17,43,31,12,41,82,131,0,Matches,2020-2021,Premier-League
Anthony Elanga,se SWE,FW,Manchester Utd,18.0,2002.0,1.7,4,2,3,1,0,4,5,80.0,1,1,1,0,1,5,1,0,Matches,2020-2021,Premier-League
Ahmed Elmohamady,eg EGY,DF,Aston Villa,32.0,1987.0,9.3,17,13,12,4,1,9,14,64.3,5,6,3,3,17,34,26,0,Matches,2020-2021,Premier-League
Mohamed Elneny,eg EGY,MF,Arsenal,28.0,1992.0,17.2,14,6,7,7,0,7,28,25.0,21,11,4,7,24,38,20,2,Matches,2020-2021,Premier-League
Jonny Evans,nir NIR,DF,Leicester City,32.0,1988.0,27.5,25,12,22,2,1,14,20,70.0,6,8,3,5,46,71,98,1,Matches,2020-2021,Premier-League
Eberechi Eze,eng ENG,MF,Crystal Palace,22.0,1998.0,28.4,27,14,11,13,3,16,35,45.7,19,19,3,16,24,51,9,1,Matches,2020-2021,Premier-League
Łukasz Fabiański,pl POL,GK,West Ham,35.0,1985.0,35.0,1,0,1,0,0,1,1,100.0,0,1,0,1,1,2,12,3,Matches,2020-2021,Premier-League
Fabinho,br BRA,"DF,MF",Liverpool,26.0,1993.0,28.5,58,31,21,29,8,27,54,50.0,27,28,10,18,44,102,66,1,Matches,2020-2021,Premier-League
Bruno Fernandes,pt POR,MF,Manchester Utd,25.0,1994.0,34.4,57,30,16,29,12,26,100,26.0,74,38,0,38,26,83,29,0,Matches,2020-2021,Premier-League
Federico Fernández,ar ARG,DF,Newcastle Utd,31.0,1989.0,23.1,29,22,23,5,1,17,21,81.0,4,41,31,10,17,46,147,0,Matches,2020-2021,Premier-League
Fernandinho,br BRA,MF,Manchester City,35.0,1985.0,13.2,31,17,8,14,9,20,43,46.5,23,11,2,9,23,54,17,0,Matches,2020-2021,Premier-League
Sam Field,eng ENG,MF,West Brom,22.0,1998.0,0.7,5,5,3,2,0,0,0,,0,4,1,3,2,7,4,0,Matches,2020-2021,Premier-League
Roberto Firmino,br BRA,FW,Liverpool,28.0,1991.0,31.5,33,15,3,17,13,6,32,18.8,26,42,5,37,11,44,12,0,Matches,2020-2021,Premier-League
Will Fish,eng ENG,FW,Manchester Utd,17.0,2003.0,0.0,0,0,0,0,0,0,0,,0,0,0,0,0,0,0,0,Matches,2020-2021,Premier-League
John Fleck,sct SCO,MF,Sheffield Utd,28.0,1991.0,28.6,51,33,28,18,5,26,83,31.3,57,26,4,22,28,79,12,1,Matches,2020-2021,Premier-League
Phil Foden,eng ENG,"FW,MF",Manchester City,20.0,2000.0,18.0,22,11,12,8,2,9,23,39.1,14,9,0,9,11,33,11,0,Matches,2020-2021,Premier-League
Wesley Fofana,fr FRA,DF,Leicester City,19.0,2000.0,25.1,51,37,27,22,2,31,46,67.4,15,28,16,12,61,112,94,0,Matches,2020-2021,Premier-League
Pablo Fornals,es ESP,"FW,MF",West Ham,24.0,1996.0,28.6,44,26,14,24,6,11,73,15.1,62,43,1,42,36,80,9,0,Matches,2020-2021,Premier-League
Fraser Forster,eng ENG,GK,Southampton,32.0,1988.0,8.0,1,0,1,0,0,1,2,50.0,1,0,0,0,0,1,9,0,Matches,2020-2021,Premier-League
Timothy Fosu-Mensah,nl NED,DF,Manchester Utd,22.0,1998.0,0.9,2,0,1,1,0,1,1,100.0,0,0,0,0,3,5,1,0,Matches,2020-2021,Premier-League
Tyrese Francois,au AUS,DF,Fulham,20.0,2000.0,0.2,0,0,0,0,0,0,0,,0,0,0,0,0,0,0,0,Matches,2020-2021,Premier-League
Ryan Fraser,sct SCO,"FW,MF",Newcastle Utd,26.0,1994.0,10.3,4,1,3,1,0,2,5,40.0,3,1,0,1,6,10,7,0,Matches,2020-2021,Premier-League
Fred,br BRA,MF,Manchester Utd,27.0,1993.0,26.6,81,39,39,38,4,29,89,32.6,60,49,9,40,45,126,26,1,Matches,2020-2021,Premier-League
Ryan Fredericks,eng ENG,"DF,FW",West Ham,27.0,1992.0,6.3,9,5,5,4,0,3,7,42.9,4,6,2,4,11,20,20,0,Matches,2020-2021,Premier-League
Christian Fuchs,at AUT,DF,Leicester City,34.0,1986.0,7.8,18,7,15,2,1,8,15,53.3,7,6,4,2,16,34,34,1,Matches,2020-2021,Premier-League
Darnell Furlong,eng ENG,DF,West Brom,24.0,1995.0,32.6,45,27,27,12,6,21,44,47.7,23,39,16,23,49,94,90,0,Matches,2020-2021,Premier-League
Conor Gallagher,eng ENG,MF,West Brom,20.0,2000.0,28.1,81,41,30,39,12,29,97,29.9,68,47,8,39,27,108,31,0,Matches,2020-2021,Premier-League
Eric García,es ESP,DF,Manchester City,19.0,2001.0,4.3,8,7,5,3,0,5,7,71.4,2,4,1,3,4,12,10,0,Matches,2020-2021,Premier-League
Dwight Gayle,eng ENG,"FW,MF",Newcastle Utd,29.0,1990.0,5.7,2,0,1,1,0,0,7,0.0,7,3,1,2,1,3,2,0,Matches,2020-2021,Premier-League
Jean-Philippe Gbamin,ci CIV,MF,Everton,24.0,1995.0,0.1,1,0,0,1,0,0,0,,0,1,0,1,0,1,1,0,Matches,2020-2021,Premier-League
David de Gea,es ESP,GK,Manchester Utd,29.0,1990.0,25.5,0,0,0,0,0,0,0,,0,0,0,0,0,0,8,3,Matches,2020-2021,Premier-League
Anwar El Ghazi,nl NED,FW,Aston Villa,25.0,1995.0,17.9,16,13,6,7,3,7,23,30.4,16,11,0,11,6,22,11,0,Matches,2020-2021,Premier-League
Kieran Gibbs,eng ENG,DF,West Brom,30.0,1989.0,9.0,15,11,11,3,1,8,10,80.0,2,8,6,2,16,31,30,1,Matches,2020-2021,Premier-League
Morgan Gibbs-White,eng ENG,"MF,FW",Wolves,20.0,2000.0,4.6,9,7,3,4,2,5,12,41.7,7,6,0,6,3,12,1,0,Matches,2020-2021,Premier-League
Billy Gilmour,sct SCO,MF,Chelsea,19.0,2001.0,2.9,4,2,1,2,1,2,7,28.6,5,3,2,1,3,7,1,0,Matches,2020-2021,Premier-League
Olivier Giroud,fr FRA,FW,Chelsea,33.0,1986.0,8.3,4,2,0,1,3,1,7,14.3,6,4,1,3,5,9,10,0,Matches,2020-2021,Premier-League
Ben Godfrey,eng ENG,DF,Everton,22.0,1998.0,29.8,55,33,37,15,3,27,41,65.9,14,56,37,19,33,88,120,0,Matches,2020-2021,Premier-League
André Gomes,pt POR,MF,Everton,27.0,1993.0,17.4,35,23,16,16,3,17,58,29.3,41,19,1,18,10,45,12,1,Matches,2020-2021,Premier-League
Joe Gomez,eng ENG,DF,Liverpool,23.0,1997.0,6.6,3,2,1,1,1,0,4,0.0,4,3,2,1,4,7,29,0,Matches,2020-2021,Premier-League
Anthony Gordon,eng ENG,"FW,MF",Everton,19.0,2001.0,1.0,3,3,3,0,0,0,2,0.0,2,1,0,1,1,4,3,0,Matches,2020-2021,Premier-League
Karlan Grant,eng ENG,"FW,MF",West Brom,22.0,1997.0,12.5,5,3,3,2,0,2,4,50.0,2,7,0,7,5,10,17,0,Matches,2020-2021,Premier-League
Demarai Gray,jm JAM,FW,Leicester City,24.0,1996.0,0.2,1,1,1,0,0,0,0,,0,0,0,0,0,1,0,0,Matches,2020-2021,Premier-League
Jack Grealish,eng ENG,"FW,MF",Aston Villa,24.0,1995.0,24.3,31,14,8,16,7,15,24,62.5,9,20,3,17,12,43,5,3,Matches,2020-2021,Premier-League
Mason Greenwood,eng ENG,FW,Manchester Utd,18.0,2001.0,20.2,13,10,6,4,3,5,22,22.7,17,9,0,9,5,18,1,0,Matches,2020-2021,Premier-League
Pascal Groß,de GER,"MF,DF",Brighton,29.0,1991.0,27.6,45,24,24,15,6,24,53,45.3,29,25,4,21,23,68,18,1,Matches,2020-2021,Premier-League
Kamil Grosicki,pl POL,"MF,FW",West Brom,32.0,1988.0,1.6,2,1,2,0,0,2,8,25.0,6,1,0,1,2,4,1,0,Matches,2020-2021,Premier-League
Vicente Guaita,es ESP,GK,Crystal Palace,33.0,1987.0,37.0,1,1,1,0,0,1,1,100.0,0,0,0,0,1,2,11,1,Matches,2020-2021,Premier-League
İlkay Gündoğan,de GER,MF,Manchester City,29.0,1990.0,22.5,25,15,8,12,5,10,39,25.6,29,13,4,9,20,45,9,0,Matches,2020-2021,Premier-League
Antwoine Hackford,eng ENG,DF,Sheffield Utd,16.0,2004.0,0.1,0,0,0,0,0,0,0,,0,0,0,0,0,0,0,0,Matches,2020-2021,Premier-League
Sébastien Haller,ci CIV,FW,West Ham,26.0,1994.0,10.4,14,9,1,6,7,4,20,20.0,16,7,1,6,5,19,7,0,Matches,2020-2021,Premier-League
Rekeem Harper,eng ENG,MF,West Brom,20.0,2000.0,0.4,0,0,0,0,0,0,0,,0,2,0,2,1,1,0,0,Matches,2020-2021,Premier-League
Jack Harrison,eng ENG,"MF,FW",Leeds United,23.0,1996.0,31.6,63,38,20,30,13,26,59,44.1,33,30,2,28,15,78,21,0,Matches,2020-2021,Premier-League
Kortney Hause,eng ENG,DF,Aston Villa,25.0,1995.0,7.0,4,2,3,1,0,0,3,0.0,3,4,2,2,8,12,53,0,Matches,2020-2021,Premier-League
Kai Havertz,de GER,"MF,FW",Chelsea,21.0,1999.0,16.9,18,9,6,10,2,6,27,22.2,21,25,0,25,4,22,22,1,Matches,2020-2021,Premier-League
Isaac Hayden,eng ENG,"MF,DF",Newcastle Utd,25.0,1995.0,21.6,52,29,23,22,7,14,35,40.0,21,32,9,23,43,95,47,0,Matches,2020-2021,Premier-League
Michael Hector,jm JAM,DF,Fulham,28.0,1992.0,2.9,3,2,1,2,0,1,6,16.7,5,4,2,2,0,3,6,0,Matches,2020-2021,Premier-League
Ahmed Hegazi,eg EGY,DF,West Brom,29.0,1991.0,1.0,0,0,0,0,0,0,0,,0,2,0,2,1,1,7,0,Matches,2020-2021,Premier-League
Dean Henderson,eng ENG,GK,Manchester Utd,23.0,1997.0,12.5,1,1,1,0,0,1,2,50.0,1,0,0,0,0,1,3,2,Matches,2020-2021,Premier-League
Jordan Henderson,eng ENG,"MF,DF",Liverpool,30.0,1990.0,18.9,24,15,12,9,3,10,26,38.5,16,12,1,11,34,58,30,0,Matches,2020-2021,Premier-League
Jeff Hendrick,ie IRL,MF,Newcastle Utd,28.0,1992.0,15.8,8,3,5,3,0,1,13,7.7,12,14,9,5,19,27,18,0,Matches,2020-2021,Premier-League
Pablo Hernández,es ESP,MF,Leeds United,35.0,1985.0,4.7,5,3,2,1,2,5,16,31.3,11,2,0,2,0,5,0,1,Matches,2020-2021,Premier-League
Son Heung-min,kr KOR,FW,Tottenham,28.0,1992.0,34.6,32,18,11,14,7,18,72,25.0,54,28,3,25,14,46,8,0,Matches,2020-2021,Premier-League
Ki-Jana Hoever,nl NED,"DF,MF",Wolves,18.0,2002.0,6.4,14,6,11,2,1,10,22,45.5,12,2,0,2,9,23,23,0,Matches,2020-2021,Premier-League
Rob Holding,eng ENG,DF,Arsenal,24.0,1995.0,28.4,43,20,28,13,2,17,35,48.6,18,37,27,10,24,67,120,0,Matches,2020-2021,Premier-League
Mason Holgate,eng ENG,DF,Everton,23.0,1996.0,25.4,56,36,31,18,7,20,50,40.0,30,37,13,24,35,91,90,3,Matches,2020-2021,Premier-League
Conor Hourihane,ie IRL,MF,Aston Villa,29.0,1991.0,2.5,0,0,0,0,0,0,2,0.0,2,3,0,3,0,0,2,0,Matches,2020-2021,Premier-League
Callum Hudson-Odoi,eng ENG,"FW,DF",Chelsea,19.0,2000.0,11.8,23,15,11,7,5,8,21,38.1,13,15,1,14,6,29,6,0,Matches,2020-2021,Premier-League
Niall Huggins,wls WAL,DF,Leeds United,19.0,2000.0,0.4,0,0,0,0,0,0,1,0.0,1,0,0,0,0,0,1,0,Matches,2020-2021,Premier-League
Pierre Højbjerg,dk DEN,MF,Tottenham,24.0,1995.0,38.0,98,51,45,42,11,54,129,41.9,75,51,9,42,48,146,66,0,Matches,2020-2021,Premier-League
Odion Ighalo,ng NGA,FW,Manchester Utd,31.0,1989.0,0.1,0,0,0,0,0,0,1,0.0,1,0,0,0,0,0,0,0,Matches,2020-2021,Premier-League
Kelechi Iheanacho,ng NGA,FW,Leicester City,23.0,1996.0,16.2,12,5,2,4,6,4,17,23.5,13,14,0,14,2,14,1,1,Matches,2020-2021,Premier-League
Danny Ings,eng ENG,FW,Southampton,28.0,1992.0,24.1,22,13,3,16,3,12,28,42.9,16,39,2,37,3,25,27,1,Matches,2020-2021,Premier-League
Branislav Ivanović,rs SRB,DF,West Brom,36.0,1984.0,8.5,14,5,11,3,0,7,13,53.8,6,11,5,6,8,22,25,0,Matches,2020-2021,Premier-League
Alex Iwobi,ng NGA,"FW,MF",Everton,24.0,1996.0,17.1,27,10,10,14,3,13,25,52.0,12,20,1,19,16,43,14,0,Matches,2020-2021,Premier-League
José Izquierdo,co COL,DF,Brighton,28.0,1992.0,0.1,0,0,0,0,0,0,0,,0,0,0,0,0,0,0,0,Matches,2020-2021,Premier-League
Phil Jagielka,eng ENG,DF,Sheffield Utd,37.0,1982.0,5.8,5,4,4,0,1,2,7,28.6,5,11,5,6,10,15,26,2,Matches,2020-2021,Premier-League
Alireza Jahanbakhsh,ir IRN,"FW,MF",Brighton,26.0,1993.0,5.9,9,7,3,5,1,2,12,16.7,10,8,0,8,8,17,1,0,Matches,2020-2021,Premier-League
Daniel James,wls WAL,FW,Manchester Utd,22.0,1997.0,10.1,15,9,4,7,4,3,18,16.7,15,10,1,9,0,15,6,0,Matches,2020-2021,Premier-League
Reece James,eng ENG,DF,Chelsea,20.0,1999.0,26.4,55,35,24,22,9,21,44,47.7,23,36,7,29,17,72,52,0,Matches,2020-2021,Premier-League
Alexandre Jankewitz,ch SUI,MF,Southampton,18.0,2001.0,0.0,2,1,2,0,0,1,1,100.0,0,0,0,0,0,2,0,0,Matches,2020-2021,Premier-League
Daniel Jebbison,eng ENG,FW,Sheffield Utd,16.0,2003.0,3.2,6,2,1,3,2,3,7,42.9,4,6,1,5,1,7,0,0,Matches,2020-2021,Premier-League
Gabriel Jesus,br BRA,FW,Manchester City,23.0,1997.0,22.9,17,6,5,5,7,11,28,39.3,17,16,0,16,15,32,5,0,Matches,2020-2021,Premier-League
Raúl Jiménez,mx MEX,FW,Wolves,29.0,1991.0,9.1,3,2,1,2,0,0,7,0.0,7,2,0,2,8,11,12,0,Matches,2020-2021,Premier-League
Joelinton,br BRA,"FW,MF",Newcastle Utd,23.0,1996.0,22.0,33,21,7,21,5,14,37,37.8,23,30,2,28,9,42,24,0,Matches,2020-2021,Premier-League
Ben Johnson,eng ENG,"DF,FW",West Ham,20.0,2000.0,5.8,11,5,5,3,3,7,9,77.8,2,5,1,4,11,22,9,0,Matches,2020-2021,Premier-League
Sam Johnstone,eng ENG,GK,West Brom,27.0,1993.0,37.0,0,0,0,0,0,0,0,,0,0,0,0,2,2,15,2,Matches,2020-2021,Premier-League
Curtis Jones,eng ENG,MF,Liverpool,19.0,2001.0,13.1,16,6,6,7,3,12,25,48.0,13,13,0,13,19,35,11,1,Matches,2020-2021,Premier-League
Jorginho,it ITA,MF,Chelsea,28.0,1991.0,22.3,57,30,22,31,4,31,76,40.8,45,33,5,28,40,97,21,3,Matches,2020-2021,Premier-League
Willian José,br BRA,FW,Wolves,28.0,1991.0,12.3,2,1,1,1,0,1,4,25.0,3,6,1,5,1,3,12,0,Matches,2020-2021,Premier-League
Diogo Jota,pt POR,FW,Liverpool,23.0,1996.0,12.4,12,6,4,7,1,2,29,6.9,27,9,0,9,5,17,3,0,Matches,2020-2021,Premier-League
James Justin,eng ENG,DF,Leicester City,22.0,1998.0,23.0,61,37,38,18,5,20,41,48.8,21,36,10,26,30,91,58,1,Matches,2020-2021,Premier-League
Ozan Kabak,tr TUR,DF,Liverpool,20.0,2000.0,8.9,19,10,11,4,4,6,9,66.7,3,2,2,0,12,31,28,1,Matches,2020-2021,Premier-League
Aboubakar Kamara,mr MTN,"FW,MF",Fulham,25.0,1995.0,3.5,2,2,1,1,0,0,5,0.0,5,6,0,6,1,3,0,0,Matches,2020-2021,Premier-League
Harry Kane,eng ENG,FW,Tottenham,27.0,1993.0,34.2,22,12,1,17,4,8,26,30.8,18,28,11,17,11,33,40,0,Matches,2020-2021,Premier-League
N'Golo Kanté,fr FRA,MF,Chelsea,29.0,1991.0,23.8,79,42,39,35,5,27,56,48.2,29,42,4,38,59,138,34,0,Matches,2020-2021,Premier-League
Moise Kean,it ITA,"FW,MF",Everton,20.0,2000.0,0.2,0,0,0,0,0,0,0,,0,0,0,0,0,0,0,0,Matches,2020-2021,Premier-League
Michael Keane,eng ENG,DF,Everton,27.0,1993.0,33.2,28,15,20,8,0,14,31,45.2,17,46,33,13,51,79,161,0,Matches,2020-2021,Premier-League
Neeskens Kebano,cd COD,"FW,MF",Fulham,28.0,1992.0,1.3,0,0,0,0,0,0,1,0.0,1,3,0,3,0,0,0,0,Matches,2020-2021,Premier-League
Naby Keïta,gn GUI,MF,Liverpool,25.0,1995.0,5.8,11,5,1,8,2,7,17,41.2,10,10,0,10,9,20,6,0,Matches,2020-2021,Premier-League
Caoimhín Kelleher,ie IRL,GK,Liverpool,21.0,1998.0,2.0,0,0,0,0,0,0,0,,0,0,0,0,0,0,2,0,Matches,2020-2021,Premier-League
Martin Kelly,eng ENG,DF,Crystal Palace,30.0,1990.0,0.0,1,0,1,0,0,1,1,100.0,0,0,0,0,0,1,0,0,Matches,2020-2021,Premier-League
Jonjoe Kenny,eng ENG,DF,Everton,23.0,1997.0,0.9,2,1,1,0,1,2,2,100.0,0,0,0,0,1,3,3,0,Matches,2020-2021,Premier-League
Reda Khadra,de GER,MF,Brighton,19.0,2001.0,0.1,0,0,0,0,0,0,0,,0,0,0,0,0,0,0,0,Matches,2020-2021,Premier-League
Max Kilman,eng ENG,DF,Wolves,23.0,1997.0,14.6,21,14,13,4,4,8,14,57.1,6,17,8,9,19,40,46,0,Matches,2020-2021,Premier-League
Joshua King,no NOR,"MF,FW",Everton,28.0,1992.0,1.6,4,1,2,1,1,0,0,,0,3,0,3,1,5,1,0,Matches,2020-2021,Premier-League
Mateusz Klich,pl POL,MF,Leeds United,30.0,1990.0,26.6,38,20,14,20,4,14,61,23.0,47,13,4,9,11,49,16,0,Matches,2020-2021,Premier-League
Robin Koch,de GER,"DF,MF",Leeds United,24.0,1996.0,12.6,27,16,17,10,0,10,19,52.6,9,18,12,6,27,54,34,2,Matches,2020-2021,Premier-League
Sead Kolašinac,ba BIH,DF,Arsenal,27.0,1993.0,1.0,0,0,0,0,0,0,0,,0,0,0,0,1,1,0,0,Matches,2020-2021,Premier-League
Terence Kongolo,nl NED,DF,Fulham,26.0,1994.0,1.0,3,2,1,2,0,1,1,100.0,0,0,0,0,2,5,3,0,Matches,2020-2021,Premier-League
Ezri Konsa,eng ENG,DF,Aston Villa,22.0,1997.0,35.5,25,13,18,6,1,9,13,69.2,4,53,47,6,29,54,162,1,Matches,2020-2021,Premier-League
Cheikhou Kouyaté,sn SEN,DF,Crystal Palace,30.0,1989.0,34.7,58,37,44,12,2,25,43,58.1,18,42,26,16,32,90,125,2,Matches,2020-2021,Premier-League
Mateo Kovačić,hr CRO,MF,Chelsea,26.0,1994.0,20.2,46,28,19,24,3,17,32,53.1,15,18,1,17,15,61,11,2,Matches,2020-2021,Premier-League
Emil Krafth,se SWE,DF,Newcastle Utd,25.0,1994.0,14.3,19,8,9,9,1,12,25,48.0,13,15,9,6,15,34,52,2,Matches,2020-2021,Premier-League
Filip Krovinović,hr CRO,MF,West Brom,24.0,1995.0,6.1,13,10,6,5,2,6,18,33.3,12,2,0,2,4,17,2,0,Matches,2020-2021,Premier-League
Alexandre Lacazette,fr FRA,FW,Arsenal,29.0,1991.0,21.4,18,10,4,11,3,4,22,18.2,18,20,1,19,12,30,13,0,Matches,2020-2021,Premier-League
Adam Lallana,eng ENG,"MF,FW",Brighton,32.0,1988.0,17.7,28,13,11,13,4,8,39,20.5,31,18,3,15,15,43,13,0,Matches,2020-2021,Premier-League
Érik Lamela,ar ARG,"FW,MF",Tottenham,28.0,1992.0,8.0,17,9,1,11,5,8,21,38.1,13,11,1,10,6,23,2,0,Matches,2020-2021,Premier-League
Tariq Lamptey,gh GHA,"DF,MF",Brighton,19.0,2000.0,9.8,17,9,7,6,4,6,13,46.2,7,8,1,7,19,36,12,1,Matches,2020-2021,Premier-League
Manuel Lanzini,ar ARG,"MF,FW",West Ham,27.0,1993.0,6.3,9,2,3,4,2,3,10,30.0,7,9,0,9,7,16,5,0,Matches,2020-2021,Premier-League
Aymeric Laporte,es ESP,DF,Manchester City,26.0,1994.0,14.9,13,6,10,3,0,7,11,63.6,4,12,7,5,11,24,28,0,Matches,2020-2021,Premier-League
Jamaal Lascelles,eng ENG,DF,Newcastle Utd,26.0,1993.0,18.1,14,7,5,9,0,3,6,50.0,3,27,17,10,12,26,86,0,Matches,2020-2021,Premier-League
Maxime Le Marchand,fr FRA,DF,Fulham,30.0,1989.0,1.4,2,2,2,0,0,2,2,100.0,0,0,0,0,0,2,3,0,Matches,2020-2021,Premier-League
Mario Lemina,ga GAB,MF,Fulham,26.0,1993.0,18.9,62,35,25,30,7,23,44,52.3,21,26,5,21,30,92,21,0,Matches,2020-2021,Premier-League
Bernd Leno,de GER,GK,Arsenal,28.0,1992.0,34.8,1,0,1,0,0,1,1,100.0,0,1,0,1,0,1,11,2,Matches,2020-2021,Premier-League
Khanya Leshabela,za RSA,MF,Leicester City,20.0,1999.0,0.1,0,0,0,0,0,0,0,,0,0,0,0,0,0,0,0,Matches,2020-2021,Premier-League
Jamal Lewis,nir NIR,DF,Newcastle Utd,22.0,1998.0,20.4,37,20,23,13,1,16,38,42.1,22,21,7,14,11,48,44,1,Matches,2020-2021,Premier-League
Victor Lindelöf,se SWE,DF,Manchester Utd,26.0,1994.0,28.7,22,10,12,10,0,12,24,50.0,12,22,14,8,30,52,95,1,Matches,2020-2021,Premier-League
Jesse Lingard,eng ENG,"MF,FW",West Ham,27.0,1992.0,15.8,12,6,4,8,0,5,14,35.7,9,7,1,6,4,16,0,0,Matches,2020-2021,Premier-League
Jake Livermore,eng ENG,MF,West Brom,30.0,1989.0,13.8,33,18,14,16,3,14,31,45.2,17,21,6,15,16,49,26,0,Matches,2020-2021,Premier-League
Diego Llorente,es ESP,DF,Leeds United,26.0,1993.0,13.4,34,21,21,13,0,19,32,59.4,13,18,13,5,20,54,40,2,Matches,2020-2021,Premier-League
Hugo Lloris,fr FRA,GK,Tottenham,33.0,1986.0,38.0,0,0,0,0,0,0,1,0.0,1,0,0,0,0,0,10,1,Matches,2020-2021,Premier-League
Giovani Lo Celso,ar ARG,MF,Tottenham,24.0,1996.0,10.5,28,22,12,11,5,10,29,34.5,19,12,1,11,7,35,5,0,Matches,2020-2021,Premier-League
Ruben Loftus-Cheek,eng ENG,FW,Chelsea,24.0,1996.0,0.7,0,0,0,0,0,0,0,,0,0,0,0,0,0,0,0,Matches,2020-2021,Premier-League
Ruben Loftus-Cheek,eng ENG,"MF,FW",Fulham,24.0,1996.0,21.2,25,14,7,15,3,7,23,30.4,16,20,2,18,7,32,18,0,Matches,2020-2021,Premier-League
Kevin Long,ie IRL,DF,Burnley,29.0,1990.0,7.1,11,6,9,2,0,7,9,77.8,2,11,7,4,6,17,24,0,Matches,2020-2021,Premier-League
Shane Long,ie IRL,FW,Southampton,33.0,1987.0,2.3,2,1,0,0,2,2,3,66.7,1,0,0,0,3,5,1,0,Matches,2020-2021,Premier-League
Matthew Longstaff,eng ENG,MF,Newcastle Utd,20.0,2000.0,4.2,3,2,2,1,0,2,8,25.0,6,7,0,7,7,10,2,0,Matches,2020-2021,Premier-League
Sean Longstaff,eng ENG,MF,Newcastle Utd,22.0,1997.0,15.7,31,14,13,15,3,18,42,42.9,24,26,5,21,19,50,14,2,Matches,2020-2021,Premier-League
Ademola Lookman,ng NGA,"FW,MF",Fulham,22.0,1997.0,30.5,35,11,18,9,8,13,44,29.5,31,31,1,30,20,55,9,0,Matches,2020-2021,Premier-League
Max Lowe,eng ENG,DF,Sheffield Utd,23.0,1997.0,6.1,26,11,18,6,2,9,21,42.9,12,12,4,8,5,31,11,0,Matches,2020-2021,Premier-League
Matthew Lowton,eng ENG,DF,Burnley,31.0,1989.0,34.0,54,32,31,22,1,32,73,43.8,41,36,13,23,56,110,91,1,Matches,2020-2021,Premier-League
David Luiz,br BRA,DF,Arsenal,33.0,1987.0,15.5,12,9,5,7,0,4,4,100.0,0,16,9,7,16,28,50,2,Matches,2020-2021,Premier-League
Douglas Luiz,br BRA,MF,Aston Villa,22.0,1998.0,30.9,49,18,22,26,1,20,58,34.5,38,52,17,35,43,92,44,2,Matches,2020-2021,Premier-League
John Lundstram,eng ENG,MF,Sheffield Utd,26.0,1994.0,22.6,25,16,12,11,2,13,47,27.7,34,26,8,18,14,39,29,1,Matches,2020-2021,Premier-League
Alexis Mac Allister,ar ARG,"MF,FW",Brighton,21.0,1998.0,12.4,26,12,6,16,4,11,38,28.9,27,25,4,21,9,35,4,0,Matches,2020-2021,Premier-League
James Maddison,eng ENG,MF,Leicester City,23.0,1996.0,23.3,32,16,5,16,11,14,41,34.1,27,14,1,13,9,41,5,0,Matches,2020-2021,Premier-League
Gabriel Magalhães,br BRA,DF,Arsenal,22.0,1997.0,22.2,25,15,19,5,1,13,19,68.4,6,27,19,8,26,51,74,2,Matches,2020-2021,Premier-League
Harry Maguire,eng ENG,DF,Manchester Utd,27.0,1993.0,33.9,29,17,19,10,0,18,29,62.1,11,28,23,5,60,89,122,4,Matches,2020-2021,Premier-League
Riyad Mahrez,dz ALG,FW,Manchester City,29.0,1991.0,21.7,20,5,2,10,8,6,30,20.0,24,19,0,19,8,28,4,0,Matches,2020-2021,Premier-League
Ainsley Maitland-Niles,eng ENG,"MF,DF",Arsenal,22.0,1997.0,5.4,11,7,6,5,0,8,12,66.7,4,12,2,10,14,25,7,1,Matches,2020-2021,Premier-League
Ainsley Maitland-Niles,eng ENG,MF,West Brom,22.0,1997.0,13.7,22,10,7,8,7,9,28,32.1,19,12,1,11,17,39,24,0,Matches,2020-2021,Premier-League
Josh Maja,ng NGA,FW,Fulham,21.0,1998.0,9.0,7,4,0,3,4,4,10,40.0,6,3,1,2,4,11,1,0,Matches,2020-2021,Premier-League
Sadio Mané,sn SEN,FW,Liverpool,28.0,1992.0,31.2,48,30,6,22,20,12,33,36.4,21,30,0,30,15,63,11,0,Matches,2020-2021,Premier-League
Javier Manquillo,es ESP,DF,Newcastle Utd,26.0,1994.0,9.2,24,14,8,14,2,11,17,64.7,6,8,1,7,9,33,15,1,Matches,2020-2021,Premier-League
Fernando Marçal,br BRA,"DF,MF",Wolves,31.0,1989.0,6.9,13,5,6,7,0,6,11,54.5,5,11,2,9,12,25,25,0,Matches,2020-2021,Premier-League
Solly March,eng ENG,"DF,MF",Brighton,26.0,1994.0,18.6,49,23,24,15,10,18,34,52.9,16,30,5,25,22,71,30,0,Matches,2020-2021,Premier-League
Pablo Marí,es ESP,DF,Arsenal,26.0,1993.0,10.0,15,9,12,3,0,5,10,50.0,5,8,7,1,9,24,30,2,Matches,2020-2021,Premier-League
Anthony Martial,fr FRA,FW,Manchester Utd,24.0,1995.0,16.4,2,1,1,1,0,0,10,0.0,10,17,3,14,1,3,8,0,Matches,2020-2021,Premier-League
Gabriel Martinelli,br BRA,FW,Arsenal,19.0,2001.0,6.5,7,1,2,3,2,4,10,40.0,6,6,0,6,8,15,4,0,Matches,2020-2021,Premier-League
Emiliano Martínez,ar ARG,GK,Aston Villa,27.0,1992.0,38.0,3,3,3,0,0,3,4,75.0,1,0,0,0,2,5,10,2,Matches,2020-2021,Premier-League
Arthur Masuaku,cd COD,"DF,MF",West Ham,26.0,1993.0,11.2,20,12,14,6,0,11,34,32.4,23,12,0,12,8,28,28,2,Matches,2020-2021,Premier-League
Juan Mata,es ESP,"FW,MF",Manchester Utd,32.0,1988.0,5.7,1,0,1,0,0,0,7,0.0,7,3,0,3,3,4,3,0,Matches,2020-2021,Premier-League
Jean-Philippe Mateta,fr FRA,FW,Crystal Palace,23.0,1997.0,2.5,1,1,0,1,0,1,3,33.3,2,1,0,1,0,1,2,0,Matches,2020-2021,Premier-League
Nemanja Matić,rs SRB,MF,Manchester Utd,31.0,1988.0,12.3,25,11,13,12,0,13,31,41.9,18,19,5,14,22,47,10,3,Matches,2020-2021,Premier-League
Joël Matip,cm CMR,DF,Liverpool,28.0,1991.0,7.7,14,9,7,7,0,7,8,87.5,1,6,0,6,7,21,22,0,Matches,2020-2021,Premier-League
Neal Maupay,fr FRA,"FW,MF",Brighton,23.0,1996.0,27.9,20,8,9,7,4,4,24,16.7,20,20,0,20,13,33,6,0,Matches,2020-2021,Premier-League
James McArthur,sct SCO,MF,Crystal Palace,32.0,1987.0,16.3,57,32,25,27,5,15,39,38.5,24,28,3,25,23,80,31,0,Matches,2020-2021,Premier-League
Oliver McBurnie,sct SCO,FW,Sheffield Utd,24.0,1996.0,14.7,15,7,7,7,1,5,17,29.4,12,10,3,7,6,21,30,0,Matches,2020-2021,Premier-League
Alex McCarthy,eng ENG,GK,Southampton,30.0,1989.0,30.0,1,0,1,0,0,1,4,25.0,3,0,0,0,0,1,11,1,Matches,2020-2021,Premier-League
James McCarthy,ie IRL,MF,Crystal Palace,29.0,1990.0,9.1,16,12,9,7,0,8,21,38.1,13,15,7,8,8,24,12,0,Matches,2020-2021,Premier-League
John McGinn,sct SCO,MF,Aston Villa,25.0,1994.0,37.0,61,37,23,31,7,27,84,32.1,57,38,6,32,43,104,23,2,Matches,2020-2021,Premier-League
David McGoldrick,ie IRL,"FW,MF",Sheffield Utd,32.0,1987.0,26.6,33,21,8,15,10,13,31,41.9,18,19,3,16,2,35,25,0,Matches,2020-2021,Premier-League
Dwight McNeil,eng ENG,MF,Burnley,20.0,1999.0,34.1,47,24,24,18,5,18,56,32.1,38,44,6,38,32,79,32,1,Matches,2020-2021,Premier-League
Scott McTominay,sct SCO,MF,Manchester Utd,23.0,1996.0,23.7,51,24,23,25,3,23,36,63.9,13,35,10,25,29,80,46,0,Matches,2020-2021,Premier-League
Ben Mee,eng ENG,DF,Burnley,30.0,1989.0,29.9,32,15,16,14,2,14,29,48.3,15,54,45,9,43,75,148,2,Matches,2020-2021,Premier-League
Hannibal Mejbri,tn TUN,MF,Manchester Utd,17.0,2003.0,0.1,0,0,0,0,0,0,0,,0,0,0,0,0,0,0,0,Matches,2020-2021,Premier-League
Benjamin Mendy,fr FRA,DF,Manchester City,26.0,1994.0,10.6,13,9,1,8,4,5,21,23.8,16,12,5,7,5,18,14,1,Matches,2020-2021,Premier-League
Edouard Mendy,sn SEN,GK,Chelsea,28.0,1992.0,30.5,0,0,0,0,0,0,1,0.0,1,0,0,0,1,1,9,3,Matches,2020-2021,Premier-League
Nampalys Mendy,sn SEN,MF,Leicester City,28.0,1992.0,16.2,26,17,18,6,2,7,20,35.0,13,12,1,11,14,40,8,0,Matches,2020-2021,Premier-League
Illan Meslier,fr FRA,GK,Leeds United,20.0,2000.0,35.0,0,0,0,0,0,0,1,0.0,1,0,0,0,0,0,17,8,Matches,2020-2021,Premier-League
Luka Milivojević,rs SRB,MF,Crystal Palace,29.0,1991.0,26.2,65,34,25,31,9,42,77,54.5,35,29,6,23,35,100,47,2,Matches,2020-2021,Premier-League
James Milner,eng ENG,"MF,DF",Liverpool,34.0,1986.0,11.9,26,19,9,14,3,11,33,33.3,22,30,3,27,14,40,16,1,Matches,2020-2021,Premier-League
Yerry Mina,co COL,DF,Everton,25.0,1994.0,21.5,21,14,17,4,0,8,12,66.7,4,30,23,7,24,45,110,1,Matches,2020-2021,Premier-League
Takumi Minamino,jp JPN,MF,Southampton,25.0,1995.0,7.9,7,3,2,5,0,2,19,10.5,17,13,1,12,4,11,9,0,Matches,2020-2021,Premier-League
Takumi Minamino,jp JPN,"MF,FW",Liverpool,25.0,1995.0,3.3,4,3,1,2,1,0,12,0.0,12,1,0,1,2,6,3,0,Matches,2020-2021,Premier-League
Tyrone Mings,eng ENG,DF,Aston Villa,27.0,1993.0,35.5,32,16,23,7,2,16,24,66.7,8,59,40,19,41,73,172,3,Matches,2020-2021,Premier-League
Tyrick Mitchell,eng ENG,DF,Crystal Palace,20.0,1999.0,19.0,64,35,48,9,7,23,40,57.5,17,29,10,19,21,85,62,1,Matches,2020-2021,Premier-League
Aleksandar Mitrović,rs SRB,FW,Fulham,25.0,1994.0,15.6,7,4,0,3,4,2,8,25.0,6,12,3,9,3,10,8,0,Matches,2020-2021,Premier-League
Jakub Moder,pl POL,"DF,MF",Brighton,21.0,1999.0,7.2,15,7,5,7,3,7,20,35.0,13,12,1,11,3,18,9,0,Matches,2020-2021,Premier-League
Jayson Molumby,ie IRL,MF,Brighton,20.0,1999.0,0.0,0,0,0,0,0,0,0,,0,0,0,0,0,0,0,0,Matches,2020-2021,Premier-League
Wesley Moraes,br BRA,FW,Aston Villa,23.0,1996.0,0.2,0,0,0,0,0,0,1,0.0,1,0,0,0,0,0,0,0,Matches,2020-2021,Premier-League
Wes Morgan,jm JAM,DF,Leicester City,36.0,1984.0,0.2,0,0,0,0,0,0,0,,0,0,0,0,0,0,1,0,Matches,2020-2021,Premier-League
Mason Mount,eng ENG,MF,Chelsea,21.0,1999.0,32.1,75,35,22,38,15,25,69,36.2,44,40,2,38,31,106,14,0,Matches,2020-2021,Premier-League
Lucas Moura,br BRA,"FW,MF",Tottenham,27.0,1992.0,15.7,32,16,12,16,4,8,29,27.6,21,12,0,12,18,50,10,0,Matches,2020-2021,Premier-League
Lys Mousset,fr FRA,"FW,MF",Sheffield Utd,24.0,1996.0,3.3,1,0,0,0,1,0,2,0.0,2,1,0,1,0,1,1,1,Matches,2020-2021,Premier-League
João Moutinho,pt POR,MF,Wolves,33.0,1986.0,28.1,75,40,34,35,6,35,91,38.5,56,18,3,15,47,122,28,0,Matches,2020-2021,Premier-League
Joel Mumbongo,se SWE,FW,Burnley,21.0,1999.0,0.4,0,0,0,0,0,0,0,,0,1,0,1,0,0,0,0,Matches,2020-2021,Premier-League
Jacob Murphy,eng ENG,"DF,MF",Newcastle Utd,25.0,1995.0,18.1,39,24,25,12,2,24,49,49.0,25,27,3,24,14,53,29,0,Matches,2020-2021,Premier-League
Shkodran Mustafi,de GER,DF,Arsenal,28.0,1992.0,0.5,1,1,1,0,0,1,1,100.0,0,1,0,1,0,1,3,0,Matches,2020-2021,Premier-League
Marvelous Nakamba,zw ZIM,MF,Aston Villa,26.0,1994.0,8.3,22,14,10,11,1,7,12,58.3,5,16,5,11,17,39,9,1,Matches,2020-2021,Premier-League
Iliman Ndiaye,sn SEN,MF,Sheffield Utd,20.0,2000.0,0.1,1,1,0,1,0,1,1,100.0,0,0,0,0,0,1,0,0,Matches,2020-2021,Premier-League
Wilfred Ndidi,ng NGA,"MF,DF",Leicester City,23.0,1996.0,24.2,96,63,45,44,7,26,66,39.4,40,38,11,27,61,157,55,0,Matches,2020-2021,Premier-League
Tanguy Ndombele,fr FRA,MF,Tottenham,23.0,1996.0,23.2,41,20,11,21,9,18,44,40.9,26,28,4,24,19,60,15,0,Matches,2020-2021,Premier-League
Reiss Nelson,eng ENG,"FW,MF",Arsenal,20.0,1999.0,0.8,1,0,0,0,1,0,0,,0,0,0,0,1,2,1,0,Matches,2020-2021,Premier-League
Pedro Neto,pt POR,"FW,MF",Wolves,20.0,2000.0,28.3,16,9,4,6,6,6,28,21.4,22,18,2,16,31,47,8,0,Matches,2020-2021,Premier-League
Rúben Neves,pt POR,MF,Wolves,23.0,1997.0,29.7,86,46,42,38,6,36,88,40.9,52,55,11,44,65,151,46,2,Matches,2020-2021,Premier-League
Eddie Nketiah,eng ENG,FW,Arsenal,21.0,1999.0,4.7,3,1,0,2,1,0,2,0.0,2,6,0,6,0,3,5,0,Matches,2020-2021,Premier-League
Niels Nkounkou,fr FRA,"DF,FW",Everton,19.0,2000.0,0.9,4,3,1,2,1,3,8,37.5,5,4,0,4,0,4,4,0,Matches,2020-2021,Premier-League
Dan Nlundulu,eng ENG,"FW,MF",Southampton,21.0,1999.0,1.2,0,0,0,0,0,0,1,0.0,1,2,0,2,0,0,2,0,Matches,2020-2021,Premier-League
Mark Noble,eng ENG,MF,West Ham,33.0,1987.0,7.9,8,4,2,5,1,4,14,28.6,10,7,3,4,13,21,3,0,Matches,2020-2021,Premier-League
Will Norris,eng ENG,GK,Burnley,26.0,1993.0,2.0,0,0,0,0,0,0,0,,0,0,0,0,0,0,0,0,Matches,2020-2021,Premier-League
Oliver Norwood,nir NIR,MF,Sheffield Utd,29.0,1991.0,24.7,49,22,16,28,5,21,72,29.2,51,29,12,17,36,85,51,1,Matches,2020-2021,Premier-League
Jack O'Connell,eng ENG,DF,Sheffield Utd,26.0,1994.0,2.0,3,1,1,1,1,0,1,0.0,1,4,3,1,2,5,7,0,Matches,2020-2021,Premier-League
Dara O'Shea,ie IRL,DF,West Brom,21.0,1999.0,23.4,45,25,30,13,2,21,45,46.7,24,32,17,15,45,90,108,0,Matches,2020-2021,Premier-League
Michael Obafemi,ie IRL,FW,Southampton,20.0,2000.0,0.7,1,0,0,1,0,0,1,0.0,1,1,0,1,0,1,0,0,Matches,2020-2021,Premier-League
Denis Odoi,gh GHA,DF,Fulham,32.0,1988.0,3.0,3,3,2,1,0,1,4,25.0,3,3,1,2,5,8,5,0,Matches,2020-2021,Premier-League
Angelo Ogbonna,it ITA,DF,West Ham,32.0,1988.0,27.7,26,13,20,5,1,9,17,52.9,8,25,11,14,30,56,119,0,Matches,2020-2021,Premier-League
Robin Olsen,se SWE,GK,Everton,30.0,1990.0,7.0,0,0,0,0,0,0,0,,0,0,0,0,0,0,4,1,Matches,2020-2021,Premier-League
Josh Onomah,eng ENG,MF,Fulham,23.0,1997.0,4.2,11,8,1,6,4,0,5,0.0,5,4,2,2,2,13,1,0,Matches,2020-2021,Premier-League
Divock Origi,be BEL,FW,Liverpool,25.0,1995.0,2.1,3,2,0,2,1,1,3,33.3,2,5,1,4,1,4,2,0,Matches,2020-2021,Premier-League
Ben Osborn,eng ENG,"MF,DF",Sheffield Utd,25.0,1994.0,17.8,33,18,15,10,8,13,40,32.5,27,20,3,17,12,45,17,0,Matches,2020-2021,Premier-League
Owen Otasowie,us USA,"MF,FW",Wolves,19.0,2001.0,2.1,5,5,3,2,0,1,2,50.0,1,1,1,0,3,8,4,0,Matches,2020-2021,Premier-League
Alex Oxlade-Chamberlain,eng ENG,"MF,FW",Liverpool,26.0,1993.0,2.8,4,0,0,3,1,0,2,0.0,2,1,0,1,2,6,0,0,Matches,2020-2021,Premier-League
Emerson Palmieri,it ITA,DF,Chelsea,25.0,1994.0,1.0,3,3,2,0,1,1,3,33.3,2,0,0,0,1,4,6,0,Matches,2020-2021,Premier-League
Thomas Partey,gh GHA,MF,Arsenal,27.0,1993.0,17.0,44,21,16,24,4,24,56,42.9,32,17,5,12,23,67,18,0,Matches,2020-2021,Premier-League
Rui Patrício,pt POR,GK,Wolves,32.0,1988.0,37.0,0,0,0,0,0,0,1,0.0,1,0,0,0,1,1,3,3,Matches,2020-2021,Premier-League
Bailey Peacock-Farrell,nir NIR,GK,Burnley,23.0,1996.0,4.0,0,0,0,0,0,0,0,,0,0,0,0,0,0,0,0,Matches,2020-2021,Premier-League
Lee Peltier,eng ENG,DF,West Brom,33.0,1986.0,2.5,9,4,8,1,0,4,4,100.0,0,1,1,0,1,10,11,0,Matches,2020-2021,Premier-League
Nicolas Pépé,ci CIV,FW,Arsenal,25.0,1995.0,18.0,20,15,8,6,6,8,23,34.8,15,16,1,15,12,32,19,0,Matches,2020-2021,Premier-League
Matheus Pereira,br BRA,"MF,FW",West Brom,24.0,1996.0,28.6,26,15,14,10,2,12,54,22.2,42,18,0,18,29,55,16,0,Matches,2020-2021,Premier-League
Ricardo Pereira,pt POR,"DF,FW",Leicester City,26.0,1993.0,10.7,31,22,16,8,7,14,35,40.0,21,24,1,23,15,46,23,0,Matches,2020-2021,Premier-League
Ayoze Pérez,es ESP,"MF,FW",Leicester City,27.0,1993.0,14.8,32,15,6,20,6,13,48,27.1,35,28,0,28,10,42,7,0,Matches,2020-2021,Premier-League
Kalvin Phillips,eng ENG,MF,Leeds United,24.0,1995.0,27.0,74,38,38,29,7,26,62,41.9,36,49,14,35,45,119,53,3,Matches,2020-2021,Premier-League
Matt Phillips,sct SCO,MF,West Brom,29.0,1991.0,20.3,15,8,4,11,0,7,23,30.4,16,32,4,28,10,25,32,1,Matches,2020-2021,Premier-League
Nathaniel Phillips,eng ENG,DF,Liverpool,23.0,1997.0,16.2,22,14,15,7,0,11,24,45.8,13,17,14,3,20,42,81,0,Matches,2020-2021,Premier-League
Jaden Philogene Bidace,eng ENG,FW,Aston Villa,18.0,2002.0,0.0,0,0,0,0,0,0,0,,0,0,0,0,0,0,0,0,Matches,2020-2021,Premier-League
Jordan Pickford,eng ENG,GK,Everton,26.0,1994.0,30.5,0,0,0,0,0,0,2,0.0,2,2,0,2,3,3,16,4,Matches,2020-2021,Premier-League
Erik Pieters,nl NED,"DF,MF",Burnley,31.0,1988.0,14.1,30,21,18,9,3,19,39,48.7,20,30,9,21,12,42,34,0,Matches,2020-2021,Premier-League
Daniel Podence,pt POR,"MF,FW",Wolves,24.0,1995.0,18.5,12,6,5,5,2,2,19,10.5,17,5,1,4,13,25,2,0,Matches,2020-2021,Premier-League
Paul Pogba,fr FRA,"MF,FW",Manchester Utd,27.0,1993.0,21.1,36,26,15,16,5,11,33,33.3,22,24,2,22,26,62,37,0,Matches,2020-2021,Premier-League
Nick Pope,eng ENG,GK,Burnley,28.0,1992.0,32.0,1,1,1,0,0,0,1,0.0,1,0,0,0,2,3,29,2,Matches,2020-2021,Premier-League
Ian Poveda,eng ENG,MF,Leeds United,20.0,2000.0,3.9,5,4,3,0,2,1,7,14.3,6,5,1,4,1,6,2,0,Matches,2020-2021,Premier-League
Dennis Praet,be BEL,MF,Leicester City,26.0,1994.0,8.0,14,7,4,7,3,6,15,40.0,9,12,2,10,7,21,3,0,Matches,2020-2021,Premier-League
Davy Pröpper,nl NED,MF,Brighton,28.0,1991.0,2.4,6,5,0,6,0,2,5,40.0,3,3,0,3,1,7,0,0,Matches,2020-2021,Premier-League
Christian Pulisic,us USA,"FW,MF",Chelsea,21.0,1998.0,19.3,19,11,8,10,1,8,21,38.1,13,25,2,23,12,31,9,0,Matches,2020-2021,Premier-League
Aaron Ramsdale,eng ENG,GK,Sheffield Utd,22.0,1998.0,38.0,1,1,1,0,0,1,1,100.0,0,0,0,0,2,3,22,6,Matches,2020-2021,Premier-League
Jacob Ramsey,eng ENG,MF,Aston Villa,19.0,2001.0,7.0,10,5,3,4,3,2,12,16.7,10,13,6,7,4,14,5,0,Matches,2020-2021,Premier-League
Kayne Ramsey,eng ENG,DF,Southampton,19.0,2000.0,1.0,5,2,4,1,0,3,3,100.0,0,0,0,0,0,5,3,0,Matches,2020-2021,Premier-League
Darren Randolph,ie IRL,GK,West Ham,33.0,1987.0,3.0,0,0,0,0,0,0,0,,0,0,0,0,0,0,1,0,Matches,2020-2021,Premier-League
Raphinha,br BRA,"MF,FW",Leeds United,23.0,1996.0,26.2,34,17,13,16,5,12,58,20.7,46,31,1,30,29,63,27,0,Matches,2020-2021,Premier-League
Marcus Rashford,eng ENG,FW,Manchester Utd,22.0,1997.0,32.4,18,9,2,8,8,7,27,25.9,20,22,2,20,8,26,10,0,Matches,2020-2021,Premier-League
Tim Ream,us USA,DF,Fulham,32.0,1987.0,7.0,12,5,9,3,0,8,11,72.7,3,8,5,3,6,18,26,1,Matches,2020-2021,Premier-League
Nathan Redmond,eng ENG,"MF,FW",Southampton,26.0,1994.0,19.3,30,17,14,12,4,8,24,33.3,16,24,2,22,11,41,9,0,Matches,2020-2021,Premier-League
Harrison Reed,eng ENG,MF,Fulham,25.0,1995.0,25.0,63,38,28,28,7,29,73,39.7,44,34,11,23,50,113,31,1,Matches,2020-2021,Premier-League
Sergio Reguilón,es ESP,DF,Tottenham,23.0,1996.0,24.9,47,25,30,13,4,23,48,47.9,25,39,7,32,32,79,50,1,Matches,2020-2021,Premier-League
Declan Rice,eng ENG,MF,West Ham,21.0,1999.0,32.0,59,35,33,25,1,21,51,41.2,30,39,11,28,59,118,41,0,Matches,2020-2021,Premier-League
Lewis Richardson,eng ENG,"FW,MF",Burnley,17.0,2003.0,0.0,0,0,0,0,0,0,0,,0,0,0,0,0,0,0,0,Matches,2020-2021,Premier-League
Richarlison,br BRA,FW,Everton,23.0,1997.0,31.8,50,32,21,22,7,16,51,31.4,35,28,3,25,14,64,36,1,Matches,2020-2021,Premier-League
Jaïro Riedewald,nl NED,MF,Crystal Palace,23.0,1996.0,20.2,34,15,13,17,4,16,36,44.4,20,39,7,32,29,63,25,0,Matches,2020-2021,Premier-League
Matt Ritchie,sct SCO,"DF,MF",Newcastle Utd,30.0,1989.0,15.0,10,3,5,3,2,3,17,17.6,14,17,2,15,12,22,47,0,Matches,2020-2021,Premier-League
Tyler Roberts,wls WAL,"MF,FW",Leeds United,21.0,1999.0,14.9,15,13,1,11,3,5,22,22.7,17,17,2,15,9,24,12,0,Matches,2020-2021,Premier-League
Andrew Robertson,sct SCO,DF,Liverpool,26.0,1994.0,37.6,46,34,23,18,5,28,57,49.1,29,39,9,30,21,67,79,1,Matches,2020-2021,Premier-League
Antonee Robinson,us USA,DF,Fulham,22.0,1997.0,24.0,45,28,24,16,5,27,44,61.4,17,21,4,17,37,82,68,0,Matches,2020-2021,Premier-League
Callum Robinson,ie IRL,"FW,MF",West Brom,25.0,1995.0,17.3,7,5,5,1,1,3,19,15.8,16,9,0,9,7,14,8,0,Matches,2020-2021,Premier-League
Jack Robinson,eng ENG,DF,Sheffield Utd,26.0,1993.0,9.7,14,6,8,5,1,6,11,54.5,5,10,4,6,9,23,42,0,Matches,2020-2021,Premier-League
Hal Robson-Kanu,wls WAL,FW,West Brom,31.0,1989.0,6.2,2,1,1,0,1,0,1,0.0,1,2,0,2,2,4,7,0,Matches,2020-2021,Premier-League
Marek Rodák,sk SVK,GK,Fulham,23.0,1996.0,2.0,0,0,0,0,0,0,0,,0,0,0,0,0,0,0,0,Matches,2020-2021,Premier-League
Joe Rodon,wls WAL,DF,Tottenham,22.0,1997.0,8.1,14,9,11,2,1,3,4,75.0,1,10,8,2,21,35,36,2,Matches,2020-2021,Premier-League
Rodri,es ESP,MF,Manchester City,24.0,1996.0,30.5,72,40,24,40,8,33,66,50.0,33,23,9,14,36,108,54,3,Matches,2020-2021,Premier-League
Rodrigo,es ESP,"MF,FW",Leeds United,29.0,1991.0,14.3,14,7,8,3,3,4,22,18.2,18,7,0,7,5,19,16,0,Matches,2020-2021,Premier-League
James Rodríguez,co COL,"FW,MF",Everton,29.0,1991.0,19.6,28,17,8,15,5,11,46,23.9,35,17,0,17,15,43,3,0,Matches,2020-2021,Premier-League
Jay Rodriguez,eng ENG,FW,Burnley,31.0,1989.0,14.1,25,16,5,15,5,13,28,46.4,15,25,4,21,2,27,7,0,Matches,2020-2021,Premier-League
Oriol Romeu,es ESP,MF,Southampton,28.0,1991.0,19.6,69,35,25,39,5,26,68,38.2,42,28,7,21,30,99,18,0,Matches,2020-2021,Premier-League
John Ruddy,eng ENG,GK,Wolves,33.0,1986.0,1.0,0,0,0,0,0,0,0,,0,0,0,0,0,0,0,0,Matches,2020-2021,Premier-League
Antonio Rüdiger,de GER,DF,Chelsea,27.0,1993.0,19.0,31,23,16,14,1,12,15,80.0,3,17,10,7,18,49,51,0,Matches,2020-2021,Premier-League
Mathew Ryan,au AUS,GK,Arsenal,28.0,1992.0,3.0,0,0,0,0,0,0,0,,0,0,0,0,0,0,1,0,Matches,2020-2021,Premier-League
Mathew Ryan,au AUS,GK,Brighton,28.0,1992.0,11.0,1,0,1,0,0,0,0,,0,0,0,0,0,1,4,0,Matches,2020-2021,Premier-League
Allan Saint-Maximin,fr FRA,"FW,MF",Newcastle Utd,23.0,1997.0,17.3,16,9,6,9,1,4,9,44.4,5,10,0,10,4,20,2,0,Matches,2020-2021,Premier-League
Romain Saïss,ma MAR,DF,Wolves,30.0,1990.0,26.7,35,24,23,12,0,19,33,57.6,14,28,13,15,52,87,115,1,Matches,2020-2021,Premier-League
Bukayo Saka,eng ENG,"FW,MF",Arsenal,18.0,2001.0,28.4,25,16,10,13,2,11,40,27.5,29,21,2,19,25,50,24,0,Matches,2020-2021,Premier-League
Mamadou Sakho,fr FRA,DF,Crystal Palace,30.0,1990.0,3.1,3,2,1,2,0,3,3,100.0,0,3,2,1,3,6,11,0,Matches,2020-2021,Premier-League
Mohamed Salah,eg EGY,FW,Liverpool,28.0,1992.0,34.2,18,9,4,4,10,7,16,43.8,9,10,0,10,1,19,10,1,Matches,2020-2021,Premier-League
Mohammed Salisu,gh GHA,DF,Southampton,21.0,1999.0,9.4,38,21,20,16,2,25,34,73.5,9,22,5,17,17,55,30,0,Matches,2020-2021,Premier-League
Davinson Sánchez,co COL,DF,Tottenham,24.0,1996.0,16.5,40,20,31,9,0,21,32,65.6,11,18,13,5,14,54,85,2,Matches,2020-2021,Premier-League
Robert Sánchez,es ESP,GK,Brighton,22.0,1997.0,27.0,1,0,1,0,0,1,1,100.0,0,1,0,1,1,2,11,2,Matches,2020-2021,Premier-League
Morgan Sanson,fr FRA,MF,Aston Villa,25.0,1994.0,3.3,7,4,4,2,1,1,4,25.0,3,5,0,5,4,11,1,0,Matches,2020-2021,Premier-League
Romaine Sawyers,kn SKN,MF,West Brom,28.0,1991.0,16.5,30,18,16,12,2,14,43,32.6,29,20,4,16,18,48,12,3,Matches,2020-2021,Premier-League
Dane Scarlett,eng ENG,FW,Tottenham,16.0,2004.0,0.0,0,0,0,0,0,0,0,,0,0,0,0,0,0,0,0,Matches,2020-2021,Premier-League
Fabian Schär,ch SUI,DF,Newcastle Utd,28.0,1991.0,13.8,13,4,8,5,0,7,19,36.8,12,19,12,7,27,40,52,1,Matches,2020-2021,Premier-League
Jeffrey Schlupp,gh GHA,MF,Crystal Palace,27.0,1992.0,15.9,29,16,14,12,3,6,23,26.1,17,24,8,16,22,51,16,0,Matches,2020-2021,Premier-League
Kasper Schmeichel,dk DEN,GK,Leicester City,33.0,1986.0,38.0,0,0,0,0,0,0,0,,0,0,0,0,0,0,10,0,Matches,2020-2021,Premier-League
Nélson Semedo,pt POR,"DF,MF",Wolves,26.0,1993.0,33.1,85,48,53,23,9,42,72,58.3,30,30,10,20,41,126,78,2,Matches,2020-2021,Premier-League
Femi Seriki,eng ENG,MF,Sheffield Utd,18.0,2002.0,0.0,0,0,0,0,0,0,0,,0,0,0,0,0,0,0,0,Matches,2020-2021,Premier-League
Jamie Shackleton,eng ENG,"MF,DF",Leeds United,20.0,1999.0,5.1,10,6,6,4,0,4,11,36.4,7,3,1,2,9,19,3,0,Matches,2020-2021,Premier-League
Xherdan Shaqiri,ch SUI,"MF,FW",Liverpool,28.0,1991.0,6.2,7,4,3,1,3,2,7,28.6,5,4,0,4,2,9,0,0,Matches,2020-2021,Premier-League
Billy Sharp,eng ENG,FW,Sheffield Utd,34.0,1986.0,8.2,5,1,0,3,2,2,9,22.2,7,2,0,2,0,5,2,0,Matches,2020-2021,Premier-League
Luke Shaw,eng ENG,DF,Manchester Utd,25.0,1995.0,29.5,44,28,21,16,7,21,36,58.3,15,34,9,25,20,64,44,2,Matches,2020-2021,Premier-League
Jonjo Shelvey,eng ENG,MF,Newcastle Utd,28.0,1992.0,29.1,39,14,18,19,2,10,37,27.0,27,26,14,12,36,75,42,0,Matches,2020-2021,Premier-League
Shola Shoretire,eng ENG,FW,Manchester Utd,16.0,2004.0,0.1,0,0,0,0,0,0,0,,0,0,0,0,0,0,0,0,Matches,2020-2021,Premier-League
Gylfi Sigurðsson,is ISL,"MF,FW",Everton,30.0,1989.0,25.0,30,20,9,14,7,13,44,29.5,31,31,2,29,34,64,21,1,Matches,2020-2021,Premier-League
Bernardo Silva,pt POR,"MF,FW",Manchester City,25.0,1994.0,22.9,26,14,7,12,7,11,52,21.2,41,17,1,16,17,43,8,0,Matches,2020-2021,Premier-League
Fábio Silva,pt POR,FW,Wolves,18.0,2002.0,15.2,6,4,1,4,1,4,12,33.3,8,12,1,11,4,10,5,1,Matches,2020-2021,Premier-League
Thiago Silva,br BRA,DF,Chelsea,35.0,1984.0,21.5,20,12,11,8,1,14,21,66.7,7,21,13,8,33,53,86,1,Matches,2020-2021,Premier-League
Moussa Sissoko,fr FRA,MF,Tottenham,30.0,1989.0,17.6,22,16,19,3,0,8,20,40.0,12,11,4,7,23,45,25,0,Matches,2020-2021,Premier-League
Islam Slimani,dz ALG,FW,Leicester City,32.0,1988.0,0.2,0,0,0,0,0,0,0,,0,0,0,0,0,0,0,0,Matches,2020-2021,Premier-League
William Smallbone,ie IRL,MF,Southampton,20.0,2000.0,1.9,6,3,2,4,0,1,3,33.3,2,5,0,5,2,8,1,0,Matches,2020-2021,Premier-League
Emile Smith Rowe,eng ENG,"MF,FW",Arsenal,20.0,2000.0,16.0,14,7,5,5,4,6,17,35.3,11,15,1,14,10,24,12,0,Matches,2020-2021,Premier-League
Robert Snodgrass,sct SCO,"MF,FW",West Brom,32.0,1987.0,5.8,17,12,12,4,1,10,16,62.5,6,11,2,9,1,18,12,0,Matches,2020-2021,Premier-League
Robert Snodgrass,sct SCO,"FW,MF",West Ham,32.0,1987.0,0.1,0,0,0,0,0,0,0,,0,0,0,0,0,0,0,0,Matches,2020-2021,Premier-League
Cédric Soares,pt POR,DF,Arsenal,28.0,1991.0,8.3,12,8,6,4,2,6,21,28.6,15,6,1,5,8,20,16,1,Matches,2020-2021,Premier-League
Tomáš Souček,cz CZE,MF,West Ham,25.0,1995.0,38.0,78,41,37,36,5,28,77,36.4,49,43,18,25,62,140,107,0,Matches,2020-2021,Premier-League
Çağlar Söyüncü,tr TUR,DF,Leicester City,24.0,1996.0,20.2,27,17,13,14,0,17,30,56.7,13,12,9,3,28,55,80,1,Matches,2020-2021,Premier-League
Zack Steffen,us USA,GK,Manchester City,25.0,1995.0,1.0,0,0,0,0,0,0,0,,0,0,0,0,0,0,0,0,Matches,2020-2021,Premier-League
Dale Stephens,eng ENG,MF,Burnley,31.0,1989.0,2.9,11,6,2,7,2,3,6,50.0,3,3,0,3,8,19,2,0,Matches,2020-2021,Premier-League
Jack Stephens,eng ENG,DF,Southampton,26.0,1994.0,17.1,34,19,19,15,0,17,38,44.7,21,25,14,11,28,62,64,2,Matches,2020-2021,Premier-League
Raheem Sterling,eng ENG,FW,Manchester City,25.0,1994.0,28.2,21,10,5,12,4,5,12,41.7,7,15,0,15,15,36,4,0,Matches,2020-2021,Premier-League
Enda Stevens,ie IRL,DF,Sheffield Utd,30.0,1990.0,30.0,59,26,32,19,8,33,58,56.9,25,41,12,29,22,81,81,1,Matches,2020-2021,Premier-League
John Stones,eng ENG,DF,Manchester City,26.0,1994.0,21.5,21,10,13,5,3,9,14,64.3,5,23,15,8,18,39,56,1,Matches,2020-2021,Premier-League
Pascal Struijk,nl NED,"DF,MF",Leeds United,20.0,1999.0,23.1,49,30,28,19,2,17,28,60.7,11,35,21,14,47,96,92,0,Matches,2020-2021,Premier-League
Japhet Tanganga,eng ENG,DF,Tottenham,21.0,1999.0,5.4,5,4,3,2,0,1,3,33.3,2,6,5,1,3,8,15,0,Matches,2020-2021,Premier-League
Matt Targett,eng ENG,DF,Aston Villa,24.0,1995.0,37.8,83,39,52,20,11,56,88,63.6,32,40,14,26,55,138,102,1,Matches,2020-2021,Premier-League
James Tarkowski,eng ENG,DF,Burnley,27.0,1992.0,36.0,66,39,52,11,3,25,49,51.0,24,54,42,12,44,110,163,1,Matches,2020-2021,Premier-League
Percy Tau,za RSA,FW,Brighton,26.0,1994.0,1.1,1,1,1,0,0,0,2,0.0,2,1,0,1,0,1,1,0,Matches,2020-2021,Premier-League
Sidnei Tavares,pt POR,MF,Leicester City,18.0,2001.0,0.9,1,1,0,1,0,0,0,,0,1,1,0,0,1,0,0,Matches,2020-2021,Premier-League
Charlie Taylor,eng ENG,DF,Burnley,26.0,1993.0,27.0,48,28,30,15,3,25,46,54.3,21,36,19,17,29,77,87,2,Matches,2020-2021,Premier-League
Neil Taylor,wls WAL,DF,Aston Villa,31.0,1989.0,0.2,1,1,1,0,0,0,0,,0,1,0,1,0,1,0,0,Matches,2020-2021,Premier-League
Allan Tchaptchet,fr FRA,DF,Southampton,18.0,2001.0,0.1,0,0,0,0,0,0,0,,0,0,0,0,0,0,0,0,Matches,2020-2021,Premier-League
Nathan Tella,ng NGA,"FW,MF",Southampton,21.0,1999.0,8.3,8,5,1,4,3,6,15,40.0,9,13,0,13,3,11,2,0,Matches,2020-2021,Premier-League
Alex Telles,br BRA,DF,Manchester Utd,27.0,1992.0,7.7,14,7,10,3,1,8,17,47.1,9,7,2,5,16,30,20,0,Matches,2020-2021,Premier-League
Kenny Tete,nl NED,"DF,MF",Fulham,24.0,1995.0,16.5,48,30,27,16,5,10,18,55.6,8,14,5,9,27,75,49,0,Matches,2020-2021,Premier-League
Luke Thomas,eng ENG,DF,Leicester City,19.0,2001.0,10.8,23,14,11,5,7,14,21,66.7,7,15,2,13,17,40,21,0,Matches,2020-2021,Premier-League
Youri Tielemans,be BEL,MF,Leicester City,23.0,1997.0,37.3,86,45,32,38,16,45,108,41.7,63,35,8,27,46,132,20,1,Matches,2020-2021,Premier-League
Kieran Tierney,sct SCO,DF,Arsenal,23.0,1997.0,25.5,27,15,5,14,8,11,31,35.5,20,31,10,21,16,43,63,0,Matches,2020-2021,Premier-League
James Tomkins,eng ENG,DF,Crystal Palace,31.0,1989.0,6.1,4,2,4,0,0,3,4,75.0,1,4,3,1,4,8,45,0,Matches,2020-2021,Premier-League
Fikayo Tomori,eng ENG,DF,Chelsea,22.0,1997.0,0.5,2,1,2,0,0,0,0,,0,1,1,0,2,4,8,0,Matches,2020-2021,Premier-League
Ferrán Torres,es ESP,"FW,MF",Manchester City,20.0,2000.0,14.5,12,5,4,6,2,5,16,31.3,11,16,0,16,3,15,8,0,Matches,2020-2021,Premier-League
Cenk Tosun,tr TUR,FW,Everton,29.0,1991.0,0.5,0,0,0,0,0,0,1,0.0,1,0,0,0,0,0,0,0,Matches,2020-2021,Premier-League
Andros Townsend,eng ENG,"MF,FW",Crystal Palace,29.0,1991.0,25.1,78,41,45,20,13,30,79,38.0,49,48,2,46,41,119,19,0,Matches,2020-2021,Premier-League
Conor Townsend,eng ENG,DF,West Brom,27.0,1993.0,24.8,44,28,32,9,3,30,49,61.2,19,38,15,23,36,80,55,2,Matches,2020-2021,Premier-League
Adama Traoré,es ESP,"FW,MF",Wolves,24.0,1996.0,29.4,28,16,11,13,4,13,21,61.9,8,23,1,22,7,35,12,1,Matches,2020-2021,Premier-League
Bertrand Traoré,bf BFA,FW,Aston Villa,24.0,1995.0,25.7,26,10,8,10,8,10,34,29.4,24,23,1,22,15,41,14,1,Matches,2020-2021,Premier-League
Trézéguet,eg EGY,FW,Aston Villa,25.0,1994.0,13.0,33,18,14,15,4,13,45,28.9,32,13,1,12,19,52,17,0,Matches,2020-2021,Premier-League
Leandro Trossard,be BEL,"MF,FW",Brighton,25.0,1994.0,29.0,33,14,11,16,6,10,36,27.8,26,34,2,32,26,59,7,1,Matches,2020-2021,Premier-League
Kostas Tsimikas,gr GRE,"DF,FW",Liverpool,24.0,1996.0,0.1,0,0,0,0,0,0,0,,0,0,0,0,0,0,0,0,Matches,2020-2021,Premier-League
Axel Tuanzebe,cd COD,DF,Manchester Utd,22.0,1997.0,4.5,13,7,5,7,1,8,9,88.9,1,7,5,2,3,16,18,0,Matches,2020-2021,Premier-League
Cengiz Ünder,tr TUR,"FW,MF",Leicester City,23.0,1997.0,3.1,4,1,0,3,1,3,5,60.0,2,3,0,3,2,6,0,0,Matches,2020-2021,Premier-League
Yan Valery,tn TUN,"DF,MF",Southampton,21.0,1999.0,1.1,5,3,2,3,0,1,5,20.0,4,2,0,2,2,7,5,0,Matches,2020-2021,Premier-League
Virgil van Dijk,nl NED,DF,Liverpool,29.0,1991.0,4.1,3,2,1,2,0,0,0,,0,1,1,0,5,8,8,1,Matches,2020-2021,Premier-League
Jamie Vardy,eng ENG,FW,Leicester City,33.0,1987.0,31.6,18,12,1,8,9,2,15,13.3,13,14,5,9,4,22,32,0,Matches,2020-2021,Premier-League
Joël Veltman,nl NED,DF,Brighton,28.0,1992.0,25.3,67,33,34,25,8,29,57,50.9,28,24,5,19,33,100,64,0,Matches,2020-2021,Premier-League
Jannik Vestergaard,dk DEN,DF,Southampton,27.0,1992.0,28.6,50,31,31,15,4,35,52,67.3,17,29,16,13,42,92,122,0,Matches,2020-2021,Premier-League
Rúben Vinagre,pt POR,"MF,DF",Wolves,21.0,1999.0,1.9,7,5,5,2,0,3,4,75.0,1,3,0,3,2,9,4,0,Matches,2020-2021,Premier-League
Carlos Vinícius,br BRA,FW,Tottenham,25.0,1995.0,3.4,3,1,2,1,0,1,1,100.0,0,0,0,0,2,5,5,0,Matches,2020-2021,Premier-League
João Virgínia,pt POR,GK,Everton,20.0,1999.0,0.5,0,0,0,0,0,0,0,,0,0,0,0,0,0,0,0,Matches,2020-2021,Premier-League
Vitinha,pt POR,MF,Wolves,20.0,2000.0,5.8,7,3,2,5,0,3,8,37.5,5,3,0,3,3,10,1,0,Matches,2020-2021,Premier-League
Jake Vokins,eng ENG,DF,Southampton,20.0,2000.0,0.7,0,0,0,0,0,0,1,0.0,1,0,0,0,0,0,0,0,Matches,2020-2021,Premier-League
Matěj Vydra,cz CZE,FW,Burnley,28.0,1992.0,15.2,9,5,2,4,3,1,8,12.5,7,8,1,7,6,15,5,0,Matches,2020-2021,Premier-League
Theo Walcott,eng ENG,"MF,FW",Southampton,31.0,1989.0,18.0,23,11,8,9,6,11,32,34.4,21,16,0,16,14,37,5,0,Matches,2020-2021,Premier-League
Theo Walcott,eng ENG,FW,Everton,31.0,1989.0,0.1,0,0,0,0,0,0,0,,0,0,0,0,0,0,0,0,Matches,2020-2021,Premier-League
Kyle Walker,eng ENG,DF,Manchester City,30.0,1990.0,21.6,29,19,15,12,2,16,24,66.7,8,19,7,12,14,43,28,0,Matches,2020-2021,Premier-League
Kyle Walker-Peters,eng ENG,DF,Southampton,23.0,1997.0,29.4,83,53,56,25,2,34,57,59.6,23,41,10,31,38,121,66,2,Matches,2020-2021,Premier-League
Aaron Wan-Bissaka,eng ENG,DF,Manchester Utd,22.0,1997.0,34.0,88,54,53,29,6,32,45,71.1,13,65,17,48,62,150,84,2,Matches,2020-2021,Premier-League
Joel Ward,eng ENG,DF,Crystal Palace,30.0,1989.0,25.1,43,25,29,14,0,24,42,57.1,18,27,8,19,41,84,87,2,Matches,2020-2021,Premier-League
James Ward-Prowse,eng ENG,MF,Southampton,25.0,1994.0,38.0,75,49,30,41,4,29,70,41.4,41,36,4,32,42,117,60,0,Matches,2020-2021,Premier-League
Ollie Watkins,eng ENG,FW,Aston Villa,24.0,1995.0,37.0,29,17,5,16,8,10,33,30.3,23,21,2,19,7,36,24,0,Matches,2020-2021,Premier-League
Caleb Watts,au AUS,MF,Southampton,18.0,2002.0,0.4,2,1,2,0,0,1,2,50.0,1,0,0,0,0,2,0,0,Matches,2020-2021,Premier-League
Adam Webster,eng ENG,DF,Brighton,25.0,1995.0,28.8,29,16,15,10,4,12,25,48.0,13,29,16,13,47,76,92,3,Matches,2020-2021,Premier-League
Danny Welbeck,eng ENG,FW,Brighton,29.0,1990.0,17.2,12,6,2,6,4,7,19,36.8,12,17,0,17,7,19,13,0,Matches,2020-2021,Premier-League
Timo Werner,de GER,"FW,MF",Chelsea,24.0,1996.0,28.9,20,9,6,11,3,7,43,16.3,36,23,1,22,8,28,8,0,Matches,2020-2021,Premier-League
Ashley Westwood,eng ENG,MF,Burnley,30.0,1990.0,37.9,23,15,6,12,5,10,42,23.8,32,26,9,17,44,67,33,0,Matches,2020-2021,Premier-League
Ben White,eng ENG,"DF,MF",Brighton,22.0,1997.0,35.5,49,26,21,24,4,24,57,42.1,33,46,22,24,62,111,56,0,Matches,2020-2021,Premier-League
Georginio Wijnaldum,nl NED,MF,Liverpool,29.0,1990.0,32.7,23,7,6,14,3,7,31,22.6,24,18,3,15,26,49,18,1,Matches,2020-2021,Premier-League
Brandon Williams,eng ENG,DF,Manchester Utd,19.0,2000.0,2.1,0,0,0,0,0,0,1,0.0,1,1,0,1,1,1,7,0,Matches,2020-2021,Premier-League
Neco Williams,wls WAL,DF,Liverpool,19.0,2001.0,2.8,6,5,4,2,0,5,9,55.6,4,3,1,2,6,12,6,0,Matches,2020-2021,Premier-League
Rhys Williams,eng ENG,DF,Liverpool,19.0,2001.0,7.3,6,4,3,3,0,3,3,100.0,0,4,3,1,6,12,27,1,Matches,2020-2021,Premier-League
Willian,br BRA,FW,Arsenal,31.0,1988.0,15.6,13,7,6,6,1,6,16,37.5,10,13,0,13,8,21,8,0,Matches,2020-2021,Premier-League
Joe Willock,eng ENG,MF,Arsenal,20.0,1999.0,2.6,6,3,1,4,1,3,7,42.9,4,6,1,5,3,9,0,0,Matches,2020-2021,Premier-League
Joe Willock,eng ENG,MF,Newcastle Utd,20.0,1999.0,10.9,26,13,16,7,3,9,42,21.4,33,21,3,18,17,43,15,1,Matches,2020-2021,Premier-League
Callum Wilson,eng ENG,FW,Newcastle Utd,28.0,1992.0,23.2,12,5,1,6,5,2,12,16.7,10,10,3,7,7,19,14,0,Matches,2020-2021,Premier-League
Harry Winks,eng ENG,MF,Tottenham,24.0,1996.0,9.6,16,9,11,5,0,5,20,25.0,15,16,4,12,11,27,12,1,Matches,2020-2021,Premier-League
Chris Wood,nz NZL,FW,Burnley,28.0,1991.0,30.5,12,7,2,4,6,5,18,27.8,13,14,3,11,1,13,21,0,Matches,2020-2021,Premier-League
Granit Xhaka,ch SUI,"MF,DF",Arsenal,27.0,1992.0,28.0,50,26,18,17,15,30,58,51.7,28,23,7,16,24,74,38,3,Matches,2020-2021,Premier-League
Andriy Yarmolenko,ua UKR,"FW,MF",West Ham,30.0,1989.0,4.2,5,4,2,2,1,2,8,25.0,6,1,0,1,1,6,2,0,Matches,2020-2021,Premier-League
DeAndre Yedlin,us USA,DF,Newcastle Utd,27.0,1993.0,4.8,9,4,8,1,0,4,10,40.0,6,5,1,4,7,16,17,0,Matches,2020-2021,Premier-League
Okay Yokuşlu,tr TUR,MF,West Brom,26.0,1994.0,14.6,38,25,21,13,4,17,35,48.6,18,15,3,12,35,73,33,1,Matches,2020-2021,Premier-League
Wilfried Zaha,ci CIV,FW,Crystal Palace,27.0,1992.0,29.0,26,18,8,15,3,11,30,36.7,19,21,0,21,9,35,4,0,Matches,2020-2021,Premier-League
Andre-Frank Zambo Anguissa,cm CMR,MF,Fulham,24.0,1995.0,28.7,78,37,27,38,13,27,68,39.7,41,35,6,29,56,134,17,2,Matches,2020-2021,Premier-League
Andi Zeqiri,ch SUI,"FW,DF",Brighton,21.0,1999.0,1.9,3,2,0,2,1,1,2,50.0,1,1,0,1,0,3,2,0,Matches,2020-2021,Premier-League
Oleksandr Zinchenko,ua UKR,DF,Manchester City,23.0,1996.0,16.4,25,15,12,9,4,14,24,58.3,10,17,4,13,23,48,28,0,Matches,2020-2021,Premier-League
Hakim Ziyech,ma MAR,"MF,FW",Chelsea,27.0,1993.0,13.0,14,10,5,7,2,5,19,26.3,14,9,1,8,10,24,2,0,Matches,2020-2021,Premier-League
Kurt Zouma,fr FRA,DF,Chelsea,25.0,1994.0,22.5,16,10,8,6,2,4,8,50.0,4,13,9,4,28,44,93,0,Matches,2020-2021,Premier-League
Martin Ødegaard,no NOR,MF,Arsenal,21.0,1998.0,9.6,9,3,2,6,1,4,14,28.6,10,2,0,2,2,11,5,0,Matches,2020-2021,Premier-League
Max Aarons,eng ENG,DF,Norwich City,21.0,2000.0,32.0,64,44,49,15,0,37,55,67.3,18,39,19,20,28,92,96,1,Matches,2021-2022,Premier-League
Che Adams,sct SCO,FW,Southampton,25.0,1996.0,22.7,13,6,5,5,3,2,16,12.5,14,18,2,16,8,21,18,0,Matches,2021-2022,Premier-League
Rayan Aït-Nouri,dz ALG,"DF,MF",Wolves,20.0,2001.0,20.3,64,36,46,15,3,22,44,50.0,22,24,2,22,22,86,39,1,Matches,2021-2022,Premier-League
Kristoffer Ajer,no NOR,DF,Brentford,23.0,1998.0,22.2,29,18,21,6,2,13,21,61.9,8,19,11,8,26,55,74,0,Matches,2021-2022,Premier-League
Nathan Aké,nl NED,DF,Manchester City,26.0,1995.0,10.3,16,9,7,8,1,6,8,75.0,2,7,5,2,8,24,23,0,Matches,2021-2022,Premier-League
Marc Albrighton,eng ENG,"FW,DF",Leicester City,31.0,1989.0,12.6,31,19,16,9,6,10,47,21.3,37,15,3,12,14,45,20,0,Matches,2021-2022,Premier-League
Thiago Alcántara,es ESP,MF,Liverpool,30.0,1991.0,17.0,48,29,14,24,10,10,42,23.8,32,22,2,20,26,74,13,2,Matches,2021-2022,Premier-League
Trent Alexander-Arnold,eng ENG,DF,Liverpool,22.0,1998.0,31.7,40,23,19,13,8,27,60,45.0,33,22,4,18,43,83,40,0,Matches,2021-2022,Premier-League
Alisson,br BRA,GK,Liverpool,28.0,1992.0,36.0,3,1,3,0,0,3,5,60.0,2,1,0,1,0,3,28,1,Matches,2021-2022,Premier-League
Allan,br BRA,MF,Everton,30.0,1991.0,24.3,74,44,28,39,7,34,105,32.4,71,40,9,31,23,97,39,1,Matches,2021-2022,Premier-League
Dele Alli,eng ENG,MF,Tottenham,25.0,1996.0,7.3,14,8,10,3,1,5,17,29.4,12,22,5,17,6,20,16,0,Matches,2021-2022,Premier-League
Dele Alli,eng ENG,"MF,FW",Everton,25.0,1996.0,3.8,7,2,3,4,0,0,4,0.0,4,7,2,5,6,13,10,0,Matches,2021-2022,Premier-League
Miguel Almirón,py PAR,"MF,FW",Newcastle Utd,27.0,1994.0,19.1,47,29,23,17,7,11,44,25.0,33,14,1,13,20,67,13,0,Matches,2021-2022,Premier-League
Marcos Alonso,es ESP,DF,Chelsea,30.0,1990.0,24.1,41,29,20,12,9,17,36,47.2,19,29,5,24,43,84,53,0,Matches,2021-2022,Premier-League
Steven Alzate,co COL,MF,Brighton,22.0,1998.0,4.5,10,4,4,5,1,4,7,57.1,3,2,1,1,10,20,10,0,Matches,2021-2022,Premier-League
Daniel Amartey,gh GHA,DF,Leicester City,26.0,1994.0,23.6,26,13,19,7,0,19,29,65.5,10,30,22,8,21,47,93,4,Matches,2021-2022,Premier-League
Joachim Andersen,dk DEN,DF,Crystal Palace,25.0,1996.0,32.4,30,23,21,9,0,16,27,59.3,11,29,19,10,37,67,125,3,Matches,2021-2022,Premier-League
Michail Antonio,jm JAM,FW,West Ham,31.0,1990.0,33.0,23,17,5,9,9,7,18,38.9,11,19,1,18,3,26,13,0,Matches,2021-2022,Premier-League
Cameron Archer,eng ENG,"FW,MF",Aston Villa,20.0,2001.0,0.3,0,0,0,0,0,0,0,,0,0,0,0,0,0,0,0,Matches,2021-2022,Premier-League
Alphonse Areola,fr FRA,GK,West Ham,28.0,1993.0,1.0,0,0,0,0,0,0,0,,0,0,0,0,0,0,1,0,Matches,2021-2022,Premier-League
Adam Armstrong,eng ENG,FW,Southampton,24.0,1997.0,15.7,10,4,2,2,6,0,6,0.0,6,13,1,12,3,13,6,0,Matches,2021-2022,Premier-League
Stuart Armstrong,sct SCO,MF,Southampton,29.0,1992.0,16.4,27,19,15,6,6,9,23,39.1,14,10,1,9,8,35,15,0,Matches,2021-2022,Premier-League
Kepa Arrizabalaga,es ESP,GK,Chelsea,26.0,1994.0,4.0,0,0,0,0,0,0,0,,0,0,0,0,0,0,4,0,Matches,2021-2022,Premier-League
Harrison Ashby,sct SCO,DF,West Ham,19.0,2001.0,0.1,0,0,0,0,0,0,0,,0,1,0,1,1,1,1,0,Matches,2021-2022,Premier-League
Pierre-Emerick Aubameyang,ga GAB,FW,Arsenal,32.0,1989.0,11.5,11,5,6,4,1,3,10,30.0,7,12,1,11,0,11,4,0,Matches,2021-2022,Premier-League
Jordan Ayew,gh GHA,FW,Crystal Palace,29.0,1991.0,22.4,47,30,20,20,7,17,31,54.8,14,33,3,30,15,62,15,0,Matches,2021-2022,Premier-League
Luke Ayling,eng ENG,DF,Leeds United,29.0,1991.0,25.2,74,42,46,23,5,51,97,52.6,46,46,25,21,28,102,52,1,Matches,2021-2022,Premier-League
César Azpilicueta,es ESP,DF,Chelsea,31.0,1989.0,23.0,51,28,18,27,6,16,35,45.7,19,32,9,23,23,74,65,1,Matches,2021-2022,Premier-League
Daniel Bachmann,at AUT,GK,Watford,27.0,1994.0,12.0,0,0,0,0,0,0,0,,0,0,0,0,1,1,5,0,Matches,2021-2022,Premier-League
Leon Bailey,jm JAM,"FW,MF",Aston Villa,23.0,1997.0,8.5,17,11,6,8,3,6,13,46.2,7,10,1,9,1,18,2,0,Matches,2021-2022,Premier-League
Eric Bailly,ci CIV,DF,Manchester Utd,27.0,1994.0,2.4,5,4,4,0,1,3,4,75.0,1,4,2,2,3,8,11,0,Matches,2021-2022,Premier-League
Folarin Balogun,us USA,FW,Arsenal,20.0,2001.0,0.8,1,1,0,0,1,0,0,,0,1,0,1,0,1,1,0,Matches,2021-2022,Premier-League
Patrick Bamford,eng ENG,FW,Leeds United,27.0,1993.0,6.2,1,0,0,1,0,0,3,0.0,3,8,2,6,2,3,8,0,Matches,2021-2022,Premier-League
Shandon Baptiste,gd GRN,MF,Brentford,23.0,1998.0,10.1,14,4,9,4,1,6,15,40.0,9,10,0,10,11,25,12,0,Matches,2021-2022,Premier-League
Ross Barkley,eng ENG,"MF,FW",Chelsea,27.0,1993.0,2.0,0,0,0,0,0,0,1,0.0,1,1,0,1,1,1,0,0,Matches,2021-2022,Premier-League
Ashley Barnes,eng ENG,FW,Burnley,31.0,1989.0,9.0,11,2,2,7,2,2,9,22.2,7,8,1,7,2,13,5,0,Matches,2021-2022,Premier-League
Harvey Barnes,eng ENG,"FW,MF",Leicester City,23.0,1997.0,23.3,31,16,9,11,11,7,23,30.4,16,24,1,23,5,36,7,0,Matches,2021-2022,Premier-League
Lewis Bate,eng ENG,MF,Leeds United,18.0,2002.0,1.6,1,0,0,0,1,0,8,0.0,8,1,0,1,1,2,1,0,Matches,2021-2022,Premier-League
Mads Bech Sørensen,dk DEN,DF,Brentford,22.0,1999.0,9.3,8,7,6,2,0,6,7,85.7,1,9,6,3,6,14,25,0,Matches,2021-2022,Premier-League
Jan Bednarek,pl POL,DF,Southampton,25.0,1996.0,29.2,32,15,18,13,1,19,33,57.6,14,48,27,21,72,104,141,0,Matches,2021-2022,Premier-League
Donny van de Beek,nl NED,MF,Manchester Utd,24.0,1997.0,0.8,6,4,4,1,1,1,2,50.0,1,5,1,4,2,8,1,0,Matches,2021-2022,Premier-League
Donny van de Beek,nl NED,MF,Everton,24.0,1997.0,5.4,15,7,8,6,1,6,13,46.2,7,6,2,4,6,21,4,0,Matches,2021-2022,Premier-League
Asmir Begović,ba BIH,GK,Everton,34.0,1987.0,3.0,0,0,0,0,0,0,0,,0,0,0,0,0,0,3,0,Matches,2021-2022,Premier-League
Saïd Benrahma,dz ALG,"FW,MF",West Ham,25.0,1995.0,24.1,28,17,16,9,3,15,38,39.5,23,17,1,16,9,37,8,0,Matches,2021-2022,Premier-League
Rodrigo Bentancur,uy URU,MF,Tottenham,24.0,1997.0,15.1,36,18,14,14,8,16,32,50.0,16,24,9,15,20,56,35,0,Matches,2021-2022,Premier-League
Christian Benteke,be BEL,FW,Crystal Palace,30.0,1990.0,12.7,3,2,1,2,0,2,6,33.3,4,7,3,4,2,5,33,0,Matches,2021-2022,Premier-League
Jóhann Berg Guðmundsson,is ISL,MF,Burnley,30.0,1990.0,12.2,16,6,7,7,2,5,20,25.0,15,11,2,9,12,28,22,0,Matches,2021-2022,Premier-League
Steven Bergwijn,nl NED,"FW,MF",Tottenham,23.0,1997.0,6.3,3,2,2,1,0,1,10,10.0,9,3,0,3,1,4,8,0,Matches,2021-2022,Premier-League
Ryan Bertrand,eng ENG,DF,Leicester City,31.0,1989.0,3.7,8,5,3,4,1,2,5,40.0,3,8,3,5,1,9,7,0,Matches,2021-2022,Premier-League
Mads Bidstrup,dk DEN,MF,Brentford,20.0,2001.0,0.5,1,0,0,1,0,0,3,0.0,3,0,0,0,1,2,2,0,Matches,2021-2022,Premier-League
Yves Bissouma,ml MLI,MF,Brighton,24.0,1996.0,23.5,76,49,35,37,4,21,37,56.8,16,33,3,30,50,126,49,0,Matches,2021-2022,Premier-League
Willy Boly,ci CIV,DF,Wolves,30.0,1991.0,10.0,25,19,18,7,0,8,15,53.3,7,14,6,8,14,39,35,0,Matches,2021-2022,Premier-League
Jarrod Bowen,eng ENG,FW,West Ham,24.0,1996.0,33.1,36,20,20,11,5,17,44,38.6,27,29,2,27,21,57,14,0,Matches,2021-2022,Premier-League
Jarrad Branthwaite,eng ENG,DF,Everton,19.0,2002.0,4.3,4,1,3,1,0,3,8,37.5,5,3,2,1,1,5,20,0,Matches,2021-2022,Premier-League
Armando Broja,al ALB,FW,Southampton,19.0,2001.0,21.9,12,5,2,7,3,2,9,22.2,7,17,1,16,3,15,11,0,Matches,2021-2022,Premier-League
Josh Brownhill,eng ENG,MF,Burnley,25.0,1995.0,32.8,73,37,25,42,6,21,53,39.6,32,37,12,25,68,141,42,1,Matches,2021-2022,Premier-League
Lewis Brunt,eng ENG,MF,Leicester City,20.0,2000.0,0.3,0,0,0,0,0,0,0,,0,1,0,1,0,0,0,0,Matches,2021-2022,Premier-League
Emi Buendía,ar ARG,"MF,FW",Aston Villa,24.0,1996.0,21.1,38,18,16,13,9,21,51,41.2,30,21,3,18,9,47,11,0,Matches,2021-2022,Premier-League
Dan Burn,eng ENG,DF,Newcastle Utd,29.0,1992.0,16.0,16,11,11,4,1,7,11,63.6,4,22,14,8,20,36,101,0,Matches,2021-2022,Premier-League
Dan Burn,eng ENG,DF,Brighton,29.0,1992.0,11.4,22,12,13,8,1,6,15,40.0,9,14,10,4,24,46,51,0,Matches,2021-2022,Premier-League
Jack Butland,eng ENG,GK,Crystal Palace,28.0,1993.0,8.5,0,0,0,0,0,0,0,,0,0,0,0,0,0,1,0,Matches,2021-2022,Premier-League
Sam Byram,eng ENG,DF,Norwich City,27.0,1993.0,11.4,24,15,17,6,1,19,27,70.4,8,21,11,10,22,46,48,0,Matches,2021-2022,Premier-League
Willy Caballero,ar ARG,GK,Southampton,39.0,1981.0,2.0,0,0,0,0,0,0,0,,0,0,0,0,0,0,2,1,Matches,2021-2022,Premier-League
Moisés Caicedo,ec ECU,MF,Brighton,19.0,2001.0,7.3,16,10,7,7,2,5,12,41.7,7,18,4,14,10,26,7,0,Matches,2021-2022,Premier-League
Dominic Calvert-Lewin,eng ENG,FW,Everton,24.0,1997.0,14.3,11,8,1,6,4,3,8,37.5,5,5,2,3,3,14,12,0,Matches,2021-2022,Premier-League
Chem Campbell,wls WAL,MF,Wolves,18.0,2002.0,0.1,1,1,0,1,0,0,0,,0,0,0,0,0,1,0,0,Matches,2021-2022,Premier-League
João Cancelo,pt POR,DF,Manchester City,27.0,1994.0,35.9,83,54,33,35,15,46,91,50.5,45,25,3,22,59,142,45,1,Matches,2021-2022,Premier-League
Sergi Canós,es ESP,"DF,FW",Brentford,24.0,1997.0,23.1,56,25,32,15,9,33,60,55.0,27,32,3,29,22,78,38,0,Matches,2021-2022,Premier-League
Todd Cantwell,eng ENG,"FW,MF",Norwich City,23.0,1998.0,4.9,15,13,8,6,1,6,17,35.3,11,2,0,2,3,18,2,0,Matches,2021-2022,Premier-League
Matty Cash,pl POL,DF,Aston Villa,23.0,1997.0,37.5,89,50,52,34,3,47,78,60.3,31,54,16,38,49,138,100,2,Matches,2021-2022,Premier-League
Timothy Castagne,be BEL,DF,Leicester City,25.0,1995.0,23.6,67,31,38,22,7,27,43,62.8,16,28,9,19,29,96,54,1,Matches,2021-2022,Premier-League
Jonny Castro,es ESP,DF,Wolves,27.0,1994.0,11.4,25,15,13,11,1,11,20,55.0,9,14,3,11,13,38,11,0,Matches,2021-2022,Premier-League
Craig Cathcart,nir NIR,DF,Watford,32.0,1989.0,26.6,32,15,25,6,1,16,30,53.3,14,39,29,10,28,60,132,3,Matches,2021-2022,Premier-League
Edinson Cavani,uy URU,FW,Manchester Utd,34.0,1987.0,8.5,4,1,0,3,1,2,8,25.0,6,6,0,6,2,6,8,0,Matches,2021-2022,Premier-League
Kayky Chagas,br BRA,FW,Manchester City,18.0,2003.0,0.1,0,0,0,0,0,0,0,,0,0,0,0,0,0,0,0,Matches,2021-2022,Premier-League
Trevoh Chalobah,eng ENG,DF,Chelsea,22.0,1999.0,16.1,40,27,22,18,0,24,31,77.4,7,16,6,10,19,59,43,2,Matches,2021-2022,Premier-League
Calum Chambers,eng ENG,DF,Arsenal,26.0,1995.0,1.9,5,3,3,1,1,3,4,75.0,1,6,3,3,0,5,10,0,Matches,2021-2022,Premier-League
Calum Chambers,eng ENG,DF,Aston Villa,26.0,1995.0,9.2,16,8,10,6,0,4,6,66.7,2,14,8,6,5,21,42,0,Matches,2021-2022,Premier-League
Daniel Chesters,eng ENG,MF,West Ham,19.0,2002.0,0.0,0,0,0,0,0,0,0,,0,0,0,0,0,0,0,0,Matches,2021-2022,Premier-League
Ben Chilwell,eng ENG,DF,Chelsea,24.0,1996.0,6.0,8,3,2,6,0,2,5,40.0,3,7,0,7,4,12,14,1,Matches,2021-2022,Premier-League
Chiquinho,pt POR,"DF,FW",Wolves,21.0,2000.0,2.3,9,6,4,5,0,4,5,80.0,1,5,0,5,2,11,1,0,Matches,2021-2022,Premier-League
Hamza Choudhury,bd BAN,"DF,MF",Leicester City,23.0,1997.0,3.2,9,3,4,4,1,3,5,60.0,2,0,0,0,12,21,10,0,Matches,2021-2022,Premier-League
Andreas Christensen,dk DEN,DF,Chelsea,25.0,1996.0,16.6,14,8,9,4,1,4,7,57.1,3,14,6,8,29,43,57,1,Matches,2021-2022,Premier-League
Carney Chukwuemeka,eng ENG,"MF,FW",Aston Villa,17.0,2003.0,3.3,7,1,2,5,0,3,5,60.0,2,3,0,3,1,8,2,1,Matches,2021-2022,Premier-League
Ciaran Clark,ie IRL,DF,Newcastle Utd,31.0,1989.0,11.3,13,10,4,7,2,9,14,64.3,5,14,11,3,13,26,43,1,Matches,2021-2022,Premier-League
Tom Cleverley,eng ENG,MF,Watford,31.0,1989.0,18.0,37,20,19,17,1,18,33,54.5,15,23,6,17,18,55,19,3,Matches,2021-2022,Premier-League
Nathaniel Clyne,eng ENG,DF,Crystal Palace,30.0,1991.0,15.0,21,10,11,9,1,10,20,50.0,10,7,2,5,15,36,32,0,Matches,2021-2022,Premier-League
Conor Coady,eng ENG,DF,Wolves,28.0,1993.0,37.3,31,14,23,7,1,16,28,57.1,12,46,40,6,28,59,140,0,Matches,2021-2022,Premier-League
Séamus Coleman,ie IRL,DF,Everton,32.0,1988.0,29.5,61,36,35,16,10,33,51,64.7,18,30,11,19,32,93,80,2,Matches,2021-2022,Premier-League
Nathan Collins,ie IRL,DF,Burnley,20.0,2001.0,18.6,37,15,27,8,2,17,27,63.0,10,38,25,13,24,61,83,2,Matches,2021-2022,Premier-League
Aaron Connolly,ie IRL,"FW,MF",Brighton,21.0,2000.0,1.7,0,0,0,0,0,0,1,0.0,1,2,0,2,0,0,0,0,Matches,2021-2022,Premier-League
Liam Cooper,sct SCO,DF,Leeds United,29.0,1991.0,20.2,41,23,27,13,1,23,33,69.7,10,29,18,11,43,84,72,2,Matches,2021-2022,Premier-League
Jack Cork,eng ENG,MF,Burnley,32.0,1989.0,18.6,20,6,6,11,3,7,20,35.0,13,17,4,13,17,37,29,1,Matches,2021-2022,Premier-League
Maxwel Cornet,ci CIV,"FW,MF",Burnley,24.0,1996.0,19.6,16,9,7,5,4,7,15,46.7,8,13,4,9,10,26,14,0,Matches,2021-2022,Premier-League
Hélder Costa,ao ANG,MF,Leeds United,27.0,1994.0,0.2,0,0,0,0,0,0,0,,0,1,0,1,0,0,0,0,Matches,2021-2022,Premier-League
Vladimír Coufal,cz CZE,DF,West Ham,28.0,1992.0,24.5,45,25,24,14,7,18,36,50.0,18,31,9,22,22,67,64,1,Matches,2021-2022,Premier-League
Philippe Coutinho,br BRA,"MF,FW",Aston Villa,29.0,1992.0,14.8,17,12,4,11,2,6,21,28.6,15,11,1,10,7,24,4,0,Matches,2021-2022,Premier-League
Aaron Cresswell,eng ENG,DF,West Ham,31.0,1989.0,30.3,28,18,18,6,4,13,25,52.0,12,31,18,13,35,63,66,0,Matches,2021-2022,Premier-League
Charlie Cresswell,eng ENG,DF,Leeds United,18.0,2002.0,1.6,5,2,1,4,0,3,3,100.0,0,1,1,0,2,7,6,0,Matches,2021-2022,Premier-League
Cucho,co COL,"FW,MF",Watford,22.0,1999.0,12.7,13,5,5,5,3,5,27,18.5,22,13,1,12,5,18,9,0,Matches,2021-2022,Premier-League
Marc Cucurella,es ESP,DF,Brighton,23.0,1998.0,34.3,93,62,43,32,18,44,71,62.0,27,42,14,28,30,123,74,0,Matches,2021-2022,Premier-League
Luke Cundle,eng ENG,MF,Wolves,19.0,2002.0,2.0,4,3,0,4,0,1,1,100.0,0,0,0,0,1,5,1,0,Matches,2021-2022,Premier-League
Patson Daka,zm ZAM,FW,Leicester City,22.0,1998.0,12.9,15,10,2,8,5,2,19,10.5,17,7,0,7,2,17,8,0,Matches,2021-2022,Premier-League
Stuart Dallas,nir NIR,"DF,MF",Leeds United,30.0,1991.0,32.4,93,55,58,31,4,56,105,53.3,49,45,14,31,57,150,63,2,Matches,2021-2022,Premier-League
Diogo Dalot,pt POR,DF,Manchester Utd,22.0,1999.0,20.0,55,41,35,12,8,31,57,54.4,26,24,13,11,29,84,59,0,Matches,2021-2022,Premier-League
Karl Darlow,wls WAL,GK,Newcastle Utd,30.0,1990.0,8.0,0,0,0,0,0,0,0,,0,0,0,0,0,0,5,1,Matches,2021-2022,Premier-League
Josh Dasilva,eng ENG,"MF,FW",Brentford,22.0,1998.0,2.9,2,1,0,1,1,1,2,50.0,1,3,0,3,1,3,7,0,Matches,2021-2022,Premier-League
Ben Davies,wls WAL,DF,Tottenham,28.0,1993.0,28.2,36,21,20,12,4,13,26,50.0,13,32,19,13,30,66,75,1,Matches,2021-2022,Premier-League
Tom Davies,eng ENG,MF,Everton,23.0,1998.0,2.6,3,1,1,1,1,2,5,40.0,3,2,1,1,2,5,9,0,Matches,2021-2022,Premier-League
Keinan Davis,eng ENG,FW,Aston Villa,23.0,1998.0,0.1,0,0,0,0,0,0,0,,0,0,0,0,0,0,0,0,Matches,2021-2022,Premier-League
Craig Dawson,eng ENG,DF,West Ham,31.0,1990.0,30.6,29,17,20,8,1,14,25,56.0,11,59,52,7,29,58,139,0,Matches,2021-2022,Premier-League
Kevin De Bruyne,be BEL,MF,Manchester City,30.0,1991.0,24.5,32,16,4,15,13,12,37,32.4,25,32,2,30,6,38,16,0,Matches,2021-2022,Premier-League
Troy Deeney,eng ENG,FW,Watford,33.0,1988.0,0.3,0,0,0,0,0,0,1,0.0,1,0,0,0,0,0,2,0,Matches,2021-2022,Premier-League
Liam Delap,eng ENG,FW,Manchester City,18.0,2003.0,0.1,0,0,0,0,0,0,0,,0,0,0,0,0,0,0,0,Matches,2021-2022,Premier-League
Fabian Delph,eng ENG,MF,Everton,31.0,1989.0,7.4,18,15,10,7,1,8,21,38.1,13,12,5,7,14,32,10,0,Matches,2021-2022,Premier-League
Leander Dendoncker,be BEL,MF,Wolves,26.0,1995.0,21.7,42,17,25,14,3,22,50,44.0,28,37,10,27,9,51,38,1,Matches,2021-2022,Premier-League
Emmanuel Dennis,ng NGA,"FW,MF",Watford,23.0,1997.0,28.7,51,35,20,22,9,17,52,32.7,35,36,2,34,15,66,13,0,Matches,2021-2022,Premier-League
Kiernan Dewsbury-Hall,eng ENG,MF,Leicester City,22.0,1998.0,23.4,39,24,20,14,5,19,40,47.5,21,37,8,29,21,60,26,1,Matches,2021-2022,Premier-League
Ibrahima Diallo,fr FRA,MF,Southampton,22.0,1999.0,11.4,22,11,10,9,3,10,24,41.7,14,7,0,7,9,31,10,0,Matches,2021-2022,Premier-League
Rúben Dias,pt POR,DF,Manchester City,24.0,1997.0,26.7,26,19,11,12,3,8,15,53.3,7,19,13,6,23,49,66,0,Matches,2021-2022,Premier-League
Luis Díaz,co COL,FW,Liverpool,24.0,1997.0,10.6,9,7,3,5,1,2,8,25.0,6,7,0,7,4,13,2,0,Matches,2021-2022,Premier-League
Eric Dier,eng ENG,DF,Tottenham,27.0,1994.0,34.1,15,9,6,8,1,7,14,50.0,7,37,32,5,27,42,142,1,Matches,2021-2022,Premier-League
Lucas Digne,fr FRA,DF,Aston Villa,28.0,1993.0,14.1,13,10,8,3,2,9,19,47.4,10,15,8,7,23,36,40,0,Matches,2021-2022,Premier-League
Lucas Digne,fr FRA,DF,Everton,28.0,1993.0,13.0,33,19,26,4,3,21,28,75.0,7,16,5,11,14,47,30,0,Matches,2021-2022,Premier-League
Issa Diop,fr FRA,DF,West Ham,24.0,1997.0,10.7,10,8,5,5,0,4,11,36.4,7,14,13,1,7,17,44,0,Matches,2021-2022,Premier-League
Moussa Djenepo,ml MLI,MF,Southampton,23.0,1998.0,5.1,9,3,3,5,1,3,11,27.3,8,6,1,5,2,11,6,1,Matches,2021-2022,Premier-League
Lewis Dobbin,eng ENG,"FW,MF",Everton,18.0,2003.0,0.4,2,1,0,1,1,1,2,50.0,1,0,0,0,0,2,0,0,Matches,2021-2022,Premier-League
Matt Doherty,ie IRL,DF,Tottenham,29.0,1992.0,9.7,18,12,5,11,2,8,14,57.1,6,11,2,9,13,31,20,0,Matches,2021-2022,Premier-League
Abdoulaye Doucouré,ml MLI,MF,Everton,28.0,1993.0,28.2,75,43,30,37,8,32,71,45.1,39,33,8,25,28,103,32,0,Matches,2021-2022,Premier-League
Kieran Dowell,eng ENG,"FW,MF",Norwich City,23.0,1997.0,10.1,18,7,8,7,3,9,32,28.1,23,10,1,9,7,25,4,0,Matches,2021-2022,Premier-League
Cody Drameh,eng ENG,"DF,MF",Leeds United,19.0,2001.0,1.4,4,2,3,1,0,1,3,33.3,2,0,0,0,1,5,4,0,Matches,2021-2022,Premier-League
Martin Dúbravka,sk SVK,GK,Newcastle Utd,32.0,1989.0,26.0,1,1,1,0,0,0,1,0.0,1,0,0,0,0,1,8,2,Matches,2021-2022,Premier-League
Shane Duffy,ie IRL,DF,Brighton,29.0,1992.0,16.0,15,12,12,3,0,8,14,57.1,6,24,18,6,16,31,76,1,Matches,2021-2022,Premier-League
Paul Dummett,wls WAL,DF,Newcastle Utd,29.0,1991.0,2.2,7,3,3,4,0,5,8,62.5,3,5,0,5,3,10,5,0,Matches,2021-2022,Premier-League
Lewis Dunk,eng ENG,DF,Brighton,29.0,1991.0,28.6,10,8,5,5,0,5,11,45.5,6,32,28,4,27,37,113,3,Matches,2021-2022,Premier-League
Ederson,br BRA,GK,Manchester City,27.0,1993.0,37.0,2,1,2,0,0,0,2,0.0,2,0,0,0,0,2,12,0,Matches,2021-2022,Premier-League
Odsonne Édouard,fr FRA,FW,Crystal Palace,23.0,1998.0,17.4,16,10,2,7,7,7,21,33.3,14,20,5,15,0,16,18,0,Matches,2021-2022,Premier-League
CJ Egan-Riley,eng ENG,DF,Manchester City,18.0,2003.0,0.0,1,1,1,0,0,1,1,100.0,0,0,0,0,0,1,0,0,Matches,2021-2022,Premier-League
Anthony Elanga,se SWE,FW,Manchester Utd,19.0,2002.0,13.5,26,20,12,12,2,15,29,51.7,14,17,1,16,9,35,7,0,Matches,2021-2022,Premier-League
Harvey Elliott,eng ENG,MF,Liverpool,18.0,2003.0,3.8,3,0,1,1,1,0,6,0.0,6,8,1,7,4,7,2,0,Matches,2021-2022,Premier-League
Mohamed Elneny,eg EGY,MF,Arsenal,29.0,1992.0,9.0,16,8,10,5,1,7,12,58.3,5,7,1,6,14,30,13,0,Matches,2021-2022,Premier-League
Mohamed Elyounoussi,no NOR,"MF,FW",Southampton,26.0,1994.0,22.7,36,17,14,15,7,11,39,28.2,28,23,2,21,12,48,28,0,Matches,2021-2022,Premier-League
Emerson,br BRA,"DF,MF",Tottenham,22.0,1999.0,25.4,72,47,50,16,6,36,67,53.7,31,25,2,23,22,94,92,1,Matches,2021-2022,Premier-League
Christian Eriksen,dk DEN,MF,Brentford,29.0,1992.0,10.4,13,6,4,5,4,8,17,47.1,9,9,1,8,9,22,14,0,Matches,2021-2022,Premier-League
Oghenekaro Etebo,ng NGA,MF,Watford,25.0,1995.0,4.5,11,8,7,4,0,3,8,37.5,5,3,1,2,5,16,5,0,Matches,2021-2022,Premier-League
Jonny Evans,nir NIR,DF,Leicester City,33.0,1988.0,15.0,24,14,14,8,2,14,22,63.6,8,17,13,4,20,44,59,0,Matches,2021-2022,Premier-League
Eberechi Eze,eng ENG,"MF,FW",Crystal Palace,23.0,1998.0,6.7,10,6,5,2,3,6,11,54.5,5,4,1,3,5,15,1,0,Matches,2021-2022,Premier-League
Łukasz Fabiański,pl POL,GK,West Ham,36.0,1985.0,37.0,0,0,0,0,0,0,0,,0,0,0,0,0,0,11,0,Matches,2021-2022,Premier-League
Fabinho,br BRA,MF,Liverpool,27.0,1993.0,25.7,46,25,17,23,6,24,70,34.3,46,33,10,23,39,85,25,1,Matches,2021-2022,Premier-League
Kiko Femenía,es ESP,DF,Watford,30.0,1991.0,23.8,35,22,23,10,2,21,37,56.8,16,24,8,16,37,72,51,0,Matches,2021-2022,Premier-League
Evan Ferguson,ie IRL,MF,Brighton,16.0,2004.0,0.3,0,0,0,0,0,0,0,,0,0,0,0,0,0,0,0,Matches,2021-2022,Premier-League
Nathan Ferguson,eng ENG,DF,Crystal Palace,20.0,2000.0,0.1,0,0,0,0,0,0,0,,0,0,0,0,0,0,0,0,Matches,2021-2022,Premier-League
Bruno Fernandes,pt POR,MF,Manchester Utd,26.0,1994.0,34.6,54,28,26,22,6,26,91,28.6,65,36,0,36,17,71,42,2,Matches,2021-2022,Premier-League
Álvaro Fernández,es ESP,GK,Brentford,23.0,1998.0,12.0,0,0,0,0,0,0,0,,0,0,0,0,0,0,5,2,Matches,2021-2022,Premier-League
Federico Fernández,ar ARG,DF,Newcastle Utd,32.0,1989.0,5.8,3,0,3,0,0,2,5,40.0,3,10,10,0,4,7,28,0,Matches,2021-2022,Premier-League
Fernandinho,br BRA,"MF,DF",Manchester City,36.0,1985.0,10.7,21,10,7,10,4,9,27,33.3,18,8,2,6,8,29,13,1,Matches,2021-2022,Premier-League
Roberto Firmino,br BRA,FW,Liverpool,29.0,1991.0,11.0,23,14,5,8,10,3,16,18.8,13,20,0,20,4,27,3,0,Matches,2021-2022,Premier-League
Junior Firpo,do DOM,"DF,MF",Leeds United,24.0,1996.0,19.0,61,29,30,26,5,31,59,52.5,28,22,6,16,24,85,37,0,Matches,2021-2022,Premier-League
Ashley Fletcher,eng ENG,FW,Watford,25.0,1995.0,0.3,2,1,1,1,0,1,1,100.0,0,1,1,0,0,2,0,0,Matches,2021-2022,Premier-League
Phil Foden,eng ENG,FW,Manchester City,21.0,2000.0,23.6,16,8,10,4,2,7,17,41.2,10,9,0,9,11,27,5,0,Matches,2021-2022,Premier-League
Wesley Fofana,fr FRA,DF,Leicester City,20.0,2000.0,7.0,12,8,11,1,0,7,11,63.6,4,5,2,3,12,24,26,1,Matches,2021-2022,Premier-League
Pablo Fornals,es ESP,"FW,MF",West Ham,25.0,1996.0,31.1,54,28,21,21,12,22,84,26.2,62,49,2,47,27,81,16,1,Matches,2021-2022,Premier-League
Adam Forshaw,eng ENG,MF,Leeds United,29.0,1991.0,17.0,53,23,21,27,5,21,54,38.9,33,17,1,16,19,72,12,2,Matches,2021-2022,Premier-League
Marcus Forss,fi FIN,"FW,MF",Brentford,22.0,1999.0,2.3,3,3,0,2,1,2,4,50.0,2,5,0,5,1,4,0,0,Matches,2021-2022,Premier-League
Fraser Forster,eng ENG,GK,Southampton,33.0,1988.0,19.0,1,0,1,0,0,0,1,0.0,1,0,0,0,0,1,23,2,Matches,2021-2022,Premier-League
Ben Foster,eng ENG,GK,Watford,38.0,1983.0,26.0,0,0,0,0,0,0,3,0.0,3,0,0,0,0,0,9,4,Matches,2021-2022,Premier-League
Tariqe Fosu,gh GHA,DF,Brentford,25.0,1995.0,0.2,0,0,0,0,0,0,0,,0,1,0,1,0,0,0,0,Matches,2021-2022,Premier-League
Ryan Fraser,sct SCO,"FW,MF",Newcastle Utd,27.0,1994.0,16.3,10,3,5,3,2,5,13,38.5,8,11,1,10,11,21,11,0,Matches,2021-2022,Premier-League
Fred,br BRA,MF,Manchester Utd,28.0,1993.0,22.5,63,27,32,24,7,22,79,27.8,57,38,11,27,32,95,24,0,Matches,2021-2022,Premier-League
Ryan Fredericks,eng ENG,DF,West Ham,28.0,1992.0,3.4,2,2,2,0,0,0,1,0.0,1,2,1,1,4,6,6,0,Matches,2021-2022,Premier-League
Leo Fuhr Hjelde,no NOR,"MF,DF",Leeds United,17.0,2003.0,1.7,5,4,3,2,0,3,3,100.0,0,3,3,0,4,9,7,0,Matches,2021-2022,Premier-League
Conor Gallagher,eng ENG,MF,Crystal Palace,21.0,2000.0,31.6,69,38,35,20,14,21,69,30.4,48,58,9,49,29,98,26,0,Matches,2021-2022,Premier-League
Alejandro Garnacho,ar ARG,"FW,MF",Manchester Utd,17.0,2004.0,0.1,0,0,0,0,0,0,1,0.0,1,0,0,0,0,0,0,0,Matches,2021-2022,Premier-League
Dwight Gayle,eng ENG,"FW,DF",Newcastle Utd,30.0,1990.0,0.4,1,0,0,1,0,0,1,0.0,1,0,0,0,1,2,0,0,Matches,2021-2022,Premier-League
Jean-Philippe Gbamin,ci CIV,MF,Everton,25.0,1995.0,0.7,1,1,1,0,0,0,2,0.0,2,0,0,0,1,2,1,0,Matches,2021-2022,Premier-League
David de Gea,es ESP,GK,Manchester Utd,30.0,1990.0,38.0,0,0,0,0,0,0,0,,0,0,0,0,0,0,11,2,Matches,2021-2022,Premier-League
Joe Gelhardt,eng ENG,"FW,MF",Leeds United,19.0,2002.0,8.3,4,3,1,0,3,2,10,20.0,8,9,0,9,0,4,3,0,Matches,2021-2022,Premier-League
Anwar El Ghazi,nl NED,"FW,MF",Aston Villa,26.0,1995.0,4.3,4,4,2,2,0,2,7,28.6,5,6,0,6,1,5,2,0,Matches,2021-2022,Premier-League
Anwar El Ghazi,nl NED,"FW,MF",Everton,26.0,1995.0,0.1,1,1,1,0,0,1,1,100.0,0,3,0,3,0,1,0,0,Matches,2021-2022,Premier-League
Saman Ghoddos,ir IRN,"MF,DF",Brentford,27.0,1993.0,6.0,17,10,8,6,3,9,15,60.0,6,2,0,2,3,20,16,0,Matches,2021-2022,Premier-League
Dimitris Giannoulis,gr GRE,DF,Norwich City,25.0,1995.0,13.0,36,21,17,17,2,24,36,66.7,12,22,6,16,19,55,41,1,Matches,2021-2022,Premier-League
Morgan Gibbs-White,eng ENG,"DF,FW",Wolves,21.0,2000.0,0.1,0,0,0,0,0,0,0,,0,1,0,1,0,0,0,0,Matches,2021-2022,Premier-League
Ben Gibson,eng ENG,DF,Norwich City,28.0,1993.0,27.7,23,16,17,6,0,7,12,58.3,5,36,30,6,27,50,139,2,Matches,2021-2022,Premier-League
Bryan Gil,es ESP,"FW,MF",Tottenham,20.0,2001.0,1.0,3,0,1,0,2,1,2,50.0,1,2,0,2,0,3,0,0,Matches,2021-2022,Premier-League
Billy Gilmour,sct SCO,MF,Norwich City,20.0,2001.0,20.6,41,21,16,21,4,14,52,26.9,38,21,4,17,17,58,29,0,Matches,2021-2022,Premier-League
Ben Godfrey,eng ENG,DF,Everton,23.0,1998.0,22.5,47,32,29,14,4,24,39,61.5,15,41,19,22,15,62,100,2,Matches,2021-2022,Premier-League
André Gomes,pt POR,MF,Everton,28.0,1993.0,6.9,16,4,6,6,4,8,32,25.0,24,8,2,6,1,17,7,1,Matches,2021-2022,Premier-League
Toti Gomes,pt POR,DF,Wolves,22.0,1999.0,4.0,11,7,10,1,0,7,9,77.8,2,6,3,3,8,19,15,0,Matches,2021-2022,Premier-League
Joe Gomez,eng ENG,DF,Liverpool,24.0,1997.0,3.7,10,6,5,2,3,5,9,55.6,4,4,1,3,5,15,6,0,Matches,2021-2022,Premier-League
Charlie Goode,eng ENG,DF,Brentford,25.0,1995.0,5.0,7,5,5,2,0,4,4,100.0,0,4,2,2,2,9,8,0,Matches,2021-2022,Premier-League
Anthony Gordon,eng ENG,"MF,FW",Everton,20.0,2001.0,25.4,54,32,20,30,4,21,59,35.6,38,49,3,46,22,76,17,0,Matches,2021-2022,Premier-League
Kaide Gordon,eng ENG,FW,Liverpool,16.0,2004.0,0.1,1,0,0,0,1,0,0,,0,0,0,0,0,1,0,0,Matches,2021-2022,Premier-League
Dan Gosling,eng ENG,MF,Watford,31.0,1990.0,1.8,2,1,1,1,0,2,6,33.3,4,2,0,2,0,2,3,0,Matches,2021-2022,Premier-League
Demarai Gray,jm JAM,"MF,FW",Everton,25.0,1996.0,26.0,30,19,13,10,7,10,22,45.5,12,30,2,28,15,45,21,1,Matches,2021-2022,Premier-League
Jack Grealish,eng ENG,FW,Manchester City,25.0,1995.0,21.3,18,17,4,10,4,5,13,38.5,8,11,1,10,8,26,7,0,Matches,2021-2022,Premier-League
Mason Greenwood,eng ENG,"FW,MF",Manchester Utd,19.0,2001.0,14.1,15,9,9,1,5,3,9,33.3,6,5,0,5,1,16,6,0,Matches,2021-2022,Premier-League
Sam Greenwood,eng ENG,"MF,FW",Leeds United,19.0,2002.0,2.6,8,5,0,5,3,4,7,57.1,3,3,0,3,2,10,1,0,Matches,2021-2022,Premier-League
Pascal Groß,de GER,"MF,DF",Brighton,30.0,1991.0,22.6,28,15,15,11,2,12,33,36.4,21,34,8,26,18,46,23,0,Matches,2021-2022,Premier-League
Vicente Guaita,es ESP,GK,Crystal Palace,34.0,1987.0,29.5,1,0,1,0,0,1,1,100.0,0,0,0,0,1,2,8,1,Matches,2021-2022,Premier-League
Marc Guéhi,eng ENG,DF,Crystal Palace,21.0,2000.0,35.8,35,17,24,10,1,15,16,93.8,1,34,26,8,30,65,127,0,Matches,2021-2022,Premier-League
Bruno Guimarães,br BRA,MF,Newcastle Utd,23.0,1997.0,11.5,44,23,18,22,4,21,38,55.3,17,25,6,19,9,53,13,0,Matches,2021-2022,Premier-League
İlkay Gündoğan,de GER,MF,Manchester City,30.0,1990.0,20.6,23,9,10,12,1,12,31,38.7,19,11,1,10,15,38,10,0,Matches,2021-2022,Premier-League
Angus Gunn,sct SCO,GK,Norwich City,25.0,1996.0,9.0,0,0,0,0,0,0,0,,0,0,0,0,0,0,11,0,Matches,2021-2022,Premier-League
Grant Hanley,sct SCO,DF,Norwich City,29.0,1991.0,32.2,44,25,28,14,2,18,35,51.4,17,56,45,11,56,100,176,2,Matches,2021-2022,Premier-League
Jack Harrison,eng ENG,"FW,MF",Leeds United,24.0,1996.0,29.3,57,37,22,22,13,31,76,40.8,45,35,1,34,21,78,19,0,Matches,2021-2022,Premier-League
Kortney Hause,eng ENG,DF,Aston Villa,26.0,1995.0,4.4,3,3,2,0,1,3,4,75.0,1,8,5,3,6,9,13,0,Matches,2021-2022,Premier-League
Kai Havertz,de GER,"FW,MF",Chelsea,22.0,1999.0,20.1,17,8,5,7,5,4,14,28.6,10,28,1,27,4,21,32,1,Matches,2021-2022,Premier-League
Isaac Hayden,eng ENG,"MF,DF",Newcastle Utd,26.0,1995.0,11.1,28,14,11,14,3,12,29,41.4,17,17,8,9,14,42,24,0,Matches,2021-2022,Premier-League
Hwang Hee-chan,kr KOR,"FW,MF",Wolves,25.0,1996.0,20.2,27,13,9,16,2,14,44,31.8,30,10,0,10,13,40,7,1,Matches,2021-2022,Premier-League
Jordan Henderson,eng ENG,MF,Liverpool,31.0,1990.0,28.9,36,20,9,25,2,17,44,38.6,27,25,1,24,23,59,14,0,Matches,2021-2022,Premier-League
Jeff Hendrick,ie IRL,MF,Newcastle Utd,29.0,1992.0,0.8,1,1,0,1,0,1,1,100.0,0,0,0,0,0,1,1,0,Matches,2021-2022,Premier-League
Wayne Hennessey,wls WAL,GK,Burnley,34.0,1987.0,2.0,0,0,0,0,0,0,0,,0,0,0,0,1,1,0,1,Matches,2021-2022,Premier-League
Rico Henry,eng ENG,DF,Brentford,24.0,1997.0,30.8,28,20,18,8,2,12,34,35.3,22,31,10,21,26,54,76,1,Matches,2021-2022,Premier-League
Son Heung-min,kr KOR,"MF,FW",Tottenham,29.0,1992.0,33.4,15,6,5,7,3,5,23,21.7,18,27,6,21,13,28,8,0,Matches,2021-2022,Premier-League
Ki-Jana Hoever,nl NED,"DF,MF",Wolves,19.0,2002.0,3.4,10,6,5,5,0,7,12,58.3,5,6,0,6,6,16,8,0,Matches,2021-2022,Premier-League
Rob Holding,eng ENG,DF,Arsenal,25.0,1995.0,9.4,13,9,11,1,1,5,6,83.3,1,23,18,5,10,23,42,1,Matches,2021-2022,Premier-League
Mason Holgate,eng ENG,DF,Everton,24.0,1996.0,23.7,35,18,26,9,0,11,26,42.3,15,25,17,8,26,61,95,1,Matches,2021-2022,Premier-League
Callum Hudson-Odoi,eng ENG,"MF,FW",Chelsea,20.0,2000.0,10.7,14,10,5,6,3,8,23,34.8,15,8,0,8,2,16,6,1,Matches,2021-2022,Premier-League
Will Hughes,eng ENG,MF,Crystal Palace,26.0,1995.0,11.7,29,14,10,16,3,7,16,43.8,9,13,7,6,8,37,10,0,Matches,2021-2022,Premier-League
Pierre Højbjerg,dk DEN,MF,Tottenham,25.0,1995.0,35.5,78,45,31,38,9,38,85,44.7,47,61,13,48,48,126,54,0,Matches,2021-2022,Premier-League
Adam Idah,ie IRL,"FW,MF",Norwich City,20.0,2001.0,6.9,9,6,2,5,2,2,3,66.7,1,4,2,2,3,12,7,0,Matches,2021-2022,Premier-League
Kelechi Iheanacho,ng NGA,FW,Leicester City,24.0,1996.0,14.0,10,7,2,5,3,3,14,21.4,11,19,0,19,4,14,10,0,Matches,2021-2022,Premier-League
Danny Ings,eng ENG,FW,Aston Villa,29.0,1992.0,21.1,23,16,2,16,5,13,37,35.1,24,31,2,29,6,29,22,0,Matches,2021-2022,Premier-League
Tim Iroegbunam,eng ENG,MF,Aston Villa,18.0,2003.0,1.0,5,4,2,3,0,1,1,100.0,0,0,0,0,2,7,1,0,Matches,2021-2022,Premier-League
Alex Iwobi,ng NGA,"MF,DF",Everton,25.0,1996.0,22.6,40,19,23,12,5,21,52,40.4,31,39,3,36,20,60,25,2,Matches,2021-2022,Premier-League
Daniel James,wls WAL,FW,Manchester Utd,23.0,1997.0,1.4,2,1,0,2,0,0,0,,0,2,0,2,0,2,1,0,Matches,2021-2022,Premier-League
Daniel James,wls WAL,"FW,MF",Leeds United,23.0,1997.0,26.3,24,14,8,8,8,10,23,43.5,13,18,1,17,8,32,12,0,Matches,2021-2022,Premier-League
Reece James,eng ENG,DF,Chelsea,21.0,1999.0,20.7,33,25,14,18,1,9,22,40.9,13,20,2,18,17,50,22,0,Matches,2021-2022,Premier-League
Vitaly Janelt,de GER,MF,Brentford,23.0,1998.0,25.5,61,32,26,27,8,27,53,50.9,26,23,7,16,28,89,35,0,Matches,2021-2022,Premier-League
Pontus Jansson,se SWE,DF,Brentford,30.0,1991.0,36.9,40,21,32,8,0,22,34,64.7,12,37,27,10,52,92,187,0,Matches,2021-2022,Premier-League
Mathias Jensen,dk DEN,MF,Brentford,25.0,1996.0,17.8,33,18,12,16,5,22,63,34.9,41,32,3,29,22,55,13,0,Matches,2021-2022,Premier-League
Gabriel Jesus,br BRA,FW,Manchester City,24.0,1997.0,20.9,18,12,2,4,12,6,26,23.1,20,18,0,18,15,33,8,0,Matches,2021-2022,Premier-League
Raúl Jiménez,mx MEX,FW,Wolves,30.0,1991.0,29.2,29,14,6,16,7,6,30,20.0,24,31,5,26,13,42,26,0,Matches,2021-2022,Premier-League
João Pedro,br BRA,"FW,MF",Watford,19.0,2001.0,18.3,20,14,7,8,5,6,23,26.1,17,23,3,20,15,35,17,0,Matches,2021-2022,Premier-League
Joelinton,br BRA,"MF,FW",Newcastle Utd,24.0,1996.0,28.4,72,38,30,33,9,26,61,42.6,35,46,11,35,34,106,50,2,Matches,2021-2022,Premier-League
Ben Johnson,eng ENG,DF,West Ham,21.0,2000.0,15.5,33,16,15,15,3,21,28,75.0,7,16,8,8,22,55,55,0,Matches,2021-2022,Premier-League
Curtis Jones,eng ENG,MF,Liverpool,20.0,2001.0,9.5,11,9,3,6,2,1,10,10.0,9,4,0,4,6,17,4,0,Matches,2021-2022,Premier-League
Phil Jones,eng ENG,DF,Manchester Utd,29.0,1992.0,1.8,5,5,3,1,1,2,3,66.7,1,4,4,0,3,8,8,0,Matches,2021-2022,Premier-League
Jorginho,it ITA,MF,Chelsea,29.0,1991.0,25.3,64,33,27,31,6,29,83,34.9,54,27,4,23,36,100,21,1,Matches,2021-2022,Premier-League
Diogo Jota,pt POR,FW,Liverpool,24.0,1996.0,26.3,39,18,12,18,9,13,55,23.6,42,19,2,17,6,45,6,0,Matches,2021-2022,Premier-League
James Justin,eng ENG,DF,Leicester City,23.0,1998.0,11.1,22,13,11,8,3,7,15,46.7,8,16,4,12,17,39,34,0,Matches,2021-2022,Premier-League
Mathias Jørgensen,dk DEN,DF,Brentford,31.0,1990.0,5.8,10,4,3,5,2,7,10,70.0,3,6,1,5,10,20,13,0,Matches,2021-2022,Premier-League
Ozan Kabak,tr TUR,DF,Norwich City,21.0,2000.0,10.2,10,5,4,6,0,5,9,55.6,4,19,11,8,16,26,26,0,Matches,2021-2022,Premier-League
Christian Kabasele,be BEL,DF,Watford,30.0,1991.0,13.3,11,5,10,1,0,7,10,70.0,3,20,16,4,14,25,67,1,Matches,2021-2022,Premier-League
Samuel Kalu,ng NGA,FW,Watford,23.0,1997.0,2.5,2,2,0,2,0,1,1,100.0,0,2,0,2,3,5,3,0,Matches,2021-2022,Premier-League
Hassane Kamara,ci CIV,DF,Watford,27.0,1994.0,18.0,53,34,31,16,6,27,43,62.8,16,20,4,16,69,122,67,0,Matches,2021-2022,Premier-League
Harry Kane,eng ENG,FW,Tottenham,28.0,1993.0,35.9,15,5,2,10,3,7,18,38.9,11,26,8,18,3,18,39,0,Matches,2021-2022,Premier-League
N'Golo Kanté,fr FRA,MF,Chelsea,30.0,1991.0,19.7,59,31,20,27,12,25,40,62.5,15,37,2,35,31,90,8,0,Matches,2021-2022,Premier-League
Edo Kayembe,cd COD,MF,Watford,23.0,1998.0,8.9,21,13,11,9,1,8,16,50.0,8,6,1,5,9,30,13,0,Matches,2021-2022,Premier-League
Moise Kean,it ITA,FW,Everton,21.0,2000.0,0.0,0,0,0,0,0,0,0,,0,0,0,0,0,0,0,0,Matches,2021-2022,Premier-League
Michael Keane,eng ENG,DF,Everton,28.0,1993.0,31.0,46,25,32,13,1,28,45,62.2,17,33,28,5,62,108,128,2,Matches,2021-2022,Premier-League
Naby Keïta,gn GUI,MF,Liverpool,26.0,1995.0,13.0,46,23,17,19,10,26,42,61.9,16,33,2,31,14,60,8,0,Matches,2021-2022,Premier-League
Caoimhín Kelleher,ie IRL,GK,Liverpool,22.0,1998.0,2.0,1,1,1,0,0,1,1,100.0,0,0,0,0,0,1,1,0,Matches,2021-2022,Premier-League
Kenedy,br BRA,DF,Chelsea,25.0,1996.0,0.6,5,2,1,2,2,2,3,66.7,1,0,0,0,0,5,0,0,Matches,2021-2022,Premier-League
Jonjoe Kenny,eng ENG,DF,Everton,24.0,1997.0,11.3,17,7,11,6,0,13,21,61.9,8,8,1,7,20,37,31,0,Matches,2021-2022,Premier-League
Max Kilman,eng ENG,DF,Wolves,24.0,1997.0,29.9,50,26,38,10,2,24,37,64.9,13,36,21,15,45,95,113,3,Matches,2021-2022,Premier-League
Joshua King,no NOR,FW,Watford,29.0,1992.0,25.0,19,15,7,6,6,4,17,23.5,13,15,4,11,8,27,31,0,Matches,2021-2022,Premier-League
Kristoffer Klaesson,no NOR,GK,Leeds United,20.0,2000.0,0.4,0,0,0,0,0,0,0,,0,0,0,0,0,0,0,0,Matches,2021-2022,Premier-League
Mateusz Klich,pl POL,MF,Leeds United,31.0,1990.0,23.0,47,25,18,23,6,25,66,37.9,41,22,4,18,11,58,20,0,Matches,2021-2022,Premier-League
Robin Koch,de GER,"MF,DF",Leeds United,25.0,1996.0,17.5,21,13,9,10,2,9,34,26.5,25,26,10,16,20,41,44,0,Matches,2021-2022,Premier-League
Sead Kolašinac,ba BIH,DF,Arsenal,28.0,1993.0,1.0,0,0,0,0,0,0,0,,0,0,0,0,4,4,1,0,Matches,2021-2022,Premier-League
Ibrahima Konaté,fr FRA,DF,Liverpool,22.0,1999.0,11.0,16,10,9,6,1,7,10,70.0,3,13,9,4,16,32,37,1,Matches,2021-2022,Premier-League
Ezri Konsa,eng ENG,DF,Aston Villa,23.0,1997.0,27.5,25,15,13,11,1,10,13,76.9,3,31,22,9,15,40,86,2,Matches,2021-2022,Premier-League
Cheikhou Kouyaté,sn SEN,MF,Crystal Palace,31.0,1989.0,21.9,52,38,28,22,2,18,39,46.2,21,40,14,26,38,90,39,0,Matches,2021-2022,Premier-League
Mateo Kovačić,hr CRO,MF,Chelsea,27.0,1994.0,17.3,51,31,14,26,11,17,35,48.6,18,19,4,15,7,58,9,1,Matches,2021-2022,Premier-League
Emil Krafth,se SWE,DF,Newcastle Utd,26.0,1994.0,18.2,37,16,25,11,1,27,36,75.0,9,16,10,6,25,62,56,0,Matches,2021-2022,Premier-League
Alex Král,cz CZE,MF,West Ham,23.0,1998.0,0.0,0,0,0,0,0,0,0,,0,0,0,0,0,0,0,0,Matches,2021-2022,Premier-League
Tim Krul,nl NED,GK,Norwich City,33.0,1988.0,29.0,1,1,1,0,0,1,4,25.0,3,0,0,0,0,1,10,4,Matches,2021-2022,Premier-League
Juraj Kucka,sk SVK,MF,Watford,34.0,1987.0,21.3,59,39,32,25,2,27,73,37.0,46,30,9,21,27,86,46,2,Matches,2021-2022,Premier-League
Dejan Kulusevski,se SWE,"MF,FW",Tottenham,21.0,2000.0,14.0,19,13,7,10,2,5,23,21.7,18,14,0,14,13,32,3,0,Matches,2021-2022,Premier-League
Alexandre Lacazette,fr FRA,FW,Arsenal,30.0,1991.0,19.8,27,10,8,13,6,7,21,33.3,14,12,1,11,5,32,6,0,Matches,2021-2022,Premier-League
Adam Lallana,eng ENG,MF,Brighton,33.0,1988.0,17.3,34,17,14,14,6,12,41,29.3,29,16,6,10,16,50,13,1,Matches,2021-2022,Premier-League
Tariq Lamptey,gh GHA,"DF,FW",Brighton,20.0,2000.0,17.3,36,25,14,17,5,15,25,60.0,10,13,3,10,21,57,23,0,Matches,2021-2022,Premier-League
Manuel Lanzini,ar ARG,"MF,FW",West Ham,28.0,1993.0,19.8,28,15,10,11,7,10,35,28.6,25,16,0,16,19,47,10,0,Matches,2021-2022,Premier-League
Aymeric Laporte,es ESP,DF,Manchester City,27.0,1994.0,31.4,33,15,22,10,1,14,20,70.0,6,15,10,5,20,53,64,2,Matches,2021-2022,Premier-League
Jamaal Lascelles,eng ENG,DF,Newcastle Utd,27.0,1993.0,22.9,15,7,9,5,1,4,12,33.3,8,38,28,10,22,37,121,1,Matches,2021-2022,Premier-League
Pierre Lees-Melou,fr FRA,MF,Norwich City,28.0,1993.0,25.2,58,36,23,29,6,25,92,27.2,67,37,11,26,25,83,23,0,Matches,2021-2022,Premier-League
Aaron Lennon,eng ENG,"MF,FW",Burnley,34.0,1987.0,17.2,33,17,10,13,10,10,34,29.4,24,26,4,22,9,42,14,0,Matches,2021-2022,Premier-League
Bernd Leno,de GER,GK,Arsenal,29.0,1992.0,4.0,1,1,1,0,0,1,1,100.0,0,0,0,0,0,1,1,0,Matches,2021-2022,Premier-League
Jamal Lewis,nir NIR,DF,Newcastle Utd,23.0,1998.0,2.9,8,6,6,1,1,3,4,75.0,1,3,2,1,3,11,8,0,Matches,2021-2022,Premier-League
Victor Lindelöf,se SWE,DF,Manchester Utd,27.0,1994.0,26.2,16,11,9,7,0,9,14,64.3,5,26,17,9,25,41,96,0,Matches,2021-2022,Premier-League
Jesse Lingard,eng ENG,"FW,MF",Manchester Utd,28.0,1992.0,4.1,9,7,4,3,2,2,6,33.3,4,4,0,4,0,9,1,0,Matches,2021-2022,Premier-League
Valentino Livramento,eng ENG,DF,Southampton,18.0,2002.0,24.5,54,28,30,18,6,27,45,60.0,18,23,9,14,47,101,50,1,Matches,2021-2022,Premier-League
Diego Llorente,es ESP,DF,Leeds United,27.0,1993.0,26.0,53,31,32,19,2,33,47,70.2,14,35,17,18,40,93,77,2,Matches,2021-2022,Premier-League
Hugo Lloris,fr FRA,GK,Tottenham,34.0,1986.0,38.0,1,1,1,0,0,1,2,50.0,1,0,0,0,1,2,24,3,Matches,2021-2022,Premier-League
Giovani Lo Celso,ar ARG,"MF,FW",Tottenham,25.0,1996.0,2.6,8,4,4,2,2,4,10,40.0,6,6,1,5,1,9,0,1,Matches,2021-2022,Premier-League
Jürgen Locadia,cw CUW,"MF,FW",Brighton,27.0,1993.0,0.3,0,0,0,0,0,0,0,,0,0,0,0,0,0,0,0,Matches,2021-2022,Premier-League
Ruben Loftus-Cheek,eng ENG,"MF,DF",Chelsea,25.0,1996.0,15.5,29,10,16,11,2,10,19,52.6,9,15,6,9,11,40,17,0,Matches,2021-2022,Premier-League
Kevin Long,ie IRL,DF,Burnley,30.0,1990.0,4.6,3,2,1,2,0,1,2,50.0,1,4,1,3,1,4,20,0,Matches,2021-2022,Premier-League
Shane Long,ie IRL,FW,Southampton,34.0,1987.0,3.4,9,5,2,4,3,1,1,100.0,0,4,0,4,0,9,2,0,Matches,2021-2022,Premier-League
Sean Longstaff,eng ENG,MF,Newcastle Utd,23.0,1997.0,16.3,54,34,18,31,5,24,65,36.9,41,18,6,12,9,63,18,0,Matches,2021-2022,Premier-League
Ademola Lookman,ng NGA,"FW,MF",Leicester City,23.0,1997.0,16.1,32,14,10,13,9,10,28,35.7,18,19,1,18,10,42,4,0,Matches,2021-2022,Premier-League
Jonas Lössl,dk DEN,GK,Brentford,32.0,1989.0,2.0,0,0,0,0,0,0,0,,0,0,0,0,0,0,1,0,Matches,2021-2022,Premier-League
Imran Louza,ma MAR,MF,Watford,22.0,1999.0,15.7,41,21,18,20,3,16,38,42.1,22,28,6,22,42,83,20,1,Matches,2021-2022,Premier-League
Matthew Lowton,eng ENG,DF,Burnley,32.0,1989.0,19.7,38,24,20,10,8,20,37,54.1,17,25,11,14,26,64,68,0,Matches,2021-2022,Premier-League
Douglas Luiz,br BRA,MF,Aston Villa,23.0,1998.0,30.2,59,39,30,24,5,21,72,29.2,51,30,7,23,34,93,28,1,Matches,2021-2022,Premier-League
Romelu Lukaku,be BEL,FW,Chelsea,28.0,1993.0,17.7,2,1,0,1,1,1,5,20.0,4,11,1,10,0,2,20,0,Matches,2021-2022,Premier-League
Lyanco,br BRA,DF,Southampton,24.0,1997.0,10.1,18,15,11,7,0,10,18,55.6,8,18,13,5,13,31,50,1,Matches,2021-2022,Premier-League
Alexis Mac Allister,ar ARG,"MF,FW",Brighton,22.0,1998.0,23.6,65,40,23,30,12,29,68,42.6,39,37,7,30,13,78,22,0,Matches,2021-2022,Premier-League
James Maddison,eng ENG,"MF,FW",Leicester City,24.0,1996.0,27.3,40,20,8,24,8,14,46,30.4,32,18,3,15,11,51,12,0,Matches,2021-2022,Premier-League
Gabriel Magalhães,br BRA,DF,Arsenal,23.0,1997.0,34.0,50,30,36,12,2,30,41,73.2,11,34,26,8,13,63,112,4,Matches,2021-2022,Premier-League
Harry Maguire,eng ENG,DF,Manchester Utd,28.0,1993.0,27.9,34,21,22,8,4,19,31,61.3,12,36,29,7,32,66,101,3,Matches,2021-2022,Premier-League
Riyad Mahrez,dz ALG,FW,Manchester City,30.0,1991.0,16.6,11,3,5,4,2,5,19,26.3,14,15,1,14,6,17,6,0,Matches,2021-2022,Premier-League
Ainsley Maitland-Niles,eng ENG,MF,Arsenal,23.0,1997.0,3.0,8,4,5,3,0,2,4,50.0,2,2,0,2,4,12,4,0,Matches,2021-2022,Premier-League
Sadio Mané,sn SEN,FW,Liverpool,29.0,1992.0,31.3,33,20,7,14,12,8,26,30.8,18,30,1,29,8,41,15,0,Matches,2021-2022,Premier-League
Javier Manquillo,es ESP,DF,Newcastle Utd,27.0,1994.0,14.0,39,29,28,10,1,21,36,58.3,15,15,6,9,10,49,32,0,Matches,2021-2022,Premier-League
Fernando Marçal,br BRA,"MF,DF",Wolves,32.0,1989.0,16.1,42,22,27,14,1,21,37,56.8,16,25,4,21,28,70,52,0,Matches,2021-2022,Premier-League
Solly March,eng ENG,"DF,FW",Brighton,27.0,1994.0,19.4,30,17,11,9,10,7,22,31.8,15,22,3,19,17,47,25,0,Matches,2021-2022,Premier-League
Pablo Marí,es ESP,DF,Arsenal,27.0,1993.0,2.0,5,3,1,3,1,3,6,50.0,3,5,4,1,3,8,10,0,Matches,2021-2022,Premier-League
Anthony Martial,fr FRA,FW,Manchester Utd,25.0,1995.0,2.4,0,0,0,0,0,0,1,0.0,1,1,0,1,0,0,1,0,Matches,2021-2022,Premier-League
Gabriel Martinelli,br BRA,"FW,MF",Arsenal,20.0,2001.0,20.7,27,19,7,14,6,10,29,34.5,19,26,1,25,20,47,15,0,Matches,2021-2022,Premier-League
Emiliano Martínez,ar ARG,GK,Aston Villa,28.0,1992.0,36.0,1,1,1,0,0,1,3,33.3,2,0,0,0,0,1,6,1,Matches,2021-2022,Premier-League
Adam Masina,ma MAR,DF,Watford,27.0,1994.0,12.0,24,13,11,10,3,12,29,41.4,17,18,6,12,18,42,45,0,Matches,2021-2022,Premier-League
Arthur Masuaku,cd COD,"DF,FW",West Ham,27.0,1993.0,7.2,31,23,19,11,1,14,23,60.9,9,9,1,8,9,40,17,0,Matches,2021-2022,Premier-League
Juan Mata,es ESP,MF,Manchester Utd,33.0,1988.0,2.6,6,4,2,3,1,3,5,60.0,2,1,0,1,1,7,1,0,Matches,2021-2022,Premier-League
Jean-Philippe Mateta,fr FRA,FW,Crystal Palace,24.0,1997.0,12.7,8,4,2,5,1,3,18,16.7,15,11,3,8,4,12,13,0,Matches,2021-2022,Premier-League
Nemanja Matić,rs SRB,MF,Manchester Utd,32.0,1988.0,15.4,31,18,19,11,1,15,31,48.4,16,21,6,15,31,62,21,3,Matches,2021-2022,Premier-League
Joël Matip,cm CMR,DF,Liverpool,29.0,1991.0,31.0,47,34,23,19,5,20,31,64.5,11,26,14,12,44,91,93,1,Matches,2021-2022,Premier-League
Neal Maupay,fr FRA,FW,Brighton,24.0,1996.0,25.3,17,10,2,6,9,4,18,22.2,14,21,2,19,2,19,2,0,Matches,2021-2022,Premier-League
Bryan Mbeumo,cm CMR,FW,Brentford,21.0,1999.0,32.3,28,16,1,12,15,6,20,30.0,14,21,6,15,11,39,20,0,Matches,2021-2022,Premier-League
James McArthur,sct SCO,MF,Crystal Palace,33.0,1987.0,16.0,33,23,13,19,1,16,44,36.4,28,23,9,14,30,63,27,0,Matches,2021-2022,Premier-League
James Mcatee,eng ENG,"MF,FW",Manchester City,18.0,2002.0,0.2,0,0,0,0,0,0,2,0.0,2,0,0,0,0,0,0,0,Matches,2021-2022,Premier-League
Kasey McAteer,ie IRL,FW,Leicester City,19.0,2001.0,0.0,0,0,0,0,0,0,0,,0,0,0,0,0,0,0,0,Matches,2021-2022,Premier-League
Liam McCarron,sct SCO,FW,Leeds United,20.0,2001.0,0.1,0,0,0,0,0,0,0,,0,1,0,1,0,0,0,0,Matches,2021-2022,Premier-League
Alex McCarthy,eng ENG,GK,Southampton,31.0,1989.0,17.0,0,0,0,0,0,0,0,,0,0,0,0,0,0,4,0,Matches,2021-2022,Premier-League
John McGinn,sct SCO,MF,Aston Villa,26.0,1994.0,34.3,106,64,35,55,16,54,104,51.9,50,53,6,47,35,141,34,0,Matches,2021-2022,Premier-League
Stuart McKinstry,sct SCO,MF,Leeds United,18.0,2002.0,0.0,0,0,0,0,0,0,0,,0,0,0,0,0,0,0,0,Matches,2021-2022,Premier-League
Kenny McLean,sct SCO,MF,Norwich City,29.0,1992.0,30.1,42,22,18,20,4,17,59,28.8,42,29,7,22,34,76,54,0,Matches,2021-2022,Premier-League
Dwight McNeil,eng ENG,MF,Burnley,21.0,1999.0,34.5,78,49,27,38,13,33,73,45.2,40,64,11,53,35,113,31,1,Matches,2021-2022,Premier-League
Scott McTominay,sct SCO,MF,Manchester Utd,24.0,1996.0,26.5,65,33,32,24,9,30,61,49.2,31,45,10,35,31,96,60,1,Matches,2021-2022,Premier-League
Ben Mee,eng ENG,DF,Burnley,31.0,1989.0,20.4,26,12,16,7,3,12,19,63.2,7,28,22,6,24,50,94,1,Matches,2021-2022,Premier-League
Hannibal Mejbri,tn TUN,FW,Manchester Utd,18.0,2003.0,0.8,2,1,1,1,0,1,1,100.0,0,0,0,0,0,2,0,0,Matches,2021-2022,Premier-League
Benjamin Mendy,fr FRA,DF,Manchester City,27.0,1994.0,0.9,2,2,1,1,0,2,6,33.3,4,0,0,0,0,2,0,0,Matches,2021-2022,Premier-League
Edouard Mendy,sn SEN,GK,Chelsea,29.0,1992.0,34.0,1,0,1,0,0,1,3,33.3,2,0,0,0,0,1,13,4,Matches,2021-2022,Premier-League
Nampalys Mendy,sn SEN,MF,Leicester City,29.0,1992.0,11.5,12,6,8,4,0,6,17,35.3,11,7,4,3,11,23,11,1,Matches,2021-2022,Premier-League
Illan Meslier,fr FRA,GK,Leeds United,21.0,2000.0,37.6,1,1,1,0,0,1,1,100.0,0,0,0,0,0,1,27,1,Matches,2021-2022,Premier-League
Luka Milivojević,rs SRB,MF,Crystal Palace,30.0,1991.0,8.6,18,9,9,6,3,10,16,62.5,6,6,1,5,11,29,15,0,Matches,2021-2022,Premier-League
James Milner,eng ENG,"MF,DF",Liverpool,35.0,1986.0,9.5,28,16,12,11,5,12,29,41.4,17,19,5,14,17,45,20,0,Matches,2021-2022,Premier-League
Yerry Mina,co COL,DF,Everton,26.0,1994.0,9.4,12,10,12,0,0,10,13,76.9,3,13,9,4,11,23,38,1,Matches,2021-2022,Premier-League
Takumi Minamino,jp JPN,"FW,MF",Liverpool,26.0,1995.0,2.1,3,2,1,1,1,2,8,25.0,6,2,0,2,1,4,2,0,Matches,2021-2022,Premier-League
Tyrone Mings,eng ENG,DF,Aston Villa,28.0,1993.0,35.4,23,12,17,3,3,14,22,63.6,8,47,30,17,46,69,153,2,Matches,2021-2022,Premier-League
Tyrick Mitchell,eng ENG,DF,Crystal Palace,21.0,1999.0,34.5,104,57,67,26,11,46,67,68.7,21,47,5,42,41,145,101,0,Matches,2021-2022,Premier-League
Jakub Moder,pl POL,MF,Brighton,22.0,1999.0,18.9,42,25,18,17,7,23,42,54.8,19,25,2,23,10,52,22,1,Matches,2021-2022,Premier-League
Wesley Moraes,br BRA,FW,Aston Villa,24.0,1996.0,0.0,0,0,0,0,0,0,0,,0,0,0,0,0,0,0,0,Matches,2021-2022,Premier-League
Tyler Morton,eng ENG,MF,Liverpool,18.0,2002.0,0.7,0,0,0,0,0,0,2,0.0,2,0,0,0,3,3,0,0,Matches,2021-2022,Premier-League
Mason Mount,eng ENG,MF,Chelsea,22.0,1999.0,26.3,41,16,10,17,14,10,34,29.4,24,18,1,17,13,54,12,0,Matches,2021-2022,Premier-League
Lucas Moura,br BRA,"FW,MF",Tottenham,28.0,1992.0,19.7,25,10,7,14,4,8,35,22.9,27,19,0,19,18,43,19,0,Matches,2021-2022,Premier-League
João Moutinho,pt POR,MF,Wolves,34.0,1986.0,33.0,74,39,34,27,13,30,106,28.3,76,48,8,40,34,108,36,2,Matches,2021-2022,Premier-League
Bali Mumba,eng ENG,DF,Norwich City,19.0,2001.0,0.5,1,1,1,0,0,0,0,,0,0,0,0,0,1,5,0,Matches,2021-2022,Premier-League
Jacob Murphy,eng ENG,"FW,DF",Newcastle Utd,26.0,1995.0,16.4,49,26,34,11,4,26,41,63.4,15,20,2,18,23,72,17,0,Matches,2021-2022,Premier-League
Enock Mwepu,zm ZAM,MF,Brighton,23.0,1998.0,11.1,22,12,10,10,2,5,27,18.5,22,20,2,18,12,34,19,0,Matches,2021-2022,Premier-League
Vitaliy Mykolenko,ua UKR,DF,Everton,22.0,1999.0,11.7,25,15,15,7,3,12,21,57.1,9,15,2,13,16,41,37,0,Matches,2021-2022,Premier-League
Marvelous Nakamba,zw ZIM,MF,Aston Villa,27.0,1994.0,10.0,32,19,18,14,0,12,34,35.3,22,14,4,10,12,44,17,1,Matches,2021-2022,Premier-League
Wilfred Ndidi,ng NGA,"MF,DF",Leicester City,24.0,1996.0,18.0,60,32,32,27,1,22,55,40.0,33,36,8,28,42,102,54,1,Matches,2021-2022,Premier-League
Tanguy Ndombele,fr FRA,MF,Tottenham,24.0,1996.0,5.4,10,7,3,5,2,1,8,12.5,7,5,0,5,1,11,1,0,Matches,2021-2022,Premier-League
Reiss Nelson,eng ENG,FW,Arsenal,21.0,1999.0,0.2,1,0,0,0,1,0,1,0.0,1,1,0,1,0,1,0,0,Matches,2021-2022,Premier-League
Pedro Neto,pt POR,"FW,MF",Wolves,21.0,2000.0,5.2,4,4,2,0,2,0,9,0.0,9,0,0,0,6,10,1,0,Matches,2021-2022,Premier-League
Rúben Neves,pt POR,MF,Wolves,24.0,1997.0,29.6,68,37,23,41,4,24,87,27.6,63,39,5,34,41,109,49,3,Matches,2021-2022,Premier-League
Jeremy Ngakia,,DF,Watford,20.0,2000.0,10.0,31,18,23,5,3,11,26,42.3,15,11,4,7,12,43,32,0,Matches,2021-2022,Premier-League
Saúl Ñíguez,es ESP,"DF,MF",Chelsea,26.0,1994.0,5.3,20,9,11,9,0,9,16,56.3,7,14,3,11,7,27,10,1,Matches,2021-2022,Premier-League
Eddie Nketiah,eng ENG,FW,Arsenal,22.0,1999.0,9.3,9,4,1,4,4,1,4,25.0,3,9,2,7,4,13,5,0,Matches,2021-2022,Premier-League
Nicolas Nkoulou,cm CMR,DF,Watford,31.0,1990.0,1.9,1,0,0,1,0,0,0,,0,2,1,1,2,3,8,0,Matches,2021-2022,Premier-League
Mark Noble,eng ENG,MF,West Ham,34.0,1987.0,3.7,8,2,7,1,0,5,11,45.5,6,4,1,3,4,12,2,1,Matches,2021-2022,Premier-League
Mathias Normann,no NOR,MF,Norwich City,25.0,1996.0,18.3,34,21,19,14,1,17,46,37.0,29,17,8,9,19,53,43,1,Matches,2021-2022,Premier-League
Christian Nørgaard,dk DEN,MF,Brentford,27.0,1994.0,33.9,109,60,42,58,9,52,101,51.5,49,48,9,39,64,173,58,1,Matches,2021-2022,Premier-League
Angelo Ogbonna,it ITA,DF,West Ham,33.0,1988.0,10.2,7,4,5,2,0,3,7,42.9,4,5,4,1,11,18,29,0,Matches,2021-2022,Premier-League
Michael Olise,fr FRA,"FW,MF",Crystal Palace,19.0,2001.0,12.7,22,18,8,11,3,7,24,29.2,17,17,0,17,6,28,6,0,Matches,2021-2022,Premier-League
Robin Olsen,se SWE,GK,Aston Villa,31.0,1990.0,1.0,0,0,0,0,0,0,0,,0,0,0,0,0,0,0,0,Matches,2021-2022,Premier-League
Andrew Omobamidele,ie IRL,DF,Norwich City,19.0,2002.0,4.2,8,6,5,3,0,5,11,45.5,6,8,8,0,5,13,13,0,Matches,2021-2022,Premier-League
Tyler Onyango,eng ENG,MF,Everton,18.0,2003.0,0.3,0,0,0,0,0,0,0,,0,0,0,0,0,0,1,0,Matches,2021-2022,Premier-League
Frank Onyeka,ng NGA,MF,Brentford,23.0,1998.0,11.6,25,17,13,9,3,8,27,29.6,19,16,2,14,14,39,13,0,Matches,2021-2022,Premier-League
Divock Origi,be BEL,FW,Liverpool,26.0,1995.0,1.5,0,0,0,0,0,0,2,0.0,2,1,0,1,1,1,2,0,Matches,2021-2022,Premier-League
Alex Oxlade-Chamberlain,eng ENG,"MF,FW",Liverpool,27.0,1993.0,8.7,15,11,2,8,5,3,14,21.4,11,12,2,10,6,21,5,0,Matches,2021-2022,Premier-League
Cole Palmer,eng ENG,"FW,MF",Manchester City,19.0,2002.0,1.4,2,1,1,1,0,0,2,0.0,2,3,0,3,1,3,0,0,Matches,2021-2022,Premier-League
Emerson Palmieri,it ITA,DF,Chelsea,26.0,1994.0,0.1,0,0,0,0,0,0,0,,0,0,0,0,0,0,0,0,Matches,2021-2022,Premier-League
Thomas Partey,gh GHA,MF,Arsenal,28.0,1993.0,22.5,43,29,22,17,4,18,44,40.9,26,22,4,18,23,66,35,2,Matches,2021-2022,Premier-League
Nicolas Pépé,ci CIV,"FW,MF",Arsenal,26.0,1995.0,7.7,8,5,3,5,0,3,9,33.3,6,9,1,8,8,16,2,0,Matches,2021-2022,Premier-League
Ricardo Pereira,pt POR,DF,Leicester City,27.0,1993.0,11.0,37,20,19,13,5,21,40,52.5,19,13,1,12,17,54,39,0,Matches,2021-2022,Premier-League
Ayoze Pérez,es ESP,"MF,FW",Leicester City,28.0,1993.0,4.9,4,2,0,3,1,0,13,0.0,13,11,1,10,2,6,5,0,Matches,2021-2022,Premier-League
Sonny Perkins,eng ENG,MF,West Ham,17.0,2004.0,0.0,0,0,0,0,0,0,0,,0,0,0,0,0,0,0,0,Matches,2021-2022,Premier-League
Romain Perraud,fr FRA,DF,Southampton,23.0,1997.0,18.0,34,22,18,14,2,16,29,55.2,13,24,6,18,17,51,42,0,Matches,2021-2022,Premier-League
Kalvin Phillips,eng ENG,MF,Leeds United,25.0,1995.0,17.7,54,25,24,25,5,24,57,42.1,33,37,9,28,24,78,18,0,Matches,2021-2022,Premier-League
Jaden Philogene Bidace,eng ENG,FW,Aston Villa,19.0,2002.0,0.1,0,0,0,0,0,0,0,,0,0,0,0,0,0,0,0,Matches,2021-2022,Premier-League
Jordan Pickford,eng ENG,GK,Everton,27.0,1994.0,35.0,1,1,1,0,0,0,1,0.0,1,1,0,1,1,2,14,1,Matches,2021-2022,Premier-League
Erik Pieters,nl NED,DF,Burnley,32.0,1988.0,8.1,28,15,15,11,2,17,28,60.7,11,18,7,11,10,38,38,0,Matches,2021-2022,Premier-League
Ethan Pinnock,jm JAM,DF,Brentford,28.0,1993.0,29.9,51,35,37,12,2,25,38,65.8,13,30,11,19,44,95,154,1,Matches,2021-2022,Premier-League
Daniel Podence,pt POR,"FW,MF",Wolves,25.0,1995.0,16.5,18,11,10,5,3,4,17,23.5,13,8,1,7,10,28,1,0,Matches,2021-2022,Premier-League
Paul Pogba,fr FRA,"MF,FW",Manchester Utd,28.0,1993.0,15.0,13,9,5,7,1,6,28,21.4,22,11,0,11,13,26,16,0,Matches,2021-2022,Premier-League
Nick Pope,eng ENG,GK,Burnley,29.0,1992.0,36.0,0,0,0,0,0,0,2,0.0,2,0,0,0,2,2,30,3,Matches,2021-2022,Premier-League
Isaac Price,nir NIR,MF,Everton,17.0,2003.0,0.2,0,0,0,0,0,0,0,,0,1,0,1,0,0,0,0,Matches,2021-2022,Premier-League
Teemu Pukki,fi FIN,FW,Norwich City,31.0,1990.0,36.1,23,11,2,14,7,6,29,20.7,23,21,1,20,4,27,3,0,Matches,2021-2022,Premier-League
Christian Pulisic,us USA,"MF,FW",Chelsea,22.0,1998.0,14.3,10,7,6,3,1,3,17,17.6,14,12,0,12,5,15,10,0,Matches,2021-2022,Premier-League
Przemysław Płacheta,pl POL,"FW,MF",Norwich City,23.0,1998.0,5.6,4,3,3,1,0,2,7,28.6,5,3,1,2,2,6,5,1,Matches,2021-2022,Premier-League
Jesurun Rak Sakyi,eng ENG,"FW,MF",Crystal Palace,18.0,2002.0,0.9,0,0,0,0,0,0,1,0.0,1,3,0,3,1,1,0,0,Matches,2021-2022,Premier-League
Aaron Ramsdale,eng ENG,GK,Arsenal,23.0,1998.0,34.0,2,1,2,0,0,1,2,50.0,1,0,0,0,0,2,26,3,Matches,2021-2022,Premier-League
Jacob Ramsey,eng ENG,MF,Aston Villa,20.0,2001.0,27.4,67,44,31,28,8,30,69,43.5,39,36,7,29,24,91,28,0,Matches,2021-2022,Premier-League
Raphinha,br BRA,"FW,MF",Leeds United,24.0,1996.0,32.4,51,29,25,14,12,22,71,31.0,49,43,0,43,29,80,28,1,Matches,2021-2022,Premier-League
Marcus Rashford,eng ENG,"FW,MF",Manchester Utd,23.0,1997.0,13.7,6,5,1,4,1,2,13,15.4,11,10,1,9,5,11,5,1,Matches,2021-2022,Premier-League
Milot Rashica,xk KVX,"FW,MF",Norwich City,25.0,1996.0,24.8,31,19,12,12,7,11,30,36.7,19,22,3,19,15,46,23,0,Matches,2021-2022,Premier-League
David Raya,es ESP,GK,Brentford,25.0,1995.0,24.0,0,0,0,0,0,0,0,,0,1,0,1,0,0,10,1,Matches,2021-2022,Premier-League
Nathan Redmond,eng ENG,"MF,FW",Southampton,27.0,1994.0,20.4,22,14,9,9,4,7,30,23.3,23,21,2,19,8,30,16,0,Matches,2021-2022,Premier-League
Sergio Reguilón,es ESP,"DF,MF",Tottenham,24.0,1996.0,21.3,40,24,15,18,7,22,43,51.2,21,20,8,12,31,71,45,1,Matches,2021-2022,Premier-League
Declan Rice,eng ENG,MF,West Ham,22.0,1999.0,35.3,80,42,45,32,3,38,71,53.5,33,45,21,24,63,143,52,1,Matches,2021-2022,Premier-League
Taylor Richards,eng ENG,MF,Brighton,20.0,2000.0,0.3,1,0,0,1,0,1,2,50.0,1,0,0,0,0,1,0,0,Matches,2021-2022,Premier-League
Richarlison,br BRA,FW,Everton,24.0,1997.0,28.0,40,23,18,15,7,15,31,48.4,16,42,4,38,12,52,34,0,Matches,2021-2022,Premier-League
Jaïro Riedewald,nl NED,MF,Crystal Palace,24.0,1996.0,1.3,1,1,0,1,0,1,2,50.0,1,1,0,1,1,2,2,0,Matches,2021-2022,Premier-League
Matt Ritchie,sct SCO,DF,Newcastle Utd,31.0,1989.0,14.9,22,15,10,10,2,10,27,37.0,17,10,2,8,13,35,26,0,Matches,2021-2022,Premier-League
Connor Roberts,wls WAL,DF,Burnley,25.0,1995.0,18.8,20,13,10,7,3,10,15,66.7,5,25,5,20,22,42,62,1,Matches,2021-2022,Premier-League
Tyler Roberts,wls WAL,"MF,FW",Leeds United,22.0,1999.0,11.0,16,7,6,7,3,9,16,56.3,7,11,1,10,5,21,11,0,Matches,2021-2022,Premier-League
Andrew Robertson,sct SCO,DF,Liverpool,27.0,1994.0,28.2,36,21,16,15,5,20,35,57.1,15,24,3,21,23,59,61,0,Matches,2021-2022,Premier-League
Joe Rodon,wls WAL,DF,Tottenham,23.0,1997.0,1.0,0,0,0,0,0,0,0,,0,2,1,1,0,0,7,0,Matches,2021-2022,Premier-League
Rodri,es ESP,MF,Manchester City,25.0,1996.0,32.0,72,43,24,38,10,32,59,54.2,27,28,5,23,28,100,45,0,Matches,2021-2022,Premier-League
Rodrigo,es ESP,"MF,FW",Leeds United,30.0,1991.0,25.2,20,9,7,6,7,4,32,12.5,28,12,0,12,11,31,27,1,Matches,2021-2022,Premier-League
Jay Rodriguez,eng ENG,FW,Burnley,32.0,1989.0,15.4,20,12,8,8,4,4,14,28.6,10,19,1,18,4,24,12,0,Matches,2021-2022,Premier-League
Mads Roerslev,dk DEN,DF,Brentford,22.0,1999.0,13.8,23,12,19,2,2,14,32,43.8,18,14,5,9,16,39,29,0,Matches,2021-2022,Premier-League
Cristian Romero,ar ARG,DF,Tottenham,23.0,1998.0,20.5,62,39,39,21,2,22,34,64.7,12,46,21,25,33,95,74,1,Matches,2021-2022,Premier-League
Oriol Romeu,es ESP,MF,Southampton,29.0,1991.0,32.1,77,39,25,45,7,28,73,38.4,45,39,8,31,51,128,43,0,Matches,2021-2022,Premier-League
Cristiano Ronaldo,pt POR,FW,Manchester Utd,36.0,1985.0,27.3,8,6,1,5,2,2,6,33.3,4,8,0,8,2,10,29,0,Matches,2021-2022,Premier-League
Salomón Rondón,ve VEN,FW,Everton,31.0,1989.0,8.8,6,1,1,2,3,4,14,28.6,10,5,0,5,0,6,10,0,Matches,2021-2022,Premier-League
Danny Rose,eng ENG,DF,Watford,31.0,1990.0,7.7,16,10,11,4,1,10,24,41.7,14,8,5,3,14,30,11,1,Matches,2021-2022,Premier-League
Jon Rowe,eng ENG,"FW,MF",Norwich City,18.0,2003.0,2.5,3,2,2,1,0,2,3,66.7,1,7,0,7,3,6,1,0,Matches,2021-2022,Premier-League
John Ruddy,eng ENG,GK,Wolves,34.0,1986.0,1.5,0,0,0,0,0,0,0,,0,0,0,0,0,0,3,0,Matches,2021-2022,Premier-League
Antonio Rüdiger,de GER,DF,Chelsea,28.0,1993.0,33.7,48,28,29,15,4,36,48,75.0,12,20,11,9,28,76,91,1,Matches,2021-2022,Premier-League
Lukas Rupp,de GER,MF,Norwich City,30.0,1991.0,8.5,9,4,5,3,1,4,15,26.7,11,11,1,10,9,18,7,0,Matches,2021-2022,Premier-League
José Sá,pt POR,GK,Wolves,28.0,1993.0,36.5,2,1,2,0,0,2,4,50.0,2,0,0,0,2,4,19,5,Matches,2021-2022,Premier-League
Allan Saint-Maximin,fr FRA,"FW,MF",Newcastle Utd,24.0,1997.0,31.2,13,8,6,4,3,3,17,17.6,14,13,2,11,11,24,3,0,Matches,2021-2022,Premier-League
Romain Saïss,ma MAR,DF,Wolves,31.0,1990.0,30.1,40,27,28,11,1,19,33,57.6,14,41,21,20,58,98,158,2,Matches,2021-2022,Premier-League
Bukayo Saka,eng ENG,"FW,MF",Arsenal,19.0,2001.0,33.1,40,21,12,17,11,13,39,33.3,26,28,2,26,22,62,23,0,Matches,2021-2022,Premier-League
Mohamed Salah,eg EGY,FW,Liverpool,29.0,1992.0,30.7,17,8,5,9,3,6,19,31.6,13,7,1,6,6,23,5,0,Matches,2021-2022,Premier-League
Mohammed Salisu,gh GHA,DF,Southampton,22.0,1999.0,33.0,80,47,54,22,4,40,65,61.5,25,49,26,23,78,158,158,4,Matches,2021-2022,Premier-League
Albert Sambi Lokonga,be BEL,MF,Arsenal,21.0,1999.0,12.6,22,18,11,9,2,12,14,85.7,2,12,7,5,13,35,12,4,Matches,2021-2022,Premier-League
Davinson Sánchez,co COL,DF,Tottenham,25.0,1996.0,18.1,41,22,25,14,2,19,28,67.9,9,24,16,8,30,71,54,3,Matches,2021-2022,Premier-League
Robert Sánchez,es ESP,GK,Brighton,23.0,1997.0,37.0,2,1,2,0,0,1,1,100.0,0,1,0,1,0,2,11,4,Matches,2021-2022,Premier-League
Jadon Sancho,eng ENG,"FW,MF",Manchester Utd,21.0,2000.0,21.1,14,8,9,4,1,8,22,36.4,14,19,0,19,15,29,5,3,Matches,2021-2022,Premier-League
Morgan Sanson,fr FRA,MF,Aston Villa,26.0,1994.0,4.0,12,8,7,2,3,3,7,42.9,4,13,0,13,10,22,2,1,Matches,2021-2022,Premier-League
Samir Santos,br BRA,DF,Watford,26.0,1994.0,18.6,24,11,18,6,0,8,19,42.1,11,21,11,10,43,67,85,3,Matches,2021-2022,Premier-League
Josh Sargent,us USA,"FW,MF",Norwich City,21.0,2000.0,17.5,26,14,15,7,4,14,39,35.9,25,29,2,27,11,37,18,2,Matches,2021-2022,Premier-League
Jeremy Sarmiento,ec ECU,"FW,MF",Brighton,19.0,2002.0,0.5,1,1,0,0,1,0,2,0.0,2,2,0,2,0,1,0,0,Matches,2021-2022,Premier-League
Ismaila Sarr,sn SEN,"FW,MF",Watford,23.0,1998.0,20.7,12,7,4,3,5,5,19,26.3,14,10,1,9,9,21,10,0,Matches,2021-2022,Premier-League
Malang Sarr,fr FRA,DF,Chelsea,22.0,1999.0,6.1,14,7,10,2,2,7,12,58.3,5,6,3,3,11,25,20,0,Matches,2021-2022,Premier-League
Dane Scarlett,eng ENG,MF,Tottenham,17.0,2004.0,0.0,0,0,0,0,0,0,0,,0,0,0,0,0,0,0,0,Matches,2021-2022,Premier-League
Fabian Schär,ch SUI,DF,Newcastle Utd,29.0,1991.0,24.0,16,11,11,3,2,8,16,50.0,8,27,18,9,32,48,95,2,Matches,2021-2022,Premier-League
Jeffrey Schlupp,gh GHA,"MF,FW",Crystal Palace,28.0,1992.0,20.6,46,25,16,23,7,24,50,48.0,26,39,9,30,18,64,32,0,Matches,2021-2022,Premier-League
Kasper Schmeichel,dk DEN,GK,Leicester City,34.0,1986.0,37.0,0,0,0,0,0,0,2,0.0,2,0,0,0,1,1,15,2,Matches,2021-2022,Premier-League
Ken Sema,se SWE,"MF,FW",Watford,27.0,1993.0,9.5,16,6,11,4,1,9,20,45.0,11,10,0,10,5,21,11,0,Matches,2021-2022,Premier-League
Nélson Semedo,pt POR,"MF,DF",Wolves,27.0,1993.0,23.7,58,39,39,17,2,25,49,51.0,24,23,4,19,21,79,64,1,Matches,2021-2022,Premier-League
Ryan Sessegnon,eng ENG,"DF,MF",Tottenham,21.0,2000.0,11.6,25,19,14,7,4,11,22,50.0,11,18,3,15,7,32,26,0,Matches,2021-2022,Premier-League
Jamie Shackleton,eng ENG,"DF,MF",Leeds United,21.0,1999.0,7.9,27,16,19,7,1,13,25,52.0,12,11,7,4,8,35,12,1,Matches,2021-2022,Premier-League
Luke Shaw,eng ENG,DF,Manchester Utd,26.0,1995.0,17.8,21,13,9,9,3,12,21,57.1,9,22,11,11,9,30,22,2,Matches,2021-2022,Premier-League
Jonjo Shelvey,eng ENG,MF,Newcastle Utd,29.0,1992.0,22.0,30,17,12,18,0,14,34,41.2,20,22,7,15,22,52,20,2,Matches,2021-2022,Premier-League
Shola Shoretire,eng ENG,MF,Manchester Utd,17.0,2004.0,0.2,0,0,0,0,0,0,0,,0,0,0,0,0,0,0,0,Matches,2021-2022,Premier-League
Francisco Sierralta,cl CHI,DF,Watford,24.0,1997.0,4.7,7,3,7,0,0,5,8,62.5,3,7,2,5,6,13,35,0,Matches,2021-2022,Premier-League
Bernardo Silva,pt POR,"MF,FW",Manchester City,26.0,1994.0,31.7,57,29,19,19,19,31,67,46.3,36,24,2,22,20,77,19,0,Matches,2021-2022,Premier-League
Fábio Silva,pt POR,FW,Wolves,19.0,2002.0,6.4,3,2,0,2,1,0,8,0.0,8,2,0,2,1,4,1,0,Matches,2021-2022,Premier-League
Thiago Silva,br BRA,DF,Chelsea,36.0,1984.0,29.4,32,21,19,12,1,11,22,50.0,11,54,31,23,44,76,100,0,Matches,2021-2022,Premier-League
Ellis Simms,eng ENG,FW,Everton,20.0,2001.0,0.7,0,0,0,0,0,0,0,,0,1,1,0,0,0,1,0,Matches,2021-2022,Premier-League
Moussa Sissoko,fr FRA,MF,Watford,31.0,1989.0,35.8,53,27,27,20,6,28,42,66.7,14,42,13,29,30,83,64,0,Matches,2021-2022,Premier-League
Oliver Skipp,eng ENG,MF,Tottenham,20.0,2000.0,15.0,33,19,14,18,1,15,31,48.4,16,19,7,12,12,45,10,1,Matches,2021-2022,Premier-League
William Smallbone,ie IRL,"MF,FW",Southampton,21.0,2000.0,1.5,4,4,2,2,0,1,3,33.3,2,4,0,4,2,6,0,0,Matches,2021-2022,Premier-League
Emile Smith Rowe,eng ENG,"MF,FW",Arsenal,21.0,2000.0,21.3,14,7,7,7,0,4,20,20.0,16,18,1,17,15,29,10,1,Matches,2021-2022,Premier-League
Cédric Soares,pt POR,DF,Arsenal,29.0,1991.0,16.5,38,26,23,9,6,16,25,64.0,9,18,7,11,16,54,31,1,Matches,2021-2022,Premier-League
Tomáš Souček,cz CZE,MF,West Ham,26.0,1995.0,34.0,66,32,27,33,6,28,65,43.1,37,34,13,21,52,118,98,1,Matches,2021-2022,Premier-League
Boubakary Soumaré,fr FRA,MF,Leicester City,22.0,1999.0,12.2,19,13,10,8,1,8,17,47.1,9,13,1,12,14,33,18,0,Matches,2021-2022,Premier-League
Çağlar Söyüncü,tr TUR,DF,Leicester City,25.0,1996.0,27.7,47,30,32,12,3,26,42,61.9,16,44,27,17,32,79,115,1,Matches,2021-2022,Premier-League
Tony Springett,ie IRL,"MF,FW",Norwich City,18.0,2002.0,1.6,2,1,1,1,0,1,4,25.0,3,0,0,0,0,2,2,0,Matches,2021-2022,Premier-League
Jason Steele,eng ENG,GK,Brighton,30.0,1990.0,1.0,0,0,0,0,0,0,0,,0,0,0,0,0,0,0,0,Matches,2021-2022,Premier-League
Jed Steer,eng ENG,GK,Aston Villa,28.0,1992.0,1.0,0,0,0,0,0,0,0,,0,0,0,0,0,0,0,0,Matches,2021-2022,Premier-League
Zack Steffen,us USA,GK,Manchester City,26.0,1995.0,1.0,0,0,0,0,0,0,0,,0,0,0,0,0,0,2,0,Matches,2021-2022,Premier-League
Dale Stephens,eng ENG,MF,Burnley,32.0,1989.0,1.4,4,1,0,3,1,3,8,37.5,5,4,1,3,1,5,1,0,Matches,2021-2022,Premier-League
Jack Stephens,eng ENG,DF,Southampton,27.0,1994.0,9.0,19,12,13,5,1,6,16,37.5,10,12,7,5,19,38,42,0,Matches,2021-2022,Premier-League
Raheem Sterling,eng ENG,FW,Manchester City,26.0,1994.0,23.6,23,10,3,11,9,10,23,43.5,13,12,0,12,12,35,3,0,Matches,2021-2022,Premier-League
Finley Stevens,wls WAL,DF,Brentford,18.0,2003.0,0.2,3,1,0,3,0,1,1,100.0,0,0,0,0,0,3,0,0,Matches,2021-2022,Premier-League
John Stones,eng ENG,DF,Manchester City,27.0,1994.0,12.4,5,3,3,2,0,2,3,66.7,1,3,3,0,11,16,27,1,Matches,2021-2022,Premier-League
Pascal Struijk,nl NED,"DF,MF",Leeds United,21.0,1999.0,22.8,61,39,34,23,4,30,50,60.0,20,35,23,12,33,94,60,2,Matches,2021-2022,Premier-League
Crysencio Summerville,nl NED,"MF,FW",Leeds United,19.0,2001.0,1.4,5,3,1,1,3,2,3,66.7,1,2,0,2,2,7,0,0,Matches,2021-2022,Premier-League
Jakob Sørensen,dk DEN,"MF,DF",Norwich City,23.0,1998.0,6.7,22,11,6,14,2,10,20,50.0,10,7,3,4,10,32,19,0,Matches,2021-2022,Premier-League
Japhet Tanganga,eng ENG,DF,Tottenham,22.0,1999.0,8.2,14,8,7,6,1,9,19,47.4,10,13,5,8,9,23,31,0,Matches,2021-2022,Premier-League
Matt Targett,eng ENG,DF,Aston Villa,25.0,1995.0,15.9,34,18,28,5,1,24,45,53.3,21,16,9,7,23,57,35,0,Matches,2021-2022,Premier-League
Matt Targett,eng ENG,DF,Newcastle Utd,25.0,1995.0,16.0,41,26,26,14,1,24,37,64.9,13,15,4,11,25,66,39,1,Matches,2021-2022,Premier-League
James Tarkowski,eng ENG,DF,Burnley,28.0,1992.0,34.5,65,45,47,17,1,33,47,70.2,14,75,61,14,48,113,186,4,Matches,2021-2022,Premier-League
Nuno Tavares,pt POR,DF,Arsenal,21.0,2000.0,13.1,21,14,10,7,4,8,18,44.4,10,15,5,10,9,30,33,1,Matches,2021-2022,Premier-League
Charlie Taylor,eng ENG,DF,Burnley,27.0,1993.0,30.3,45,26,31,11,3,26,44,59.1,18,42,20,22,58,103,95,2,Matches,2021-2022,Premier-League
Nathan Tella,ng NGA,"MF,FW",Southampton,22.0,1999.0,8.9,13,9,5,7,1,6,17,35.3,11,13,0,13,6,19,9,0,Matches,2021-2022,Premier-League
Alex Telles,br BRA,DF,Manchester Utd,28.0,1992.0,18.4,48,27,35,9,4,27,43,62.8,16,17,4,13,26,74,45,0,Matches,2021-2022,Premier-League
Luke Thomas,eng ENG,DF,Leicester City,20.0,2001.0,21.2,50,31,33,13,4,28,65,43.1,37,35,14,21,40,90,55,0,Matches,2021-2022,Premier-League
Dominic Thompson,eng ENG,DF,Brentford,21.0,2000.0,1.6,1,0,1,0,0,0,1,0.0,1,2,2,0,2,3,3,0,Matches,2021-2022,Premier-League
Youri Tielemans,be BEL,MF,Leicester City,24.0,1997.0,29.2,74,38,23,45,6,42,100,42.0,58,47,13,34,21,95,41,3,Matches,2021-2022,Premier-League
Kieran Tierney,sct SCO,DF,Arsenal,24.0,1997.0,21.3,18,14,11,7,0,10,11,90.9,1,23,5,18,15,33,54,0,Matches,2021-2022,Premier-League
Takehiro Tomiyasu,jp JPN,DF,Arsenal,22.0,1998.0,18.7,35,17,19,13,3,21,32,65.6,11,22,3,19,24,59,64,2,Matches,2021-2022,Premier-League
James Tomkins,eng ENG,DF,Crystal Palace,32.0,1989.0,6.1,8,3,6,2,0,6,8,75.0,2,8,8,0,4,12,18,0,Matches,2021-2022,Premier-League
Ivan Toney,eng ENG,FW,Brentford,25.0,1996.0,32.3,33,21,5,20,8,12,38,31.6,26,16,2,14,14,47,44,1,Matches,2021-2022,Premier-League
Ferrán Torres,es ESP,FW,Manchester City,21.0,2000.0,3.4,2,2,0,1,1,0,3,0.0,3,2,0,2,0,2,1,0,Matches,2021-2022,Premier-League
Cenk Tosun,tr TUR,MF,Everton,30.0,1991.0,0.1,0,0,0,0,0,0,0,,0,0,0,0,0,0,0,0,Matches,2021-2022,Premier-League
Andros Townsend,eng ENG,"MF,FW",Everton,30.0,1991.0,16.2,31,17,15,6,10,15,40,37.5,25,28,2,26,14,45,6,1,Matches,2021-2022,Premier-League
Adama Traoré,es ESP,"FW,MF",Wolves,25.0,1996.0,11.9,8,3,6,0,2,3,7,42.9,4,4,1,3,2,10,1,0,Matches,2021-2022,Premier-League
Bertrand Traoré,bf BFA,"MF,FW",Aston Villa,25.0,1995.0,2.4,3,3,0,1,2,1,2,50.0,1,0,0,0,0,3,1,0,Matches,2021-2022,Premier-League
Trézéguet,eg EGY,FW,Aston Villa,26.0,1994.0,0.1,0,0,0,0,0,0,0,,0,0,0,0,0,0,0,0,Matches,2021-2022,Premier-League
Francisco Trincão,pt POR,"FW,MF",Wolves,21.0,1999.0,14.8,28,15,9,13,6,3,19,15.8,16,17,1,16,12,40,1,1,Matches,2021-2022,Premier-League
Kieran Trippier,eng ENG,DF,Newcastle Utd,30.0,1990.0,4.8,17,10,8,8,1,10,16,62.5,6,10,3,7,10,27,10,0,Matches,2021-2022,Premier-League
William Troost-Ekong,ng NGA,DF,Watford,27.0,1993.0,15.4,18,9,11,6,1,10,15,66.7,5,24,14,10,7,25,82,1,Matches,2021-2022,Premier-League
Leandro Trossard,be BEL,"FW,MF",Brighton,26.0,1994.0,31.2,34,20,12,9,13,4,31,12.9,27,33,4,29,15,49,10,0,Matches,2021-2022,Premier-League
Kostas Tsimikas,gr GRE,DF,Liverpool,25.0,1996.0,9.7,27,12,12,8,7,12,16,75.0,4,6,2,4,10,37,22,2,Matches,2021-2022,Premier-League
Axel Tuanzebe,cd COD,DF,Aston Villa,23.0,1997.0,5.6,5,3,3,2,0,2,5,40.0,3,5,4,1,5,10,12,1,Matches,2021-2022,Premier-League
Ozan Tufan,tr TUR,MF,Watford,26.0,1995.0,3.7,3,2,1,1,1,1,5,20.0,4,2,0,2,2,5,4,0,Matches,2021-2022,Premier-League
Christos Tzolis,gr GRE,"FW,MF",Norwich City,19.0,2002.0,3.7,5,3,3,1,1,2,9,22.2,7,3,0,3,1,6,1,0,Matches,2021-2022,Premier-League
Yan Valery,tn TUN,DF,Southampton,22.0,1999.0,4.1,8,6,4,3,1,4,9,44.4,5,6,3,3,6,14,19,1,Matches,2021-2022,Premier-League
Virgil van Dijk,nl NED,DF,Liverpool,30.0,1991.0,34.0,16,10,11,5,0,11,16,68.8,5,21,14,7,31,47,109,0,Matches,2021-2022,Premier-League
Raphaël Varane,fr FRA,DF,Manchester Utd,28.0,1993.0,20.3,28,19,21,6,1,10,22,45.5,12,18,9,9,18,46,82,1,Matches,2021-2022,Premier-League
Jamie Vardy,eng ENG,FW,Leicester City,34.0,1987.0,20.1,6,5,0,4,2,1,7,14.3,6,9,0,9,1,7,17,0,Matches,2021-2022,Premier-League
Joël Veltman,nl NED,DF,Brighton,29.0,1992.0,31.9,74,48,47,21,6,21,53,39.6,32,46,16,30,45,119,89,0,Matches,2021-2022,Premier-League
Jannik Vestergaard,dk DEN,DF,Leicester City,28.0,1992.0,6.3,15,10,12,3,0,8,15,53.3,7,10,8,2,7,22,36,0,Matches,2021-2022,Premier-League
Nikola Vlašić,hr CRO,"FW,MF",West Ham,23.0,1997.0,6.2,11,7,4,6,1,5,20,25.0,15,4,0,4,2,13,1,0,Matches,2021-2022,Premier-League
Matěj Vydra,cz CZE,FW,Burnley,29.0,1992.0,7.5,12,7,3,4,5,3,7,42.9,4,5,1,4,0,12,9,0,Matches,2021-2022,Premier-League
Theo Walcott,eng ENG,"MF,FW",Southampton,32.0,1989.0,4.2,4,2,2,0,2,1,5,20.0,4,3,0,3,5,9,2,0,Matches,2021-2022,Premier-League
Kyle Walker,eng ENG,DF,Manchester City,31.0,1990.0,19.5,15,6,7,7,1,8,17,47.1,9,14,4,10,14,29,16,1,Matches,2021-2022,Premier-League
Kyle Walker-Peters,eng ENG,DF,Southampton,24.0,1997.0,29.3,57,33,28,21,8,26,38,68.4,12,29,8,21,37,94,53,1,Matches,2021-2022,Premier-League
Aaron Wan-Bissaka,eng ENG,DF,Manchester Utd,23.0,1997.0,19.9,49,36,25,18,6,14,20,70.0,6,24,14,10,34,83,41,2,Matches,2021-2022,Premier-League
Danny Ward,wls WAL,GK,Leicester City,28.0,1993.0,1.0,0,0,0,0,0,0,0,,0,0,0,0,0,0,1,0,Matches,2021-2022,Premier-League
Joel Ward,eng ENG,DF,Crystal Palace,31.0,1989.0,27.6,44,26,30,11,3,30,57,52.6,27,24,11,13,32,76,107,1,Matches,2021-2022,Premier-League
James Ward-Prowse,eng ENG,MF,Southampton,26.0,1994.0,35.7,41,24,12,24,5,19,70,27.1,51,43,15,28,40,81,45,1,Matches,2021-2022,Premier-League
Ollie Watkins,eng ENG,FW,Aston Villa,25.0,1995.0,32.8,17,13,2,7,8,2,15,13.3,13,25,3,22,12,29,27,0,Matches,2021-2022,Premier-League
Adam Webster,eng ENG,DF,Brighton,26.0,1995.0,15.9,26,8,17,7,2,13,20,65.0,7,25,17,8,17,43,66,2,Matches,2021-2022,Premier-League
Wout Weghorst,nl NED,FW,Burnley,28.0,1992.0,16.1,17,9,3,9,5,6,19,31.6,13,16,5,11,6,23,13,0,Matches,2021-2022,Premier-League
Danny Welbeck,eng ENG,"FW,MF",Brighton,30.0,1990.0,16.4,14,7,2,8,4,3,10,30.0,7,18,2,16,5,19,18,0,Matches,2021-2022,Premier-League
Timo Werner,de GER,"FW,MF",Chelsea,25.0,1996.0,14.3,8,4,3,3,2,2,20,10.0,18,9,0,9,2,10,4,0,Matches,2021-2022,Premier-League
Ashley Westwood,eng ENG,MF,Burnley,31.0,1990.0,25.4,21,12,8,12,1,10,31,32.3,21,21,9,12,30,51,16,1,Matches,2021-2022,Premier-League
Ben White,eng ENG,DF,Arsenal,23.0,1997.0,32.0,44,23,30,8,6,28,45,62.2,17,42,24,18,42,86,102,0,Matches,2021-2022,Premier-League
Brandon Williams,eng ENG,DF,Norwich City,20.0,2000.0,23.6,55,37,35,18,2,36,64,56.3,28,26,6,20,44,99,50,0,Matches,2021-2022,Premier-League
Neco Williams,wls WAL,DF,Liverpool,20.0,2001.0,0.1,0,0,0,0,0,0,0,,0,0,0,0,0,0,0,0,Matches,2021-2022,Premier-League
Joe Willock,eng ENG,MF,Newcastle Utd,21.0,1999.0,22.6,64,37,30,28,6,29,68,42.6,39,37,6,31,21,85,10,1,Matches,2021-2022,Premier-League
Callum Wilson,eng ENG,FW,Newcastle Utd,29.0,1992.0,15.4,9,8,1,5,3,1,4,25.0,3,7,2,5,3,12,10,0,Matches,2021-2022,Premier-League
Harry Winks,eng ENG,MF,Tottenham,25.0,1996.0,10.1,15,10,4,9,2,8,21,38.1,13,14,3,11,16,31,10,2,Matches,2021-2022,Premier-League
Yoane Wissa,cd COD,FW,Brentford,24.0,1996.0,14.3,12,6,5,4,3,1,16,6.3,15,12,5,7,8,20,6,0,Matches,2021-2022,Premier-League
Chris Wood,nz NZL,FW,Burnley,29.0,1991.0,15.2,7,5,0,3,4,3,10,30.0,7,13,4,9,0,7,3,0,Matches,2021-2022,Premier-League
Chris Wood,nz NZL,FW,Newcastle Utd,29.0,1991.0,14.7,2,0,1,1,0,1,2,50.0,1,5,2,3,2,4,9,0,Matches,2021-2022,Premier-League
Freddie Woodman,eng ENG,GK,Newcastle Utd,24.0,1997.0,4.0,0,0,0,0,0,0,0,,0,0,0,0,0,0,0,1,Matches,2021-2022,Premier-League
Granit Xhaka,ch SUI,"MF,DF",Arsenal,28.0,1992.0,25.9,32,18,16,12,4,16,41,39.0,25,21,6,15,21,53,31,0,Matches,2021-2022,Premier-League
Andriy Yarmolenko,ua UKR,"FW,MF",West Ham,31.0,1989.0,3.5,4,2,2,2,0,2,8,25.0,6,4,2,2,0,4,2,0,Matches,2021-2022,Premier-League
Ashley Young,eng ENG,"DF,FW",Aston Villa,36.0,1985.0,13.9,18,6,9,6,3,11,16,68.8,5,10,4,6,13,31,25,1,Matches,2021-2022,Premier-League
Nathan Young-Coombes,eng ENG,MF,Brentford,18.0,2003.0,0.0,0,0,0,0,0,0,0,,0,0,0,0,0,0,0,0,Matches,2021-2022,Premier-League
Wilfried Zaha,ci CIV,FW,Crystal Palace,28.0,1992.0,30.7,40,20,14,15,11,10,31,32.3,21,28,0,28,5,45,5,0,Matches,2021-2022,Premier-League
Christoph Zimmermann,de GER,DF,Norwich City,28.0,1993.0,1.7,6,3,5,1,0,3,4,75.0,1,0,0,0,1,7,4,0,Matches,2021-2022,Premier-League
Oleksandr Zinchenko,ua UKR,DF,Manchester City,24.0,1996.0,11.6,20,14,7,10,3,11,20,55.0,9,11,3,8,14,34,15,1,Matches,2021-2022,Premier-League
Hakim Ziyech,ma MAR,"MF,FW",Chelsea,28.0,1993.0,14.7,19,10,5,12,2,10,36,27.8,26,11,1,10,10,29,10,0,Matches,2021-2022,Premier-League
Kurt Zouma,fr FRA,DF,West Ham,26.0,1994.0,23.1,11,6,8,3,0,4,7,57.1,3,31,26,5,34,45,132,0,Matches,2021-2022,Premier-League
Martin Ødegaard,no NOR,"MF,FW",Arsenal,22.0,1998.0,30.9,49,21,6,24,19,22,61,36.1,39,18,1,17,11,60,11,1,Matches,2021-2022,Premier-League
Brenden Aaronson,us USA,"MF,FW",Leeds United,21.0,2000.0,26.4,45,18,16,22,7,15,46,32.6,31,43,3,40,5,50,6,1,Matches,2022-2023,Premier-League
George Abbott,eng ENG,MF,Tottenham,16.0,2005.0,0.0,0,0,0,0,0,0,0,,0,0,0,0,1,1,0,0,Matches,2022-2023,Premier-League
Che Adams,sct SCO,FW,Southampton,26.0,1996.0,22.1,17,13,7,8,2,7,12,58.3,5,13,4,9,4,21,22,0,Matches,2022-2023,Premier-League
Tyler Adams,us USA,MF,Leeds United,23.0,1999.0,24.0,89,46,44,35,10,50,79,63.3,29,48,8,40,35,124,29,0,Matches,2022-2023,Premier-League
Tosin Adarabioyo,eng ENG,DF,Fulham,24.0,1997.0,23.2,30,13,22,6,2,16,23,69.6,7,20,15,5,26,56,140,1,Matches,2022-2023,Premier-League
Nayef Aguerd,ma MAR,DF,West Ham,26.0,1996.0,17.7,27,18,18,8,1,13,20,65.0,7,26,24,2,18,45,79,2,Matches,2022-2023,Premier-League
Naouirou Ahamada,fr FRA,"MF,FW",Crystal Palace,20.0,2002.0,1.0,3,2,3,0,0,1,3,33.3,2,2,0,2,0,3,0,0,Matches,2022-2023,Premier-League
Rayan Aït-Nouri,dz ALG,DF,Wolves,21.0,2001.0,12.0,33,20,25,7,1,9,16,56.3,7,3,0,3,9,42,28,0,Matches,2022-2023,Premier-League
Kristoffer Ajer,no NOR,DF,Brentford,24.0,1998.0,8.5,11,8,5,4,2,9,16,56.3,7,6,5,1,7,18,22,0,Matches,2022-2023,Premier-League
Manuel Akanji,ch SUI,DF,Manchester City,27.0,1995.0,25.4,36,25,15,18,3,23,36,63.9,13,27,9,18,16,52,33,1,Matches,2022-2023,Premier-League
Nathan Aké,nl NED,DF,Manchester City,27.0,1995.0,20.8,26,12,15,9,2,11,15,73.3,4,20,10,10,20,46,48,0,Matches,2022-2023,Premier-League
Marc Albrighton,eng ENG,"FW,MF",Leicester City,32.0,1989.0,2.6,4,1,0,2,2,1,8,12.5,7,6,2,4,1,5,5,0,Matches,2022-2023,Premier-League
Thiago Alcántara,es ESP,MF,Liverpool,31.0,1991.0,13.9,43,24,20,21,2,14,23,60.9,9,15,3,12,21,64,13,2,Matches,2022-2023,Premier-League
Carlos Alcaraz,ar ARG,"MF,FW",Southampton,19.0,2002.0,11.4,10,5,2,7,1,6,22,27.3,16,14,5,9,1,11,11,0,Matches,2022-2023,Premier-League
Trent Alexander-Arnold,eng ENG,DF,Liverpool,23.0,1998.0,32.5,57,40,32,16,9,42,80,52.5,38,25,7,18,43,100,41,2,Matches,2022-2023,Premier-League
Alisson,br BRA,GK,Liverpool,29.0,1992.0,37.0,0,0,0,0,0,0,3,0.0,3,3,0,3,0,0,20,0,Matches,2022-2023,Premier-League
Dele Alli,eng ENG,MF,Everton,26.0,1996.0,0.4,0,0,0,0,0,0,0,,0,0,0,0,0,0,0,0,Matches,2022-2023,Premier-League
Miguel Almirón,py PAR,FW,Newcastle Utd,28.0,1994.0,27.7,46,30,16,19,11,18,42,42.9,24,25,2,23,10,56,17,0,Matches,2022-2023,Premier-League
Julián Álvarez,ar ARG,"FW,MF",Manchester City,22.0,2000.0,16.3,26,16,3,13,10,9,30,30.0,21,13,0,13,2,28,6,0,Matches,2022-2023,Premier-League
Daniel Amartey,gh GHA,DF,Leicester City,27.0,1994.0,17.9,19,8,13,5,1,12,14,85.7,2,24,17,7,8,27,71,0,Matches,2022-2023,Premier-League
Samuel Amo-Ameyaw,eng ENG,MF,Southampton,16.0,2006.0,0.0,0,0,0,0,0,0,1,0.0,1,0,0,0,0,0,0,0,Matches,2022-2023,Premier-League
Joachim Andersen,dk DEN,DF,Crystal Palace,26.0,1996.0,30.9,42,22,30,12,0,16,32,50.0,16,28,13,15,24,66,188,1,Matches,2022-2023,Premier-League
Elliot Anderson,eng ENG,"MF,FW",Newcastle Utd,19.0,2002.0,4.6,11,5,5,3,3,6,12,50.0,6,11,2,9,6,17,2,0,Matches,2022-2023,Premier-League
Jaidon Anthony,eng ENG,"MF,FW",Bournemouth,22.0,1999.0,14.0,30,17,15,9,6,8,24,33.3,16,30,3,27,10,40,19,0,Matches,2022-2023,Premier-League
Michail Antonio,jm JAM,FW,West Ham,32.0,1990.0,20.3,14,7,1,8,5,3,12,25.0,9,13,5,8,5,19,9,0,Matches,2022-2023,Premier-League
Antony,br BRA,FW,Manchester Utd,22.0,2000.0,20.0,22,9,9,9,4,8,28,28.6,20,18,0,18,11,33,6,0,Matches,2022-2023,Premier-League
Cameron Archer,eng ENG,"FW,MF",Aston Villa,21.0,2001.0,0.5,0,0,0,0,0,0,0,,0,0,0,0,0,0,0,0,Matches,2022-2023,Premier-League
Alphonse Areola,fr FRA,GK,West Ham,29.0,1993.0,3.4,0,0,0,0,0,0,0,,0,0,0,0,0,0,0,0,Matches,2022-2023,Premier-League
Joe Aribo,ng NGA,"MF,FW",Southampton,26.0,1996.0,13.6,31,20,15,12,4,11,20,55.0,9,14,1,13,10,41,11,0,Matches,2022-2023,Premier-League
Adam Armstrong,eng ENG,"FW,MF",Southampton,25.0,1997.0,14.8,14,9,6,5,3,3,10,30.0,7,15,3,12,5,19,6,0,Matches,2022-2023,Premier-League
Stuart Armstrong,sct SCO,"MF,FW",Southampton,30.0,1992.0,15.6,32,21,15,13,4,14,39,35.9,25,18,0,18,10,42,9,2,Matches,2022-2023,Premier-League
Kepa Arrizabalaga,es ESP,GK,Chelsea,27.0,1994.0,28.5,2,2,2,0,0,2,3,66.7,1,0,0,0,1,3,16,2,Matches,2022-2023,Premier-League
Pierre-Emerick Aubameyang,ga GAB,FW,Chelsea,33.0,1989.0,6.2,1,0,1,0,0,0,1,0.0,1,2,0,2,2,3,4,2,Matches,2022-2023,Premier-League
Ludwig Augustinsson,se SWE,DF,Aston Villa,28.0,1994.0,0.9,1,1,1,0,0,0,0,,0,0,0,0,0,1,1,0,Matches,2022-2023,Premier-League
Serge Aurier,ci CIV,DF,Nott'ham Forest,29.0,1992.0,21.6,64,41,41,18,5,23,33,69.7,10,34,11,23,29,93,75,0,Matches,2022-2023,Premier-League
Taiwo Awoniyi,ng NGA,FW,Nott'ham Forest,24.0,1997.0,15.6,17,10,2,10,5,6,12,50.0,6,18,4,14,4,21,20,0,Matches,2022-2023,Premier-League
Yasin Ayari,se SWE,MF,Brighton,18.0,2003.0,0.7,2,2,1,1,0,0,4,0.0,4,1,0,1,0,2,0,0,Matches,2022-2023,Premier-League
André Ayew,gh GHA,"FW,MF",Nott'ham Forest,32.0,1989.0,3.5,5,3,0,4,1,2,4,50.0,2,6,1,5,0,5,7,0,Matches,2022-2023,Premier-League
Jordan Ayew,gh GHA,"FW,MF",Crystal Palace,30.0,1991.0,30.2,66,41,23,20,23,21,53,39.6,32,35,4,31,15,81,31,0,Matches,2022-2023,Premier-League
Luke Ayling,eng ENG,DF,Leeds United,30.0,1991.0,22.8,66,37,42,15,9,42,85,49.4,43,34,11,23,26,92,52,2,Matches,2022-2023,Premier-League
César Azpilicueta,es ESP,DF,Chelsea,32.0,1989.0,17.0,43,25,23,15,5,22,37,59.5,15,26,5,21,19,62,54,1,Matches,2022-2023,Premier-League
Benoît Badiashile,fr FRA,DF,Chelsea,21.0,2001.0,10.1,14,8,10,4,0,9,14,64.3,5,5,2,3,16,30,34,1,Matches,2022-2023,Premier-League
Leon Bailey,jm JAM,"FW,MF",Aston Villa,24.0,1997.0,21.9,14,6,6,7,1,5,20,25.0,15,13,0,13,6,20,12,0,Matches,2022-2023,Premier-League
Stefan Bajcetic,es ESP,MF,Liverpool,17.0,2004.0,5.8,9,6,5,3,1,8,27,29.6,19,7,0,7,9,18,4,0,Matches,2022-2023,Premier-League
Dominic Ballard,eng ENG,"FW,MF",Southampton,17.0,2005.0,0.3,0,0,0,0,0,0,0,,0,0,0,0,1,1,0,0,Matches,2022-2023,Premier-League
Patrick Bamford,eng ENG,FW,Leeds United,28.0,1993.0,16.8,9,6,0,6,3,4,20,20.0,16,12,5,7,5,14,13,0,Matches,2022-2023,Premier-League
Shandon Baptiste,gd GRN,MF,Brentford,24.0,1998.0,6.9,15,9,6,6,3,7,17,41.2,10,10,2,8,7,22,10,0,Matches,2022-2023,Premier-League
Harvey Barnes,eng ENG,"FW,MF",Leicester City,24.0,1997.0,30.1,26,14,8,14,4,14,42,33.3,28,32,1,31,8,34,12,0,Matches,2022-2023,Premier-League
Gavin Bazunu,ie IRL,GK,Southampton,20.0,2002.0,32.0,1,0,1,0,0,1,1,100.0,0,0,0,0,1,2,24,2,Matches,2022-2023,Premier-League
Mads Bech Sørensen,dk DEN,"DF,MF",Brentford,23.0,1999.0,0.2,0,0,0,0,0,0,0,,0,0,0,0,1,1,1,0,Matches,2022-2023,Premier-League
Jan Bednarek,pl POL,DF,Southampton,26.0,1996.0,18.6,27,21,20,7,0,12,16,75.0,4,38,27,11,49,76,87,0,Matches,2022-2023,Premier-League
Jan Bednarek,pl POL,DF,Aston Villa,26.0,1996.0,1.1,3,3,0,3,0,1,1,100.0,0,3,1,2,2,5,5,0,Matches,2022-2023,Premier-League
Donny van de Beek,nl NED,MF,Manchester Utd,25.0,1997.0,1.9,0,0,0,0,0,0,1,0.0,1,2,1,1,1,1,1,0,Matches,2022-2023,Premier-League
Asmir Begović,ba BIH,GK,Everton,35.0,1987.0,1.0,0,0,0,0,0,0,0,,0,0,0,0,0,0,1,0,Matches,2022-2023,Premier-League
Armel Bella Kotchap,de GER,DF,Southampton,20.0,2001.0,20.9,37,17,28,9,0,15,20,75.0,5,29,12,17,44,81,110,0,Matches,2022-2023,Premier-League
Saïd Benrahma,dz ALG,"FW,MF",West Ham,26.0,1995.0,23.0,25,15,11,7,7,11,27,40.7,16,23,1,22,9,34,13,0,Matches,2022-2023,Premier-League
Rodrigo Bentancur,uy URU,MF,Tottenham,25.0,1997.0,16.7,45,28,15,21,9,16,28,57.1,12,28,15,13,20,65,22,0,Matches,2022-2023,Premier-League
Daniel Bentley,eng ENG,GK,Wolves,29.0,1993.0,2.0,1,1,1,0,0,1,1,100.0,0,0,0,0,0,1,0,1,Matches,2022-2023,Premier-League
Victor Bernth Kristiansen,dk DEN,DF,Leicester City,19.0,2002.0,9.9,38,23,18,16,4,22,30,73.3,8,16,4,12,3,41,26,1,Matches,2022-2023,Premier-League
Owen Bevan,wls WAL,DF,Bournemouth,18.0,2003.0,0.1,0,0,0,0,0,0,0,,0,0,0,0,0,0,0,0,Matches,2022-2023,Premier-League
Giulian Biancone,fr FRA,DF,Nott'ham Forest,22.0,2000.0,0.2,2,1,2,0,0,1,1,100.0,0,0,0,0,1,3,0,0,Matches,2022-2023,Premier-League
Philip Billing,dk DEN,"MF,FW",Bournemouth,26.0,1996.0,30.7,63,36,21,33,9,11,42,26.2,31,48,8,40,31,94,58,1,Matches,2022-2023,Premier-League
Yves Bissouma,ml MLI,MF,Tottenham,25.0,1996.0,11.2,16,13,6,6,4,2,7,28.6,5,15,6,9,12,28,10,0,Matches,2022-2023,Premier-League
Willy Boly,ci CIV,DF,Nott'ham Forest,31.0,1991.0,7.6,13,6,8,3,2,8,13,61.5,5,13,4,9,12,25,45,0,Matches,2022-2023,Premier-League
Sven Botman,nl NED,DF,Newcastle Utd,22.0,2000.0,34.7,38,24,31,7,0,22,28,78.6,6,44,24,20,34,72,126,2,Matches,2022-2023,Premier-League
Jarrod Bowen,eng ENG,"FW,MF",West Ham,25.0,1996.0,35.9,39,16,14,11,14,16,58,27.6,42,47,9,38,36,75,25,0,Matches,2022-2023,Premier-League
James Bree,eng ENG,DF,Southampton,24.0,1997.0,4.1,5,3,4,1,0,3,4,75.0,1,3,1,2,6,11,11,0,Matches,2022-2023,Premier-League
Armando Broja,al ALB,FW,Chelsea,20.0,2001.0,3.3,4,1,0,3,1,1,1,100.0,0,10,1,9,1,5,1,0,Matches,2022-2023,Premier-League
David Brooks,wls WAL,"FW,MF",Bournemouth,25.0,1997.0,1.9,1,0,1,0,0,0,1,0.0,1,2,0,2,2,3,5,0,Matches,2022-2023,Premier-League
Lewis Brunt,eng ENG,DF,Leicester City,21.0,2000.0,0.3,0,0,0,0,0,0,0,,0,0,0,0,0,0,2,0,Matches,2022-2023,Premier-League
Emi Buendía,ar ARG,"MF,FW",Aston Villa,25.0,1996.0,26.8,52,23,20,20,12,21,74,28.4,53,20,2,18,20,72,17,0,Matches,2022-2023,Premier-League
Hugo Bueno,es ESP,DF,Wolves,19.0,2002.0,14.6,33,16,23,6,4,17,33,51.5,16,14,1,13,10,43,36,0,Matches,2022-2023,Premier-League
Facundo Buonanotte,ar ARG,"FW,MF",Brighton,17.0,2004.0,6.3,2,1,1,1,0,1,22,4.5,21,5,2,3,4,6,3,0,Matches,2022-2023,Premier-League
Dan Burn,eng ENG,DF,Newcastle Utd,30.0,1992.0,34.6,60,38,29,23,8,34,67,50.7,33,42,16,26,32,92,120,2,Matches,2022-2023,Premier-League
Cafú,pt POR,MF,Nott'ham Forest,29.0,1993.0,0.1,0,0,0,0,0,0,0,,0,0,0,0,0,0,1,0,Matches,2022-2023,Premier-League
Moisés Caicedo,ec ECU,MF,Brighton,20.0,2001.0,34.9,100,50,41,47,12,40,68,58.8,28,43,7,36,56,156,31,3,Matches,2022-2023,Premier-League
Tom Cairney,sct SCO,MF,Fulham,31.0,1991.0,11.0,17,6,4,8,5,7,10,70.0,3,18,3,15,5,22,3,0,Matches,2022-2023,Premier-League
Duje Ćaleta-Car,hr CRO,DF,Southampton,25.0,1996.0,10.5,14,10,9,4,1,6,9,66.7,3,15,11,4,15,29,65,1,Matches,2022-2023,Premier-League
Dominic Calvert-Lewin,eng ENG,FW,Everton,25.0,1997.0,12.9,4,2,1,0,3,1,5,20.0,4,5,1,4,3,7,18,0,Matches,2022-2023,Premier-League
Chem Campbell,wls WAL,"FW,MF",Wolves,19.0,2002.0,0.8,2,1,1,1,0,0,1,0.0,1,2,0,2,1,3,0,0,Matches,2022-2023,Premier-League
João Cancelo,pt POR,DF,Manchester City,28.0,1994.0,14.2,29,21,16,9,4,17,24,70.8,7,7,1,6,19,48,9,1,Matches,2022-2023,Premier-League
Thomas Cannon,ie IRL,FW,Everton,19.0,2002.0,0.3,0,0,0,0,0,0,0,,0,0,0,0,0,0,0,0,Matches,2022-2023,Premier-League
Sergi Canós,es ESP,"FW,DF",Brentford,25.0,1997.0,0.9,0,0,0,0,0,0,2,0.0,2,3,1,2,0,0,1,0,Matches,2022-2023,Premier-League
Diego Carlos,br BRA,DF,Aston Villa,29.0,1993.0,2.3,1,0,0,1,0,0,1,0.0,1,2,2,0,1,2,2,0,Matches,2022-2023,Premier-League
Fabio Carvalho,pt POR,"MF,FW",Liverpool,19.0,2002.0,3.9,8,8,3,3,2,3,6,50.0,3,6,0,6,6,14,0,0,Matches,2022-2023,Premier-League
Casemiro,br BRA,MF,Manchester Utd,30.0,1992.0,23.6,88,46,43,35,10,47,92,51.1,45,49,11,38,34,122,64,0,Matches,2022-2023,Premier-League
Matty Cash,pl POL,DF,Aston Villa,24.0,1997.0,20.2,55,32,36,15,4,26,37,70.3,11,20,5,15,26,81,43,0,Matches,2022-2023,Premier-League
Timothy Castagne,be BEL,DF,Leicester City,26.0,1995.0,36.2,87,44,53,27,7,41,84,48.8,43,50,13,37,43,130,110,0,Matches,2022-2023,Premier-League
Jonny Castro,es ESP,DF,Wolves,28.0,1994.0,14.0,33,15,22,10,1,17,38,44.7,21,26,5,21,14,47,28,2,Matches,2022-2023,Premier-League
Nathaniel Chalobah,eng ENG,MF,Fulham,27.0,1994.0,0.1,1,1,1,0,0,1,1,100.0,0,0,0,0,0,1,2,0,Matches,2022-2023,Premier-League
Trevoh Chalobah,eng ENG,DF,Chelsea,23.0,1999.0,17.9,31,20,22,6,3,24,35,68.6,11,17,7,10,24,55,56,1,Matches,2022-2023,Premier-League
Calum Chambers,eng ENG,"DF,MF",Aston Villa,27.0,1995.0,3.9,9,6,7,2,0,6,8,75.0,2,5,4,1,7,16,10,1,Matches,2022-2023,Premier-League
Shea Charles,nir NIR,DF,Manchester City,18.0,2003.0,0.3,4,0,4,0,0,1,1,100.0,0,0,0,0,1,5,2,0,Matches,2022-2023,Premier-League
Ben Chilwell,eng ENG,"DF,MF",Chelsea,25.0,1996.0,15.6,21,17,12,8,1,13,25,52.0,12,21,2,19,18,39,26,0,Matches,2022-2023,Premier-League
Ryan Christie,sct SCO,"MF,FW",Bournemouth,27.0,1995.0,20.4,34,22,10,23,1,14,50,28.0,36,16,4,12,26,60,20,0,Matches,2022-2023,Premier-League
Carney Chukwuemeka,eng ENG,"MF,FW",Chelsea,18.0,2003.0,3.9,13,7,7,6,0,3,5,60.0,2,7,0,7,6,19,1,0,Matches,2022-2023,Premier-League
Bobby Clark,eng ENG,MF,Liverpool,17.0,2005.0,0.1,0,0,0,0,0,0,0,,0,2,0,2,0,0,0,0,Matches,2022-2023,Premier-League
Nathaniel Clyne,eng ENG,DF,Crystal Palace,31.0,1991.0,18.2,27,16,13,9,5,14,23,60.9,9,22,4,18,19,46,34,0,Matches,2022-2023,Premier-League
Conor Coady,eng ENG,DF,Everton,29.0,1993.0,23.3,14,9,8,6,0,7,15,46.7,8,21,17,4,14,28,88,3,Matches,2022-2023,Premier-League
Jack Colback,eng ENG,MF,Nott'ham Forest,32.0,1989.0,5.5,18,13,12,6,0,5,8,62.5,3,3,0,3,3,21,9,0,Matches,2022-2023,Premier-League
Séamus Coleman,ie IRL,DF,Everton,33.0,1988.0,18.4,35,26,21,10,4,19,29,65.5,10,14,7,7,22,57,58,2,Matches,2022-2023,Premier-League
Nathan Collins,ie IRL,DF,Wolves,21.0,2001.0,20.2,27,15,19,8,0,15,24,62.5,9,35,28,7,21,48,84,0,Matches,2022-2023,Premier-League
Levi Colwill,eng ENG,DF,Brighton,19.0,2003.0,13.6,8,7,4,4,0,4,9,44.4,5,5,3,2,15,23,37,1,Matches,2022-2023,Premier-League
Lewis Cook,eng ENG,MF,Bournemouth,25.0,1997.0,19.1,37,22,10,22,5,18,44,40.9,26,29,10,19,23,60,31,0,Matches,2022-2023,Premier-League
Steve Cook,eng ENG,DF,Nott'ham Forest,31.0,1991.0,10.6,8,4,4,4,0,5,7,71.4,2,16,11,5,12,20,51,0,Matches,2022-2023,Premier-League
Liam Cooper,sct SCO,DF,Leeds United,30.0,1991.0,15.8,38,23,27,9,2,23,36,63.9,13,16,8,8,34,72,57,3,Matches,2022-2023,Premier-League
Maxwel Cornet,ci CIV,FW,West Ham,25.0,1996.0,2.7,7,3,5,0,2,4,6,66.7,2,6,0,6,2,9,3,0,Matches,2022-2023,Premier-League
Diego Costa,es ESP,FW,Wolves,33.0,1988.0,13.8,3,1,3,0,0,2,9,22.2,7,6,1,5,2,5,17,0,Matches,2022-2023,Premier-League
Vladimír Coufal,cz CZE,DF,West Ham,29.0,1992.0,23.7,58,31,37,15,6,36,51,70.6,15,24,6,18,38,96,70,0,Matches,2022-2023,Premier-League
Philippe Coutinho,br BRA,"MF,FW",Aston Villa,30.0,1992.0,8.8,19,14,8,8,3,9,15,60.0,6,11,1,10,4,23,2,0,Matches,2022-2023,Premier-League
Conor Coventry,ie IRL,"MF,FW",West Ham,22.0,2000.0,0.0,0,0,0,0,0,0,0,,0,0,0,0,0,0,0,0,Matches,2022-2023,Premier-League
Matthew Craig,sct SCO,MF,Tottenham,19.0,2003.0,0.2,4,1,2,2,0,0,0,,0,0,0,0,0,4,0,0,Matches,2022-2023,Premier-League
Aaron Cresswell,eng ENG,DF,West Ham,32.0,1989.0,24.8,21,11,12,7,2,12,31,38.7,19,21,11,10,27,48,56,0,Matches,2022-2023,Premier-League
Marc Cucurella,es ESP,DF,Chelsea,24.0,1998.0,18.6,66,33,40,15,11,30,60,50.0,30,28,8,20,16,82,48,1,Matches,2022-2023,Premier-League
Matheus Cunha,br BRA,FW,Wolves,23.0,1999.0,10.7,7,4,0,5,2,2,10,20.0,8,15,3,12,9,16,11,0,Matches,2022-2023,Premier-League
Patson Daka,zm ZAM,FW,Leicester City,23.0,1998.0,13.2,14,8,6,8,0,3,13,23.1,10,14,2,12,7,21,7,0,Matches,2022-2023,Premier-League
Diogo Dalot,pt POR,DF,Manchester Utd,23.0,1999.0,23.9,54,41,40,13,1,33,45,73.3,12,25,7,18,37,91,55,2,Matches,2022-2023,Premier-League
Mikkel Damsgaard,dk DEN,"MF,FW",Brentford,22.0,2000.0,11.0,31,21,13,13,5,15,42,35.7,27,20,2,18,10,41,14,0,Matches,2022-2023,Premier-League
Danilo,br BRA,MF,Nott'ham Forest,21.0,2001.0,10.8,18,7,7,9,2,6,25,24.0,19,26,6,20,9,27,19,0,Matches,2022-2023,Premier-League
Arnaut Danjuma,nl NED,"FW,MF",Tottenham,25.0,1997.0,1.9,2,0,1,1,0,0,0,,0,1,0,1,0,2,0,0,Matches,2022-2023,Premier-League
Josh Dasilva,eng ENG,MF,Brentford,23.0,1998.0,15.4,18,9,6,6,6,6,15,40.0,9,22,6,16,5,23,7,1,Matches,2022-2023,Premier-League
David Datro Fofana,ci CIV,FW,Chelsea,19.0,2002.0,0.8,3,1,1,1,1,1,1,100.0,0,1,0,1,0,3,0,0,Matches,2022-2023,Premier-League
Ben Davies,wls WAL,DF,Tottenham,29.0,1993.0,25.4,28,11,13,13,2,14,26,53.8,12,17,8,9,18,46,72,0,Matches,2022-2023,Premier-League
Tom Davies,eng ENG,MF,Everton,24.0,1998.0,6.0,15,9,5,9,1,7,14,50.0,7,10,1,9,4,19,7,1,Matches,2022-2023,Premier-League
Craig Dawson,eng ENG,DF,West Ham,32.0,1990.0,8.0,11,7,9,2,0,5,7,71.4,2,9,6,3,6,17,26,0,Matches,2022-2023,Premier-League
Craig Dawson,eng ENG,DF,Wolves,32.0,1990.0,15.7,9,6,6,3,0,4,7,57.1,3,31,23,8,12,21,74,2,Matches,2022-2023,Premier-League
Kevin De Bruyne,be BEL,MF,Manchester City,31.0,1991.0,26.9,28,12,3,12,13,14,39,35.9,25,27,2,25,9,37,10,0,Matches,2022-2023,Premier-League
Bobby De Cordova-Reid,jm JAM,"FW,DF",Fulham,29.0,1993.0,27.5,42,24,14,14,14,16,36,44.4,20,25,3,22,20,62,28,1,Matches,2022-2023,Premier-League
Siriki Dembélé,ci CIV,"FW,MF",Bournemouth,25.0,1996.0,1.2,3,1,2,1,0,0,1,0.0,1,1,0,1,1,4,1,0,Matches,2022-2023,Premier-League
Leander Dendoncker,be BEL,MF,Aston Villa,27.0,1995.0,7.7,19,9,11,6,2,11,22,50.0,11,19,4,15,10,29,12,0,Matches,2022-2023,Premier-League
Leander Dendoncker,be BEL,MF,Wolves,27.0,1995.0,2.4,4,2,0,3,1,2,3,66.7,1,2,0,2,9,13,4,0,Matches,2022-2023,Premier-League
Emmanuel Dennis,ng NGA,"FW,MF",Nott'ham Forest,24.0,1997.0,8.0,17,11,5,5,7,8,18,44.4,10,13,1,12,2,19,6,0,Matches,2022-2023,Premier-League
Halil Dervişoğlu,tr TUR,MF,Brentford,22.0,1999.0,0.1,0,0,0,0,0,0,1,0.0,1,0,0,0,0,0,0,0,Matches,2022-2023,Premier-League
Kiernan Dewsbury-Hall,eng ENG,MF,Leicester City,23.0,1998.0,25.6,53,29,14,34,5,19,47,40.4,28,55,13,42,28,81,21,0,Matches,2022-2023,Premier-League
Ibrahima Diallo,fr FRA,MF,Southampton,23.0,1999.0,9.1,25,15,14,10,1,8,14,57.1,6,11,1,10,6,31,11,0,Matches,2022-2023,Premier-League
Rúben Dias,pt POR,DF,Manchester City,25.0,1997.0,22.2,21,13,10,10,1,11,18,61.1,7,21,13,8,18,39,56,1,Matches,2022-2023,Premier-League
Luis Díaz,co COL,FW,Liverpool,25.0,1997.0,11.1,17,11,4,8,5,8,15,53.3,7,8,0,8,6,23,2,0,Matches,2022-2023,Premier-League
Eric Dier,eng ENG,DF,Tottenham,28.0,1994.0,31.3,30,19,16,12,2,9,19,47.4,10,41,24,17,35,65,112,2,Matches,2022-2023,Premier-League
Lucas Digne,fr FRA,DF,Aston Villa,29.0,1993.0,16.7,30,12,20,9,1,20,33,60.6,13,18,5,13,18,48,45,0,Matches,2022-2023,Premier-League
Issa Diop,fr FRA,DF,Fulham,25.0,1997.0,22.4,28,19,18,9,1,17,32,53.1,15,24,17,7,35,63,86,0,Matches,2022-2023,Premier-League
Moussa Djenepo,ml MLI,"DF,FW",Southampton,24.0,1998.0,7.9,19,11,13,5,1,11,27,40.7,16,19,2,17,11,30,7,0,Matches,2022-2023,Premier-League
Ben Doak,sct SCO,FW,Liverpool,16.0,2005.0,0.3,3,2,1,2,0,1,1,100.0,0,1,0,1,0,3,0,0,Matches,2022-2023,Premier-League
Matt Doherty,ie IRL,"DF,MF",Tottenham,30.0,1992.0,7.4,16,10,12,3,1,8,10,80.0,2,11,6,5,8,24,14,1,Matches,2022-2023,Premier-League
Abdoulaye Doucouré,ml MLI,MF,Everton,29.0,1993.0,17.0,31,20,9,15,7,12,37,32.4,25,26,3,23,13,44,11,0,Matches,2022-2023,Premier-League
Cheick Doucouré,ml MLI,MF,Crystal Palace,22.0,2000.0,30.8,77,46,40,33,4,29,52,55.8,23,47,13,34,56,133,48,0,Matches,2022-2023,Premier-League
Flynn Downes,eng ENG,MF,West Ham,23.0,1999.0,8.5,16,9,4,10,2,6,12,50.0,6,15,2,13,7,23,6,0,Matches,2022-2023,Premier-League
Kami Doyle,eng ENG,MF,Southampton,16.0,2005.0,0.1,0,0,0,0,0,0,0,,0,0,0,0,0,0,0,0,Matches,2022-2023,Premier-League
Cody Drameh,eng ENG,DF,Leeds United,20.0,2001.0,0.8,5,4,0,4,1,2,3,66.7,1,0,0,0,1,6,1,0,Matches,2022-2023,Premier-League
Martin Dúbravka,sk SVK,GK,Newcastle Utd,33.0,1989.0,1.7,0,0,0,0,0,0,1,0.0,1,0,0,0,0,0,1,0,Matches,2022-2023,Premier-League
Shane Duffy,ie IRL,"DF,FW",Fulham,30.0,1992.0,0.2,0,0,0,0,0,0,0,,0,0,0,0,0,0,0,1,Matches,2022-2023,Premier-League
Lewis Dunk,eng ENG,DF,Brighton,30.0,1991.0,36.0,30,19,19,9,2,18,41,43.9,23,37,27,10,34,64,81,1,Matches,2022-2023,Premier-League
Jáder Durán,co COL,"FW,MF",Aston Villa,18.0,2003.0,1.5,2,2,0,1,1,1,4,25.0,3,0,0,0,2,4,2,0,Matches,2022-2023,Premier-League
Malcolm Ebiowei,eng ENG,"MF,FW",Crystal Palace,18.0,2003.0,0.4,1,1,1,0,0,0,1,0.0,1,2,0,2,0,1,0,0,Matches,2022-2023,Premier-League
Ederson,br BRA,GK,Manchester City,28.0,1993.0,35.0,3,1,3,0,0,1,2,50.0,1,0,0,0,1,4,10,2,Matches,2022-2023,Premier-League
Odsonne Édouard,fr FRA,FW,Crystal Palace,24.0,1998.0,20.0,25,13,7,12,6,7,13,53.8,6,17,5,12,3,28,22,0,Matches,2022-2023,Premier-League
Samuel Edozie,eng ENG,"FW,MF",Southampton,19.0,2003.0,6.3,17,10,6,10,1,3,8,37.5,5,7,0,7,6,23,6,0,Matches,2022-2023,Premier-League
Anthony Elanga,se SWE,FW,Manchester Utd,20.0,2002.0,4.7,3,0,0,2,1,1,2,50.0,1,4,0,4,2,5,4,0,Matches,2022-2023,Premier-League
Harvey Elliott,eng ENG,"MF,FW",Liverpool,19.0,2003.0,17.9,27,18,6,12,9,9,37,24.3,28,26,1,25,15,42,8,0,Matches,2022-2023,Premier-League
Mohamed Elneny,eg EGY,MF,Arsenal,30.0,1992.0,1.3,1,1,1,0,0,1,1,100.0,0,0,0,0,0,1,0,0,Matches,2022-2023,Premier-League
Mohamed Elyounoussi,no NOR,"MF,FW",Southampton,27.0,1994.0,24.1,46,28,22,20,4,19,44,43.2,25,40,3,37,27,73,37,0,Matches,2022-2023,Premier-League
Emerson,br BRA,DF,Tottenham,23.0,1999.0,19.3,54,33,38,12,4,27,40,67.5,13,17,3,14,18,72,75,0,Matches,2022-2023,Premier-League
Julio Enciso,py PAR,"FW,MF",Brighton,18.0,2004.0,9.0,13,4,3,6,4,8,13,61.5,5,9,0,9,4,17,2,0,Matches,2022-2023,Premier-League
Christian Eriksen,dk DEN,MF,Manchester Utd,30.0,1992.0,22.8,22,18,10,7,5,10,33,30.3,23,23,9,14,11,33,20,1,Matches,2022-2023,Premier-League
Pervis Estupiñán,ec ECU,DF,Brighton,24.0,1998.0,29.7,61,31,36,19,6,35,60,58.3,25,30,8,22,37,98,37,1,Matches,2022-2023,Premier-League
Jonny Evans,nir NIR,DF,Leicester City,34.0,1988.0,11.7,13,5,12,1,0,7,11,63.6,4,15,11,4,18,31,51,0,Matches,2022-2023,Premier-League
Eberechi Eze,eng ENG,"MF,FW",Crystal Palace,24.0,1998.0,29.3,42,24,17,18,7,18,38,47.4,20,22,0,22,13,55,10,0,Matches,2022-2023,Premier-League
Łukasz Fabiański,pl POL,GK,West Ham,37.0,1985.0,34.6,2,0,2,0,0,1,2,50.0,1,1,0,1,0,2,10,1,Matches,2022-2023,Premier-League
Fabinho,br BRA,MF,Liverpool,28.0,1993.0,29.7,65,38,18,40,7,24,62,38.7,38,38,11,27,37,102,40,0,Matches,2022-2023,Premier-League
Wout Faes,be BEL,DF,Leicester City,24.0,1998.0,31.0,56,33,28,26,2,28,44,63.6,16,53,37,16,41,97,113,2,Matches,2022-2023,Premier-League
Felipe,br BRA,DF,Nott'ham Forest,33.0,1989.0,15.8,42,23,29,13,0,24,41,58.5,17,34,13,21,36,78,90,0,Matches,2022-2023,Premier-League
João Félix,pt POR,"FW,MF",Chelsea,22.0,1999.0,10.5,14,7,5,6,3,4,12,33.3,8,3,0,3,1,15,1,1,Matches,2022-2023,Premier-League
Evan Ferguson,ie IRL,FW,Brighton,17.0,2004.0,10.6,6,3,1,3,2,1,7,14.3,6,11,1,10,2,8,6,0,Matches,2022-2023,Premier-League
Bruno Fernandes,pt POR,"MF,FW",Manchester Utd,27.0,1994.0,36.8,68,42,24,25,19,30,71,42.3,41,37,5,32,25,93,40,1,Matches,2022-2023,Premier-League
Enzo Fernández,ar ARG,MF,Chelsea,21.0,2001.0,17.2,45,27,25,17,3,21,56,37.5,35,32,2,30,16,61,12,1,Matches,2022-2023,Premier-League
Roberto Firmino,br BRA,"FW,MF",Liverpool,30.0,1991.0,13.5,17,12,2,12,3,4,22,18.2,18,16,1,15,7,24,2,0,Matches,2022-2023,Premier-League
Junior Firpo,do DOM,DF,Leeds United,25.0,1996.0,15.2,47,25,27,15,5,24,46,52.2,22,23,7,16,24,71,40,0,Matches,2022-2023,Premier-League
Phil Foden,eng ENG,FW,Manchester City,22.0,2000.0,20.5,16,10,9,5,2,8,19,42.1,11,25,2,23,5,21,12,0,Matches,2022-2023,Premier-League
Wesley Fofana,fr FRA,DF,Leicester City,21.0,2000.0,2.0,4,2,1,2,1,1,3,33.3,2,1,1,0,9,13,5,0,Matches,2022-2023,Premier-League
Wesley Fofana,fr FRA,DF,Chelsea,21.0,2000.0,13.1,30,18,19,7,4,13,26,50.0,13,17,10,7,20,50,33,2,Matches,2022-2023,Premier-League
Pablo Fornals,es ESP,"FW,MF",West Ham,26.0,1996.0,16.7,30,15,9,12,9,13,34,38.2,21,16,2,14,14,44,9,0,Matches,2022-2023,Premier-League
Adam Forshaw,eng ENG,MF,Leeds United,30.0,1991.0,5.3,12,9,5,7,0,7,17,41.2,10,9,1,8,4,16,2,0,Matches,2022-2023,Premier-League
Fraser Forster,eng ENG,GK,Tottenham,34.0,1988.0,13.5,1,0,1,0,0,0,0,,0,1,0,1,0,1,3,1,Matches,2022-2023,Premier-League
Tyrese Francois,au AUS,FW,Fulham,22.0,2000.0,0.0,0,0,0,0,0,0,1,0.0,1,0,0,0,0,0,1,0,Matches,2022-2023,Premier-League
Ryan Fraser,sct SCO,FW,Newcastle Utd,28.0,1994.0,3.5,2,2,0,0,2,2,5,40.0,3,3,1,2,0,2,3,0,Matches,2022-2023,Premier-League
Fred,br BRA,MF,Manchester Utd,29.0,1993.0,13.9,47,30,24,20,3,15,38,39.5,23,38,2,36,19,66,19,0,Matches,2022-2023,Premier-League
Ryan Fredericks,eng ENG,DF,Bournemouth,29.0,1992.0,5.9,3,2,2,0,1,1,4,25.0,3,7,2,5,1,4,27,0,Matches,2022-2023,Premier-League
Remo Freuler,ch SUI,MF,Nott'ham Forest,30.0,1992.0,24.0,43,23,23,15,5,19,43,44.2,24,36,9,27,29,72,45,0,Matches,2022-2023,Premier-League
Cody Gakpo,nl NED,"FW,MF",Liverpool,23.0,1999.0,16.2,26,15,4,13,9,13,38,34.2,25,13,1,12,4,30,2,0,Matches,2022-2023,Premier-League
Conor Gallagher,eng ENG,MF,Chelsea,22.0,2000.0,18.0,46,33,17,19,10,10,37,27.0,27,41,10,31,23,69,18,1,Matches,2022-2023,Premier-League
Idrissa Gana Gueye,sn SEN,MF,Everton,32.0,1989.0,28.6,97,57,49,35,13,31,62,50.0,31,50,12,38,56,153,34,3,Matches,2022-2023,Premier-League
Alejandro Garnacho,ar ARG,"FW,MF",Manchester Utd,18.0,2004.0,6.3,5,2,2,0,3,1,11,9.1,10,5,0,5,5,10,3,0,Matches,2022-2023,Premier-League
James Garner,eng ENG,"MF,DF",Everton,21.0,2001.0,8.9,16,13,4,8,4,9,19,47.4,10,9,1,8,12,28,13,0,Matches,2022-2023,Premier-League
David de Gea,es ESP,GK,Manchester Utd,31.0,1990.0,38.0,0,0,0,0,0,0,1,0.0,1,0,0,0,1,1,15,3,Matches,2022-2023,Premier-League
Joe Gelhardt,eng ENG,FW,Leeds United,20.0,2002.0,2.4,6,2,1,3,2,3,5,60.0,2,5,0,5,0,6,4,0,Matches,2022-2023,Premier-League
Saman Ghoddos,ir IRN,"MF,FW",Brentford,28.0,1993.0,1.5,2,1,0,1,1,1,3,33.3,2,5,1,4,4,6,2,0,Matches,2022-2023,Premier-League
Morgan Gibbs-White,eng ENG,"FW,MF",Wolves,22.0,2000.0,2.0,3,1,3,0,0,2,4,50.0,2,2,0,2,1,4,3,0,Matches,2022-2023,Premier-League
Morgan Gibbs-White,eng ENG,"MF,FW",Nott'ham Forest,22.0,2000.0,33.0,26,14,7,7,12,11,33,33.3,22,23,4,19,14,40,15,0,Matches,2022-2023,Premier-League
Bryan Gil,es ESP,"MF,FW",Tottenham,21.0,2001.0,1.6,3,1,3,0,0,0,3,0.0,3,3,0,3,1,4,1,0,Matches,2022-2023,Premier-League
Billy Gilmour,sct SCO,MF,Brighton,21.0,2001.0,5.6,5,2,2,2,1,2,8,25.0,6,5,2,3,6,11,5,0,Matches,2022-2023,Premier-League
Wilfried Gnonto,it ITA,"FW,MF",Leeds United,18.0,2003.0,15.0,27,17,7,15,5,10,30,33.3,20,24,1,23,5,32,7,0,Matches,2022-2023,Premier-League
Ben Godfrey,eng ENG,DF,Everton,24.0,1998.0,8.9,20,11,13,5,2,11,29,37.9,18,12,6,6,8,28,33,1,Matches,2022-2023,Premier-League
João Gomes,br BRA,MF,Wolves,21.0,2001.0,7.3,29,13,14,14,1,13,23,56.5,10,12,3,9,4,33,11,0,Matches,2022-2023,Premier-League
Toti Gomes,pt POR,DF,Wolves,23.0,1999.0,10.9,15,9,11,4,0,9,13,69.2,4,16,8,8,11,26,51,0,Matches,2022-2023,Premier-League
Joe Gomez,eng ENG,DF,Liverpool,25.0,1997.0,16.3,28,21,15,11,2,11,19,57.9,8,17,11,6,24,52,51,2,Matches,2022-2023,Premier-League
Sergio Gómez,es ESP,"DF,MF",Manchester City,21.0,2000.0,3.9,9,4,6,1,2,5,8,62.5,3,5,3,2,2,11,9,1,Matches,2022-2023,Premier-League
Anthony Gordon,eng ENG,"FW,MF",Newcastle Utd,21.0,2001.0,5.4,14,12,5,7,2,9,20,45.0,11,9,1,8,2,16,1,1,Matches,2022-2023,Premier-League
Anthony Gordon,eng ENG,FW,Everton,21.0,2001.0,12.2,34,22,17,10,7,8,24,33.3,16,19,0,19,4,38,11,0,Matches,2022-2023,Premier-League
Demarai Gray,jm JAM,"FW,MF",Everton,26.0,1996.0,27.9,33,24,9,14,10,17,31,54.8,14,23,3,20,13,46,18,0,Matches,2022-2023,Premier-League
Jack Grealish,eng ENG,FW,Manchester City,26.0,1995.0,22.8,25,16,10,12,3,13,23,56.5,10,17,3,14,7,32,9,0,Matches,2022-2023,Premier-League
Sam Greenwood,eng ENG,"MF,FW",Leeds United,20.0,2002.0,4.7,15,7,7,8,0,8,21,38.1,13,10,2,8,1,16,1,0,Matches,2022-2023,Premier-League
Pascal Groß,de GER,"MF,DF",Brighton,31.0,1991.0,36.0,59,38,23,27,9,25,55,45.5,30,32,10,22,13,72,21,1,Matches,2022-2023,Premier-League
Vicente Guaita,es ESP,GK,Crystal Palace,35.0,1987.0,27.0,0,0,0,0,0,0,0,,0,0,0,0,0,0,9,1,Matches,2022-2023,Premier-League
Gonçalo Guedes,pt POR,"FW,MF",Wolves,25.0,1996.0,7.9,8,6,4,3,1,5,8,62.5,3,4,0,4,1,9,2,0,Matches,2022-2023,Premier-League
Marc Guéhi,eng ENG,DF,Crystal Palace,22.0,2000.0,37.0,52,27,39,11,2,26,42,61.9,16,45,24,21,45,97,134,3,Matches,2022-2023,Premier-League
Bruno Guimarães,br BRA,MF,Newcastle Utd,24.0,1997.0,30.3,78,40,27,46,5,38,65,58.5,27,28,4,24,36,114,22,1,Matches,2022-2023,Premier-League
İlkay Gündoğan,de GER,MF,Manchester City,31.0,1990.0,26.1,30,18,7,13,10,12,34,35.3,22,18,3,15,20,50,13,0,Matches,2022-2023,Premier-League
Darko Gyabi,eng ENG,FW,Leeds United,18.0,2004.0,0.1,2,2,1,1,0,0,0,,0,2,0,2,0,2,0,0,Matches,2022-2023,Premier-League
Erling Haaland,no NOR,FW,Manchester City,22.0,2000.0,30.8,3,2,0,2,1,1,5,20.0,4,12,4,8,3,6,14,0,Matches,2022-2023,Premier-League
Lewis Hall,eng ENG,DF,Chelsea,17.0,2004.0,7.3,23,12,19,4,0,15,22,68.2,7,8,0,8,11,34,11,1,Matches,2022-2023,Premier-League
Luke Harris,wls WAL,"MF,FW",Fulham,17.0,2005.0,0.1,0,0,0,0,0,0,0,,0,0,0,0,0,0,0,0,Matches,2022-2023,Premier-League
Jack Harrison,eng ENG,"FW,MF",Leeds United,25.0,1996.0,30.1,41,17,5,15,21,12,52,23.1,40,47,2,45,22,63,25,0,Matches,2022-2023,Premier-League
Kai Havertz,de GER,"FW,MF",Chelsea,23.0,1999.0,28.5,34,16,4,20,10,10,30,33.3,20,28,0,28,7,41,41,0,Matches,2022-2023,Premier-League
Jan Paul van Hecke,nl NED,DF,Brighton,22.0,2000.0,3.3,8,6,3,4,1,5,5,100.0,0,8,5,3,6,14,9,0,Matches,2022-2023,Premier-League
Hwang Hee-chan,kr KOR,"FW,MF",Wolves,26.0,1996.0,12.6,20,9,7,8,5,6,20,30.0,14,18,2,16,5,25,5,0,Matches,2022-2023,Premier-League
Dean Henderson,eng ENG,GK,Nott'ham Forest,25.0,1997.0,18.0,0,0,0,0,0,0,0,,0,0,0,0,0,0,12,1,Matches,2022-2023,Premier-League
Jordan Henderson,eng ENG,MF,Liverpool,32.0,1990.0,23.0,32,23,10,18,4,15,36,41.7,21,21,3,18,21,53,16,1,Matches,2022-2023,Premier-League
Wayne Hennessey,wls WAL,GK,Nott'ham Forest,35.0,1987.0,3.0,1,0,1,0,0,1,1,100.0,0,0,0,0,0,1,2,0,Matches,2022-2023,Premier-League
Rico Henry,eng ENG,DF,Brentford,25.0,1997.0,36.0,57,31,20,28,9,22,41,53.7,19,29,8,21,30,87,84,1,Matches,2022-2023,Premier-League
Son Heung-min,kr KOR,"MF,FW",Tottenham,30.0,1992.0,32.1,24,12,7,8,9,9,30,30.0,21,23,2,21,13,37,6,0,Matches,2022-2023,Premier-League
Aaron Hickey,sct SCO,DF,Brentford,20.0,2002.0,21.3,38,26,27,11,0,18,32,56.3,14,18,7,11,17,55,32,1,Matches,2022-2023,Premier-League
Jack Hinshelwood,eng ENG,FW,Brighton,17.0,2005.0,0.0,1,0,1,0,0,0,0,,0,0,0,0,0,1,0,0,Matches,2022-2023,Premier-League
Joseph Hodge,ie IRL,MF,Wolves,19.0,2002.0,1.9,5,2,1,3,1,3,4,75.0,1,5,0,5,0,5,2,1,Matches,2022-2023,Premier-League
Rob Holding,eng ENG,DF,Arsenal,26.0,1995.0,6.3,8,5,4,4,0,3,6,50.0,3,6,5,1,3,11,27,1,Matches,2022-2023,Premier-League
Mason Holgate,eng ENG,DF,Everton,25.0,1996.0,5.6,11,7,8,3,0,3,11,27.3,8,7,3,4,7,18,28,0,Matches,2022-2023,Premier-League
Will Hughes,eng ENG,MF,Crystal Palace,27.0,1995.0,9.4,29,16,11,16,2,11,20,55.0,9,16,7,9,16,45,9,0,Matches,2022-2023,Premier-League
Omari Hutchinson,eng ENG,FW,Chelsea,18.0,2003.0,0.3,0,0,0,0,0,0,0,,0,0,0,0,1,1,0,0,Matches,2022-2023,Premier-League
Pierre Højbjerg,dk DEN,MF,Tottenham,26.0,1995.0,34.8,56,30,28,22,6,26,67,38.8,41,46,17,29,49,105,64,1,Matches,2022-2023,Premier-League
Kelechi Iheanacho,ng NGA,"FW,MF",Leicester City,25.0,1996.0,12.5,7,2,0,3,4,3,10,30.0,7,9,1,8,0,7,8,0,Matches,2022-2023,Premier-League
Danny Ings,eng ENG,FW,West Ham,30.0,1992.0,8.6,9,8,0,4,5,5,14,35.7,9,8,2,6,3,12,5,0,Matches,2022-2023,Premier-League
Danny Ings,eng ENG,FW,Aston Villa,30.0,1992.0,9.2,10,5,1,6,3,1,6,16.7,5,12,1,11,1,11,11,0,Matches,2022-2023,Premier-League
Alexander Isak,se SWE,FW,Newcastle Utd,22.0,1999.0,16.9,18,8,4,7,7,10,28,35.7,18,21,2,19,4,22,8,0,Matches,2022-2023,Premier-League
Daniel Iversen,dk DEN,GK,Leicester City,25.0,1997.0,12.0,0,0,0,0,0,0,0,,0,0,0,0,0,0,6,1,Matches,2022-2023,Premier-League
Alex Iwobi,ng NGA,"MF,FW",Everton,26.0,1996.0,37.5,69,37,37,28,4,33,65,50.8,32,41,2,39,25,94,29,0,Matches,2022-2023,Premier-League
Daniel James,wls WAL,FW,Leeds United,24.0,1997.0,2.2,6,2,1,3,2,3,6,50.0,3,4,0,4,2,8,2,0,Matches,2022-2023,Premier-League
Daniel James,wls WAL,FW,Fulham,24.0,1997.0,6.9,10,6,4,5,1,4,9,44.4,5,5,1,4,1,11,5,0,Matches,2022-2023,Premier-League
Reece James,eng ENG,"DF,MF",Chelsea,22.0,1999.0,13.8,31,20,10,18,3,15,19,78.9,4,17,2,15,12,43,23,0,Matches,2022-2023,Premier-League
Vitaly Janelt,de GER,"MF,DF",Brentford,24.0,1998.0,24.5,54,27,20,24,10,21,49,42.9,28,29,9,20,29,83,26,0,Matches,2022-2023,Premier-League
Pontus Jansson,se SWE,DF,Brentford,31.0,1991.0,8.0,5,3,4,1,0,3,5,60.0,2,13,9,4,9,14,38,0,Matches,2022-2023,Premier-League
Mathias Jensen,dk DEN,MF,Brentford,26.0,1996.0,31.1,71,36,29,30,12,34,97,35.1,63,54,5,49,32,103,24,1,Matches,2022-2023,Premier-League
Gabriel Jesus,br BRA,FW,Arsenal,25.0,1997.0,22.9,33,25,16,8,9,15,32,46.9,17,27,3,24,11,44,15,1,Matches,2022-2023,Premier-League
Raúl Jiménez,mx MEX,FW,Wolves,31.0,1991.0,9.4,9,6,3,5,1,3,6,50.0,3,9,0,9,0,9,8,0,Matches,2022-2023,Premier-League
Joelinton,br BRA,"MF,FW",Newcastle Utd,25.0,1996.0,29.6,70,49,36,26,8,26,62,41.9,36,52,7,45,48,118,39,0,Matches,2022-2023,Premier-League
Ben Johnson,eng ENG,DF,West Ham,22.0,2000.0,9.6,20,14,12,4,4,12,18,66.7,6,12,4,8,9,29,28,1,Matches,2022-2023,Premier-League
Brennan Johnson,wls WAL,"FW,MF",Nott'ham Forest,21.0,2001.0,32.6,34,20,18,8,8,8,29,27.6,21,30,1,29,5,39,7,1,Matches,2022-2023,Premier-League
Sam Johnstone,eng ENG,GK,Crystal Palace,29.0,1993.0,9.0,0,0,0,0,0,0,0,,0,0,0,0,0,0,5,0,Matches,2022-2023,Premier-League
Curtis Jones,eng ENG,MF,Liverpool,21.0,2001.0,11.5,34,17,8,12,14,18,31,58.1,13,12,2,10,3,37,9,0,Matches,2022-2023,Premier-League
Jorginho,it ITA,MF,Arsenal,30.0,1991.0,9.5,18,13,6,10,2,5,24,20.8,19,7,2,5,9,27,8,0,Matches,2022-2023,Premier-League
Jorginho,it ITA,MF,Chelsea,30.0,1991.0,14.2,42,23,22,14,6,22,46,47.8,24,18,3,15,21,63,7,0,Matches,2022-2023,Premier-League
Mateo Joseph,es ESP,"FW,MF",Leeds United,18.0,2003.0,0.3,0,0,0,0,0,0,0,,0,1,0,1,0,0,1,0,Matches,2022-2023,Premier-League
Diogo Jota,pt POR,FW,Liverpool,25.0,1996.0,12.6,23,15,8,8,7,12,37,32.4,25,5,0,5,3,26,11,0,Matches,2022-2023,Premier-League
Hamed Junior Traorè,ci CIV,"FW,MF",Bournemouth,22.0,2000.0,4.7,17,11,5,9,3,6,18,33.3,12,9,0,9,2,19,1,0,Matches,2022-2023,Premier-League
James Justin,eng ENG,DF,Leicester City,24.0,1998.0,13.9,20,18,7,12,1,9,18,50.0,9,24,6,18,15,35,47,0,Matches,2022-2023,Premier-League
Mathias Jørgensen,dk DEN,DF,Brentford,32.0,1990.0,12.3,17,8,9,8,0,9,21,42.9,12,19,12,7,16,33,39,1,Matches,2022-2023,Premier-League
Sasa Kalajdzic,at AUT,FW,Wolves,25.0,1997.0,0.5,0,0,0,0,0,0,0,,0,0,0,0,1,1,0,0,Matches,2022-2023,Premier-League
Boubacar Kamara,fr FRA,MF,Aston Villa,22.0,1999.0,19.7,58,25,25,23,10,27,56,48.2,29,38,12,26,19,77,24,3,Matches,2022-2023,Premier-League
Harry Kane,eng ENG,FW,Tottenham,29.0,1993.0,37.8,15,12,1,6,8,7,21,33.3,14,27,7,20,2,17,18,0,Matches,2022-2023,Premier-League
N'Golo Kanté,fr FRA,MF,Chelsea,31.0,1991.0,5.8,16,10,4,10,2,4,8,50.0,4,11,0,11,6,22,2,0,Matches,2022-2023,Premier-League
Michael Keane,eng ENG,DF,Everton,29.0,1993.0,10.9,7,4,5,2,0,5,8,62.5,3,12,7,5,14,21,55,1,Matches,2022-2023,Premier-League
Neeskens Kebano,cd COD,FW,Fulham,30.0,1992.0,8.5,17,9,8,6,3,9,18,50.0,9,14,0,14,1,18,8,0,Matches,2022-2023,Premier-League
Thilo Kehrer,de GER,DF,West Ham,25.0,1996.0,24.8,43,24,25,14,4,21,45,46.7,24,16,6,10,34,77,76,1,Matches,2022-2023,Premier-League
Naby Keïta,gn GUI,MF,Liverpool,27.0,1995.0,3.3,5,4,2,3,0,1,4,25.0,3,1,0,1,2,7,3,0,Matches,2022-2023,Premier-League
Caoimhín Kelleher,ie IRL,GK,Liverpool,23.0,1998.0,1.0,0,0,0,0,0,0,0,,0,0,0,0,0,0,0,0,Matches,2022-2023,Premier-League
Lloyd Kelly,eng ENG,DF,Bournemouth,23.0,1998.0,22.7,33,18,23,9,1,13,19,68.4,6,26,15,11,26,59,101,1,Matches,2022-2023,Premier-League
Max Kilman,eng ENG,DF,Wolves,25.0,1997.0,36.7,36,20,26,9,1,16,30,53.3,14,70,42,28,19,55,164,1,Matches,2022-2023,Premier-League
Jakub Kiwior,pl POL,DF,Arsenal,22.0,2000.0,4.7,7,5,6,1,0,5,8,62.5,3,5,3,2,6,13,10,0,Matches,2022-2023,Premier-League
Mateusz Klich,pl POL,"MF,FW",Leeds United,32.0,1990.0,3.1,12,8,3,4,5,7,13,53.8,6,4,0,4,0,12,1,0,Matches,2022-2023,Premier-League
Robin Koch,de GER,DF,Leeds United,26.0,1996.0,35.3,53,30,32,16,5,24,56,42.9,32,44,21,23,43,96,152,1,Matches,2022-2023,Premier-League
Ibrahima Konaté,fr FRA,DF,Liverpool,23.0,1999.0,17.2,38,26,25,13,0,16,27,59.3,11,12,5,7,26,64,61,4,Matches,2022-2023,Premier-League
Ezri Konsa,eng ENG,DF,Aston Villa,24.0,1997.0,36.9,42,20,25,15,2,18,26,69.2,8,41,23,18,26,68,120,3,Matches,2022-2023,Premier-League
Kalidou Koulibaly,sn SEN,DF,Chelsea,31.0,1991.0,20.0,45,31,34,8,3,26,40,65.0,14,30,13,17,29,74,77,0,Matches,2022-2023,Premier-League
Cheikhou Kouyaté,sn SEN,MF,Nott'ham Forest,32.0,1989.0,9.8,29,21,18,8,3,9,13,69.2,4,14,2,12,10,39,24,0,Matches,2022-2023,Premier-League
Mateo Kovačić,hr CRO,MF,Chelsea,28.0,1994.0,19.0,36,24,16,14,6,14,36,38.9,22,10,1,9,19,55,16,0,Matches,2022-2023,Premier-League
Emil Krafth,se SWE,DF,Newcastle Utd,27.0,1994.0,0.0,0,0,0,0,0,0,0,,0,0,0,0,0,0,0,0,Matches,2022-2023,Premier-League
Rasmus Kristensen,dk DEN,DF,Leeds United,25.0,1997.0,21.8,62,35,35,21,6,42,76,55.3,34,32,14,18,35,97,61,0,Matches,2022-2023,Premier-League
Dejan Kulusevski,se SWE,"MF,FW",Tottenham,22.0,2000.0,23.0,38,15,23,7,8,16,44,36.4,28,19,0,19,13,51,7,0,Matches,2022-2023,Premier-League
Layvin Kurzawa,fr FRA,DF,Fulham,29.0,1992.0,1.5,3,2,1,1,1,3,3,100.0,0,1,1,0,2,5,4,0,Matches,2022-2023,Premier-League
Adam Lallana,eng ENG,"MF,FW",Brighton,34.0,1988.0,8.0,9,4,6,2,1,0,7,0.0,7,6,0,6,2,11,1,0,Matches,2022-2023,Premier-League
Tariq Lamptey,gh GHA,DF,Brighton,21.0,2000.0,5.0,11,6,6,4,1,5,7,71.4,2,7,3,4,7,18,2,0,Matches,2022-2023,Premier-League
Manuel Lanzini,ar ARG,"MF,FW",West Ham,29.0,1993.0,2.8,2,2,1,1,0,2,6,33.3,4,2,0,2,2,4,0,0,Matches,2022-2023,Premier-League
Aymeric Laporte,es ESP,DF,Manchester City,28.0,1994.0,11.0,11,8,6,4,1,7,11,63.6,4,10,4,6,3,14,30,1,Matches,2022-2023,Premier-League
Juan Larios,es ESP,DF,Southampton,18.0,2004.0,1.7,7,6,6,1,0,5,5,100.0,0,2,0,2,3,10,4,0,Matches,2022-2023,Premier-League
Jamaal Lascelles,eng ENG,DF,Newcastle Utd,28.0,1993.0,2.4,1,0,1,0,0,1,1,100.0,0,3,2,1,0,1,17,0,Matches,2022-2023,Premier-League
Roméo Lavia,be BEL,MF,Southampton,18.0,2004.0,24.7,60,35,27,29,4,21,53,39.6,32,47,11,36,33,93,23,1,Matches,2022-2023,Premier-League
Dexter Lembikisa,jm JAM,DF,Wolves,18.0,2003.0,0.3,0,0,0,0,0,0,0,,0,0,0,0,0,0,0,0,Matches,2022-2023,Premier-League
Mario Lemina,ga GAB,MF,Wolves,28.0,1993.0,14.4,38,24,22,13,3,20,38,52.6,18,26,8,18,14,52,24,1,Matches,2022-2023,Premier-League
Clément Lenglet,fr FRA,DF,Tottenham,27.0,1995.0,22.4,38,23,18,15,5,16,34,47.1,18,26,11,15,18,56,68,2,Matches,2022-2023,Premier-League
Bernd Leno,de GER,GK,Fulham,30.0,1992.0,36.0,0,0,0,0,0,0,3,0.0,3,0,0,0,0,0,18,1,Matches,2022-2023,Premier-League
Jefferson Lerma,co COL,MF,Bournemouth,27.0,1994.0,36.1,50,30,23,23,4,20,45,44.4,25,32,15,17,47,97,91,2,Matches,2022-2023,Premier-League
Jamal Lewis,nir NIR,"DF,FW",Newcastle Utd,24.0,1998.0,0.1,0,0,0,0,0,0,0,,0,0,0,0,0,0,0,0,Matches,2022-2023,Premier-League
Rico Lewis,eng ENG,"DF,MF",Manchester City,17.0,2004.0,10.0,16,9,9,5,2,6,11,54.5,5,8,4,4,6,22,13,1,Matches,2022-2023,Premier-League
Keane Lewis-Potter,eng ENG,"FW,MF",Brentford,21.0,2001.0,3.6,1,0,0,1,0,0,0,,0,5,1,4,0,1,2,0,Matches,2022-2023,Premier-League
Victor Lindelöf,se SWE,DF,Manchester Utd,28.0,1994.0,15.2,22,17,10,9,3,9,17,52.9,8,18,9,9,21,43,63,1,Matches,2022-2023,Premier-League
Jesse Lingard,eng ENG,"FW,MF",Nott'ham Forest,29.0,1992.0,10.3,4,4,2,2,0,1,7,14.3,6,11,0,11,5,9,4,0,Matches,2022-2023,Premier-League
Valentino Livramento,eng ENG,"DF,FW",Southampton,19.0,2002.0,0.3,2,1,2,0,0,0,0,,0,0,0,0,2,4,3,0,Matches,2022-2023,Premier-League
Diego Llorente,es ESP,DF,Leeds United,28.0,1993.0,7.2,13,10,8,5,0,4,8,50.0,4,6,2,4,15,28,24,2,Matches,2022-2023,Premier-League
Hugo Lloris,fr FRA,GK,Tottenham,35.0,1986.0,24.5,1,1,1,0,0,1,3,33.3,2,0,0,0,1,2,13,5,Matches,2022-2023,Premier-League
Renan Lodi,br BRA,DF,Nott'ham Forest,24.0,1998.0,24.6,52,39,38,8,6,33,66,50.0,33,25,6,19,33,85,74,0,Matches,2022-2023,Premier-League
Ruben Loftus-Cheek,eng ENG,"MF,DF",Chelsea,26.0,1996.0,17.1,25,14,8,14,3,12,22,54.5,10,15,2,13,12,37,23,0,Matches,2022-2023,Premier-League
Sean Longstaff,eng ENG,MF,Newcastle Utd,24.0,1997.0,28.0,42,21,16,20,6,20,52,38.5,32,35,8,27,16,58,23,0,Matches,2022-2023,Premier-League
Jamal Lowe,jm JAM,"MF,FW",Bournemouth,28.0,1994.0,0.1,0,0,0,0,0,0,0,,0,0,0,0,0,0,0,0,Matches,2022-2023,Premier-League
Douglas Luiz,br BRA,MF,Aston Villa,24.0,1998.0,32.5,72,42,31,32,9,29,63,46.0,34,36,7,29,40,112,27,2,Matches,2022-2023,Premier-League
Saša Lukić,rs SRB,MF,Fulham,25.0,1996.0,4.6,8,3,1,4,3,3,7,42.9,4,6,2,4,5,13,3,0,Matches,2022-2023,Premier-League
Lyanco,br BRA,DF,Southampton,25.0,1997.0,13.1,24,16,15,9,0,12,18,66.7,6,30,25,5,20,44,65,2,Matches,2022-2023,Premier-League
Alexis Mac Allister,ar ARG,MF,Brighton,23.0,1998.0,32.1,70,39,22,40,8,34,71,47.9,37,26,2,24,22,92,10,1,Matches,2022-2023,Premier-League
James Maddison,eng ENG,"MF,FW",Leicester City,25.0,1996.0,27.6,51,26,25,19,7,19,50,38.0,31,19,1,18,13,64,6,1,Matches,2022-2023,Premier-League
Noni Madueke,eng ENG,FW,Chelsea,20.0,2002.0,7.1,12,8,5,4,3,6,13,46.2,7,13,2,11,4,16,7,0,Matches,2022-2023,Premier-League
Gabriel Magalhães,br BRA,DF,Arsenal,24.0,1997.0,37.9,48,30,29,15,4,18,27,66.7,9,49,26,23,32,80,125,3,Matches,2022-2023,Premier-League
Harry Maguire,eng ENG,DF,Manchester Utd,29.0,1993.0,8.5,8,6,6,1,1,4,5,80.0,1,18,11,7,13,21,41,0,Matches,2022-2023,Premier-League
Riyad Mahrez,dz ALG,"FW,MF",Manchester City,31.0,1991.0,21.3,30,14,8,13,9,13,39,33.3,26,27,1,26,9,39,5,0,Matches,2022-2023,Premier-League
Kobbie Mainoo,eng ENG,MF,Manchester Utd,17.0,2005.0,0.1,0,0,0,0,0,0,0,,0,1,1,0,0,0,0,0,Matches,2022-2023,Premier-League
Ainsley Maitland-Niles,eng ENG,"DF,MF",Southampton,24.0,1997.0,15.6,45,24,23,18,4,28,44,63.6,16,28,7,21,22,67,45,1,Matches,2022-2023,Premier-League
Tyrell Malacia,nl NED,DF,Manchester Utd,22.0,1999.0,15.5,46,33,33,12,1,14,25,56.0,11,13,3,10,25,71,49,0,Matches,2022-2023,Premier-League
Orel Mangala,be BEL,MF,Nott'ham Forest,24.0,1998.0,17.2,28,20,16,10,2,12,29,41.4,17,21,7,14,23,51,15,0,Matches,2022-2023,Premier-League
Javier Manquillo,es ESP,DF,Newcastle Utd,28.0,1994.0,0.4,3,2,2,1,0,2,2,100.0,0,1,0,1,1,4,1,0,Matches,2022-2023,Premier-League
Sekou Mara,fr FRA,"FW,MF",Southampton,20.0,2002.0,6.2,14,10,5,8,1,3,9,33.3,6,11,0,11,1,15,5,0,Matches,2022-2023,Premier-League
Solly March,eng ENG,"FW,DF",Brighton,28.0,1994.0,30.2,53,31,16,17,20,8,28,28.6,20,34,3,31,24,77,32,0,Matches,2022-2023,Premier-League
Emiliano Marcondes,dk DEN,MF,Bournemouth,27.0,1995.0,0.1,0,0,0,0,0,0,0,,0,0,0,0,0,0,1,0,Matches,2022-2023,Premier-League
Marquinhos,br BRA,MF,Arsenal,19.0,2003.0,0.0,0,0,0,0,0,0,0,,0,0,0,0,0,0,0,0,Matches,2022-2023,Premier-League
Anthony Martial,fr FRA,FW,Manchester Utd,26.0,1995.0,10.9,5,3,0,2,3,1,4,25.0,3,11,2,9,1,6,4,0,Matches,2022-2023,Premier-League
Gabriel Martinelli,br BRA,FW,Arsenal,21.0,2001.0,31.0,31,18,13,12,6,9,22,40.9,13,24,1,23,9,40,14,0,Matches,2022-2023,Premier-League
Emiliano Martínez,ar ARG,GK,Aston Villa,29.0,1992.0,34.9,0,0,0,0,0,0,2,0.0,2,0,0,0,1,1,23,1,Matches,2022-2023,Premier-League
Lisandro Martínez,ar ARG,DF,Manchester Utd,24.0,1998.0,23.5,54,28,33,18,3,30,43,69.8,13,51,27,24,33,87,103,0,Matches,2022-2023,Premier-League
Pape Matar Sarr,sn SEN,"MF,FW",Tottenham,19.0,2002.0,2.4,7,6,4,2,1,4,8,50.0,4,3,2,1,6,13,6,0,Matches,2022-2023,Premier-League
Jean-Philippe Mateta,fr FRA,FW,Crystal Palace,25.0,1997.0,8.6,7,1,2,4,1,1,3,33.3,2,3,1,2,3,10,18,0,Matches,2022-2023,Premier-League
Joël Matip,cm CMR,DF,Liverpool,30.0,1991.0,12.1,14,8,12,2,0,11,23,47.8,12,8,3,5,21,35,45,3,Matches,2022-2023,Premier-League
Neal Maupay,fr FRA,FW,Everton,25.0,1996.0,12.4,11,5,3,4,4,2,4,50.0,2,8,0,8,5,16,0,0,Matches,2022-2023,Premier-League
Kevin Mbabu,ch SUI,"DF,FW",Fulham,27.0,1995.0,1.6,3,2,2,1,0,1,3,33.3,2,2,0,2,3,6,3,0,Matches,2022-2023,Premier-League
Bryan Mbeumo,cm CMR,FW,Brentford,22.0,1999.0,32.3,26,18,5,13,8,8,42,19.0,34,24,1,23,13,39,21,0,Matches,2022-2023,Premier-League
James McArthur,sct SCO,MF,Crystal Palace,34.0,1987.0,0.6,1,1,1,0,0,1,1,100.0,0,2,1,1,1,2,2,0,Matches,2022-2023,Premier-League
Alex McCarthy,eng ENG,GK,Southampton,32.0,1989.0,6.0,0,0,0,0,0,0,1,0.0,1,0,0,0,1,1,3,1,Matches,2022-2023,Premier-League
John McGinn,sct SCO,"MF,FW",Aston Villa,27.0,1994.0,29.9,66,36,27,29,10,34,71,47.9,37,43,4,39,24,90,19,0,Matches,2022-2023,Premier-League
Scott McKenna,sct SCO,DF,Nott'ham Forest,25.0,1996.0,17.5,12,7,7,3,2,6,10,60.0,4,20,14,6,12,24,85,1,Matches,2022-2023,Premier-League
Weston McKennie,us USA,MF,Leeds United,23.0,1998.0,16.0,30,13,5,18,7,10,29,34.5,19,22,3,19,22,52,26,0,Matches,2022-2023,Premier-League
Dwight McNeil,eng ENG,"FW,MF",Everton,22.0,1999.0,27.8,64,41,35,14,15,27,65,41.5,38,46,7,39,31,95,41,0,Matches,2022-2023,Premier-League
Scott McTominay,sct SCO,MF,Manchester Utd,25.0,1996.0,12.9,32,19,16,10,6,13,22,59.1,9,15,6,9,14,46,45,1,Matches,2022-2023,Premier-League
Ben Mee,eng ENG,DF,Brentford,32.0,1989.0,36.3,45,24,28,13,4,20,37,54.1,17,54,42,12,48,93,122,2,Matches,2022-2023,Premier-League
Edouard Mendy,sn SEN,GK,Chelsea,30.0,1992.0,9.5,0,0,0,0,0,0,0,,0,0,0,0,0,0,3,3,Matches,2022-2023,Premier-League
Nampalys Mendy,sn SEN,MF,Leicester City,30.0,1992.0,8.4,13,9,7,6,0,8,15,53.3,7,20,4,16,13,26,2,0,Matches,2022-2023,Premier-League
Chris Mepham,wls WAL,DF,Bournemouth,24.0,1997.0,24.4,45,22,37,8,0,19,30,63.3,11,40,27,13,30,75,152,0,Matches,2022-2023,Premier-League
Illan Meslier,fr FRA,GK,Leeds United,22.0,2000.0,34.0,2,1,2,0,0,2,4,50.0,2,0,0,0,1,3,30,3,Matches,2022-2023,Premier-League
Alex Mighten,eng ENG,FW,Nott'ham Forest,20.0,2002.0,0.1,0,0,0,0,0,0,1,0.0,1,0,0,0,0,0,0,0,Matches,2022-2023,Premier-League
Lewis Miley,eng ENG,MF,Newcastle Utd,16.0,2006.0,0.2,0,0,0,0,0,0,0,,0,1,0,1,0,0,0,0,Matches,2022-2023,Premier-League
Luka Milivojević,rs SRB,MF,Crystal Palace,31.0,1991.0,5.7,13,7,7,4,2,7,10,70.0,3,13,4,9,12,25,10,1,Matches,2022-2023,Premier-League
James Milner,eng ENG,"MF,DF",Liverpool,36.0,1986.0,10.1,26,16,11,11,4,15,34,44.1,19,14,2,12,12,38,15,0,Matches,2022-2023,Premier-League
Yerry Mina,co COL,DF,Everton,27.0,1994.0,6.6,15,8,9,6,0,9,11,81.8,2,7,4,3,6,21,28,0,Matches,2022-2023,Premier-League
Tyrone Mings,eng ENG,DF,Aston Villa,29.0,1993.0,35.0,15,7,10,5,0,9,20,45.0,11,40,21,19,54,69,163,2,Matches,2022-2023,Premier-League
Tyrick Mitchell,eng ENG,DF,Crystal Palace,22.0,1999.0,32.1,71,49,43,23,5,30,53,56.6,23,48,11,37,42,113,78,0,Matches,2022-2023,Premier-League
Kaoru Mitoma,jp JPN,"FW,MF",Brighton,25.0,1997.0,25.8,44,27,15,16,13,20,41,48.8,21,25,0,25,17,61,10,0,Matches,2022-2023,Premier-League
Aleksandar Mitrović,rs SRB,FW,Fulham,27.0,1994.0,22.3,14,7,8,4,2,5,12,41.7,7,22,5,17,3,17,20,1,Matches,2022-2023,Premier-League
Kieffer Moore,wls WAL,FW,Bournemouth,29.0,1992.0,14.2,14,11,2,9,3,5,16,31.3,11,12,5,7,1,15,26,0,Matches,2022-2023,Premier-League
Andrew Moran,ie IRL,FW,Brighton,18.0,2003.0,0.1,0,0,0,0,0,0,0,,0,1,0,1,0,0,0,0,Matches,2022-2023,Premier-League
Álex Moreno,es ESP,DF,Aston Villa,29.0,1993.0,14.8,23,14,15,5,3,13,36,36.1,23,18,3,15,7,30,37,2,Matches,2022-2023,Premier-League
Mason Mount,eng ENG,"MF,FW",Chelsea,23.0,1999.0,18.3,33,19,6,16,11,14,27,51.9,13,24,6,18,8,41,9,0,Matches,2022-2023,Premier-League
Lucas Moura,br BRA,"MF,DF",Tottenham,29.0,1992.0,1.7,8,5,1,3,4,1,4,25.0,3,0,0,0,2,10,1,1,Matches,2022-2023,Premier-League
João Moutinho,pt POR,MF,Wolves,35.0,1986.0,19.8,51,30,24,21,6,19,46,41.3,27,22,6,16,18,69,20,0,Matches,2022-2023,Premier-League
Divin Mubama,eng ENG,FW,West Ham,17.0,2004.0,0.4,1,1,1,0,0,0,0,,0,0,0,0,0,1,0,0,Matches,2022-2023,Premier-League
Mykhailo Mudryk,ua UKR,"FW,MF",Chelsea,21.0,2001.0,7.3,11,9,2,4,5,4,13,30.8,9,7,1,6,0,11,3,0,Matches,2022-2023,Premier-League
Jacob Murphy,eng ENG,FW,Newcastle Utd,27.0,1995.0,13.9,15,7,3,8,4,8,20,40.0,12,17,0,17,7,22,3,0,Matches,2022-2023,Premier-League
Enock Mwepu,zm ZAM,"FW,MF",Brighton,24.0,1998.0,2.4,10,5,1,6,3,3,4,75.0,1,3,1,2,1,11,1,0,Matches,2022-2023,Premier-League
Vitaliy Mykolenko,ua UKR,DF,Everton,23.0,1999.0,29.5,58,34,36,19,3,28,51,54.9,23,50,16,34,46,104,99,0,Matches,2022-2023,Premier-League
Keylor Navas,cr CRC,GK,Nott'ham Forest,35.0,1986.0,17.0,0,0,0,0,0,0,0,,0,0,0,0,1,1,11,2,Matches,2022-2023,Premier-League
Wilfred Ndidi,ng NGA,MF,Leicester City,25.0,1996.0,18.7,61,42,34,24,3,17,43,39.5,26,32,14,18,38,99,48,3,Matches,2022-2023,Premier-League
Reiss Nelson,eng ENG,FW,Arsenal,22.0,1999.0,2.4,4,1,2,1,1,2,4,50.0,2,3,0,3,0,4,4,0,Matches,2022-2023,Premier-League
Neto,br BRA,GK,Bournemouth,33.0,1989.0,26.5,3,1,3,0,0,3,3,100.0,0,0,0,0,0,3,10,3,Matches,2022-2023,Premier-League
Pedro Neto,pt POR,"FW,MF",Wolves,22.0,2000.0,10.7,11,6,4,2,5,7,17,41.2,10,5,1,4,4,15,4,0,Matches,2022-2023,Premier-League
Rúben Neves,pt POR,MF,Wolves,25.0,1997.0,33.5,79,43,31,33,15,32,76,42.1,44,59,22,37,50,129,85,1,Matches,2022-2023,Premier-League
Moussa Niakhate,sn SEN,DF,Nott'ham Forest,26.0,1996.0,12.9,18,9,15,3,0,11,22,50.0,11,18,8,10,19,37,60,0,Matches,2022-2023,Premier-League
Eddie Nketiah,eng ENG,FW,Arsenal,23.0,1999.0,12.1,13,9,6,2,5,2,10,20.0,8,7,1,6,1,14,7,0,Matches,2022-2023,Premier-League
Matheus Nunes,pt POR,MF,Wolves,23.0,1998.0,27.4,67,43,36,22,9,28,61,45.9,33,35,4,31,16,83,35,2,Matches,2022-2023,Premier-League
Darwin Núñez,uy URU,FW,Liverpool,23.0,1999.0,18.8,11,5,2,4,5,4,17,23.5,13,10,0,10,3,14,13,0,Matches,2022-2023,Premier-League
Ethan Nwaneri,eng ENG,FW,Arsenal,15.0,2007.0,0.0,0,0,0,0,0,0,0,,0,1,0,1,0,0,0,0,Matches,2022-2023,Premier-League
Christian Nørgaard,dk DEN,MF,Brentford,28.0,1994.0,19.6,52,30,21,29,2,18,48,37.5,30,32,9,23,34,86,41,2,Matches,2022-2023,Premier-League
Lewis O'Brien,eng ENG,MF,Nott'ham Forest,23.0,1998.0,6.5,16,9,4,11,1,6,12,50.0,6,13,2,11,5,21,9,0,Matches,2022-2023,Premier-League
Odeluga Offiah,eng ENG,DF,Brighton,19.0,2002.0,0.3,1,1,1,0,0,0,2,0.0,2,0,0,0,0,1,1,0,Matches,2022-2023,Premier-League
Angelo Ogbonna,it ITA,DF,West Ham,34.0,1988.0,13.7,11,4,7,4,0,5,10,50.0,5,11,7,4,17,28,74,1,Matches,2022-2023,Premier-League
Michael Olise,fr FRA,"FW,MF",Crystal Palace,20.0,2001.0,30.5,58,34,28,26,4,25,60,41.7,35,46,1,45,26,84,17,0,Matches,2022-2023,Premier-League
Robin Olsen,se SWE,GK,Aston Villa,32.0,1990.0,3.1,0,0,0,0,0,0,2,0.0,2,0,0,0,0,0,1,0,Matches,2022-2023,Premier-League
Amadou Onana,be BEL,MF,Everton,20.0,2001.0,27.6,72,43,24,42,6,30,42,71.4,12,25,6,19,37,109,39,0,Matches,2022-2023,Premier-League
Josh Onomah,eng ENG,MF,Fulham,25.0,1997.0,0.2,1,0,1,0,0,0,0,,0,1,0,1,0,1,0,0,Matches,2022-2023,Premier-League
Paul Onuachu,ng NGA,FW,Southampton,28.0,1994.0,4.5,3,2,1,1,1,1,3,33.3,2,4,1,3,0,3,4,0,Matches,2022-2023,Premier-League
Frank Onyeka,ng NGA,MF,Brentford,24.0,1998.0,9.4,19,14,11,7,1,10,24,41.7,14,16,3,13,10,29,16,0,Matches,2022-2023,Premier-League
Mislav Oršić,hr CRO,MF,Southampton,29.0,1992.0,0.1,1,1,1,0,0,0,0,,0,0,0,0,0,1,0,0,Matches,2022-2023,Premier-League
Stefan Ortega,de GER,GK,Manchester City,29.0,1992.0,3.0,0,0,0,0,0,0,0,,0,0,0,0,0,0,0,0,Matches,2022-2023,Premier-League
Dango Ouattara,bf BFA,"MF,FW",Bournemouth,20.0,2002.0,13.8,28,15,20,6,2,13,32,40.6,19,20,3,17,13,41,29,1,Matches,2022-2023,Premier-League
Alex Oxlade-Chamberlain,eng ENG,"FW,MF",Liverpool,28.0,1993.0,3.7,5,4,1,2,2,1,5,20.0,4,5,2,3,1,6,4,0,Matches,2022-2023,Premier-League
David Ozoh,eng ENG,FW,Crystal Palace,17.0,2005.0,0.0,0,0,0,0,0,0,0,,0,0,0,0,0,0,0,0,Matches,2022-2023,Premier-League
João Palhinha,pt POR,MF,Fulham,27.0,1995.0,34.5,148,83,59,65,24,71,135,52.6,64,48,5,43,46,194,61,2,Matches,2022-2023,Premier-League
Cole Palmer,eng ENG,"MF,FW",Manchester City,20.0,2002.0,4.1,5,1,0,3,2,3,5,60.0,2,2,1,1,1,6,2,0,Matches,2022-2023,Premier-League
Emerson Palmieri,it ITA,DF,West Ham,27.0,1994.0,14.7,26,14,9,15,2,12,24,50.0,12,17,4,13,15,41,36,0,Matches,2022-2023,Premier-League
Lucas Paquetá,br BRA,MF,West Ham,24.0,1997.0,23.9,71,53,23,36,12,27,68,39.7,41,41,4,37,16,87,31,0,Matches,2022-2023,Premier-League
Thomas Partey,gh GHA,MF,Arsenal,29.0,1993.0,27.6,70,40,20,35,15,25,52,48.1,27,26,5,21,28,98,41,1,Matches,2022-2023,Premier-League
Nathan Patterson,sct SCO,"DF,MF",Everton,20.0,2001.0,14.2,49,24,32,13,4,29,54,53.7,25,24,4,20,15,64,45,0,Matches,2022-2023,Premier-League
Ben Pearson,eng ENG,MF,Bournemouth,27.0,1995.0,3.2,7,3,3,3,1,1,3,33.3,2,4,0,4,2,9,6,0,Matches,2022-2023,Premier-League
Facundo Pellistri,uy URU,"FW,MF",Manchester Utd,20.0,2001.0,0.7,1,1,0,1,0,0,0,,0,0,0,0,0,1,3,0,Matches,2022-2023,Premier-League
Andreas Pereira,br BRA,MF,Fulham,26.0,1996.0,29.9,18,9,3,6,9,8,34,23.5,26,21,3,18,6,24,8,0,Matches,2022-2023,Premier-League
Ricardo Pereira,pt POR,"DF,MF",Leicester City,28.0,1993.0,5.0,11,7,8,3,0,7,17,41.2,10,8,2,6,4,15,20,0,Matches,2022-2023,Premier-League
Ayoze Pérez,es ESP,"MF,FW",Leicester City,29.0,1993.0,4.2,11,8,5,4,2,8,19,42.1,11,6,0,6,2,13,3,0,Matches,2022-2023,Premier-League
Ivan Perišić,hr CRO,"DF,MF",Tottenham,33.0,1989.0,23.4,42,24,25,10,7,27,47,57.4,20,29,7,22,22,64,49,1,Matches,2022-2023,Premier-League
Romain Perraud,fr FRA,DF,Southampton,24.0,1997.0,20.4,54,33,23,23,8,28,52,53.8,24,24,6,18,20,74,42,0,Matches,2022-2023,Premier-League
Máximo Perrone,ar ARG,MF,Manchester City,19.0,2003.0,0.2,0,0,0,0,0,0,0,,0,1,0,1,0,0,0,0,Matches,2022-2023,Premier-League
Cameron Peupion,au AUS,MF,Brighton,19.0,2002.0,0.1,0,0,0,0,0,0,0,,0,0,0,0,0,0,0,0,Matches,2022-2023,Premier-League
Kalvin Phillips,eng ENG,MF,Manchester City,26.0,1995.0,3.3,6,4,3,3,0,2,10,20.0,8,7,3,4,5,11,10,0,Matches,2022-2023,Premier-League
Nathaniel Phillips,eng ENG,DF,Liverpool,25.0,1997.0,0.7,2,1,0,2,0,2,2,100.0,0,0,0,0,2,4,1,0,Matches,2022-2023,Premier-League
Jordan Pickford,eng ENG,GK,Everton,28.0,1994.0,37.0,0,0,0,0,0,0,1,0.0,1,0,0,0,4,4,15,3,Matches,2022-2023,Premier-League
Ethan Pinnock,jm JAM,DF,Brentford,29.0,1993.0,30.0,52,28,33,12,7,18,24,75.0,6,41,31,10,35,87,215,2,Matches,2022-2023,Premier-League
Daniel Podence,pt POR,"FW,MF",Wolves,26.0,1995.0,19.7,27,17,13,9,5,6,32,18.8,26,19,0,19,7,34,6,0,Matches,2022-2023,Premier-League
Nick Pope,eng ENG,GK,Newcastle Utd,30.0,1992.0,36.2,1,0,1,0,0,1,3,33.3,2,0,0,0,0,1,27,2,Matches,2022-2023,Premier-League
Pedro Porro,es ESP,"DF,MF",Tottenham,22.0,1999.0,12.6,25,16,8,15,2,14,39,35.9,25,25,2,23,15,40,24,1,Matches,2022-2023,Premier-League
Dennis Praet,be BEL,"MF,FW",Leicester City,28.0,1994.0,7.2,12,9,5,6,1,6,11,54.5,5,12,2,10,5,17,6,0,Matches,2022-2023,Premier-League
Isaac Price,nir NIR,MF,Everton,18.0,2003.0,0.4,0,0,0,0,0,0,1,0.0,1,1,1,0,0,0,0,0,Matches,2022-2023,Premier-League
Christian Pulisic,us USA,"FW,DF",Chelsea,23.0,1998.0,9.1,11,6,3,6,2,3,5,60.0,2,8,1,7,4,15,4,0,Matches,2022-2023,Premier-League
Aaron Ramsdale,eng ENG,GK,Arsenal,24.0,1998.0,38.0,1,1,1,0,0,1,1,100.0,0,0,0,0,0,1,20,6,Matches,2022-2023,Premier-League
Jacob Ramsey,eng ENG,"MF,FW",Aston Villa,21.0,2001.0,29.3,69,39,23,35,11,32,69,46.4,37,48,8,40,23,92,34,0,Matches,2022-2023,Premier-League
Marcus Rashford,eng ENG,FW,Manchester Utd,24.0,1997.0,32.0,20,10,7,8,5,9,24,37.5,15,31,4,27,7,27,14,0,Matches,2022-2023,Premier-League
David Raya,es ESP,GK,Brentford,26.0,1995.0,38.0,0,0,0,0,0,0,2,0.0,2,1,0,1,1,1,10,3,Matches,2022-2023,Premier-League
Tim Ream,us USA,DF,Fulham,34.0,1987.0,32.2,30,16,15,12,3,13,26,50.0,13,45,24,21,41,71,116,3,Matches,2022-2023,Premier-League
Nathan Redmond,eng ENG,DF,Southampton,28.0,1994.0,0.0,0,0,0,0,0,0,0,,0,0,0,0,0,0,0,0,Matches,2022-2023,Premier-League
Harrison Reed,eng ENG,MF,Fulham,27.0,1995.0,31.8,44,27,17,21,6,16,51,31.4,35,54,12,42,19,63,36,0,Matches,2022-2023,Premier-League
Declan Rice,eng ENG,MF,West Ham,23.0,1999.0,36.4,79,38,44,31,4,31,50,62.0,19,45,15,30,63,142,58,0,Matches,2022-2023,Premier-League
Chris Richards,us USA,DF,Crystal Palace,22.0,2000.0,5.0,9,6,8,1,0,5,7,71.4,2,10,1,9,8,17,31,0,Matches,2022-2023,Premier-League
Richarlison,br BRA,"MF,FW",Tottenham,25.0,1997.0,11.2,21,16,13,5,3,12,27,44.4,15,14,1,13,5,26,10,0,Matches,2022-2023,Premier-League
Jaïro Riedewald,nl NED,"DF,MF",Crystal Palace,25.0,1996.0,0.7,2,1,2,0,0,0,1,0.0,1,2,0,2,0,2,4,0,Matches,2022-2023,Premier-League
Matt Ritchie,sct SCO,"FW,MF",Newcastle Utd,32.0,1989.0,0.4,1,1,0,1,0,1,3,33.3,2,0,0,0,1,2,0,0,Matches,2022-2023,Premier-League
Andrew Robertson,sct SCO,DF,Liverpool,28.0,1994.0,28.7,38,21,12,16,10,21,41,51.2,20,32,5,27,18,56,50,3,Matches,2022-2023,Premier-League
Antonee Robinson,us USA,DF,Fulham,24.0,1997.0,34.3,62,38,43,15,4,44,65,67.7,21,49,13,36,53,115,83,3,Matches,2022-2023,Premier-League
Joel Robles,es ESP,GK,Leeds United,32.0,1990.0,4.0,0,0,0,0,0,0,1,0.0,1,0,0,0,0,0,2,1,Matches,2022-2023,Premier-League
Marc Roca,es ESP,MF,Leeds United,25.0,1996.0,25.7,66,40,27,34,5,20,66,30.3,46,34,10,24,23,89,24,2,Matches,2022-2023,Premier-League
Marek Rodák,sk SVK,GK,Fulham,25.0,1996.0,2.0,0,0,0,0,0,0,0,,0,0,0,0,0,0,1,1,Matches,2022-2023,Premier-League
Rodri,es ESP,MF,Manchester City,26.0,1996.0,32.3,67,41,28,28,11,26,53,49.1,27,40,14,26,33,100,43,1,Matches,2022-2023,Premier-League
Rodrigo,es ESP,"FW,MF",Leeds United,31.0,1991.0,21.5,24,10,2,15,7,8,20,40.0,12,16,4,12,6,30,21,1,Matches,2022-2023,Premier-League
Mads Roerslev,dk DEN,DF,Brentford,23.0,1999.0,12.3,22,12,19,3,0,16,33,48.5,17,14,5,9,9,31,38,0,Matches,2022-2023,Premier-League
Cristian Romero,ar ARG,DF,Tottenham,24.0,1998.0,26.3,68,36,42,24,2,29,46,63.0,17,40,18,22,44,112,102,3,Matches,2022-2023,Premier-League
Oriol Romeu,es ESP,MF,Southampton,30.0,1991.0,0.8,1,0,0,1,0,0,0,,0,1,0,1,1,2,1,0,Matches,2022-2023,Premier-League
Cristiano Ronaldo,pt POR,FW,Manchester Utd,37.0,1985.0,5.8,2,2,1,0,1,1,2,50.0,1,0,0,0,1,3,9,0,Matches,2022-2023,Premier-League
Connor Ronan,ie IRL,MF,Wolves,24.0,1998.0,0.0,0,0,0,0,0,0,0,,0,0,0,0,0,0,0,0,Matches,2022-2023,Premier-League
Salomón Rondón,ve VEN,FW,Everton,32.0,1989.0,1.2,0,0,0,0,0,0,0,,0,1,1,0,0,0,0,0,Matches,2022-2023,Premier-League
Joe Rothwell,eng ENG,MF,Bournemouth,27.0,1995.0,11.3,20,13,7,12,1,7,21,33.3,14,14,3,11,9,29,7,0,Matches,2022-2023,Premier-League
Georginio Rutter,fr FRA,"FW,MF",Leeds United,20.0,2002.0,3.0,10,9,5,3,2,5,8,62.5,3,5,0,5,3,13,3,0,Matches,2022-2023,Premier-League
José Sá,pt POR,GK,Wolves,29.0,1993.0,36.0,1,0,1,0,0,1,1,100.0,0,0,0,0,0,1,10,6,Matches,2022-2023,Premier-League
Marcel Sabitzer,at AUT,MF,Manchester Utd,28.0,1994.0,7.0,12,8,3,8,1,2,11,18.2,9,6,2,4,8,20,11,0,Matches,2022-2023,Premier-League
Allan Saint-Maximin,fr FRA,FW,Newcastle Utd,25.0,1997.0,12.4,10,3,3,6,1,2,11,18.2,9,4,0,4,5,15,2,0,Matches,2022-2023,Premier-League
Bukayo Saka,eng ENG,FW,Arsenal,20.0,2001.0,35.3,63,34,22,15,26,20,44,45.5,24,38,0,38,14,77,19,0,Matches,2022-2023,Premier-League
Mohamed Salah,eg EGY,FW,Liverpool,30.0,1992.0,36.6,21,12,4,5,12,10,26,38.5,16,21,0,21,6,27,4,0,Matches,2022-2023,Premier-League
William Saliba,fr FRA,DF,Arsenal,21.0,2001.0,26.8,34,20,23,9,2,15,18,83.3,3,13,10,3,19,53,85,4,Matches,2022-2023,Premier-League
Mohammed Salisu,gh GHA,DF,Southampton,23.0,1999.0,21.9,52,29,34,16,2,24,34,70.6,10,56,25,31,30,82,122,1,Matches,2022-2023,Premier-League
Albert Sambi Lokonga,be BEL,MF,Arsenal,22.0,1999.0,2.2,1,1,0,0,1,0,2,0.0,2,1,0,1,5,6,2,0,Matches,2022-2023,Premier-League
Albert Sambi Lokonga,be BEL,MF,Crystal Palace,22.0,1999.0,6.0,13,10,7,4,2,8,12,66.7,4,8,3,5,7,20,10,0,Matches,2022-2023,Premier-League
Davinson Sánchez,co COL,DF,Tottenham,26.0,1996.0,9.5,24,11,17,6,1,14,20,70.0,6,16,10,6,12,36,41,0,Matches,2022-2023,Premier-League
Robert Sánchez,es ESP,GK,Brighton,24.0,1997.0,23.0,1,0,1,0,0,0,0,,0,0,0,0,3,4,9,2,Matches,2022-2023,Premier-League
Jadon Sancho,eng ENG,"FW,MF",Manchester Utd,22.0,2000.0,18.7,16,10,7,5,4,8,28,28.6,20,25,2,23,7,23,6,0,Matches,2022-2023,Premier-League
Morgan Sanson,fr FRA,MF,Aston Villa,27.0,1994.0,0.1,2,1,1,1,0,1,1,100.0,0,0,0,0,0,2,0,0,Matches,2022-2023,Premier-League
Pablo Sarabia,es ESP,"FW,MF",Wolves,30.0,1992.0,8.5,12,6,4,5,3,6,15,40.0,9,7,0,7,2,14,4,0,Matches,2022-2023,Premier-League
Jeremy Sarmiento,ec ECU,MF,Brighton,20.0,2002.0,2.0,6,3,4,1,1,2,5,40.0,3,2,0,2,1,7,0,0,Matches,2022-2023,Premier-League
Gianluca Scamacca,it ITA,FW,West Ham,23.0,1999.0,10.3,10,5,1,3,6,2,2,100.0,0,3,0,3,4,14,5,0,Matches,2022-2023,Premier-League
Gustavo Scarpa,br BRA,"MF,FW",Nott'ham Forest,28.0,1994.0,2.0,5,2,3,1,1,2,5,40.0,3,4,0,4,0,5,3,0,Matches,2022-2023,Premier-League
Kevin Schade,de GER,FW,Brentford,20.0,2001.0,8.1,12,8,7,2,3,5,10,50.0,5,7,0,7,4,16,6,0,Matches,2022-2023,Premier-League
Fabian Schär,ch SUI,DF,Newcastle Utd,30.0,1991.0,35.6,47,22,31,13,3,24,39,61.5,15,34,19,15,52,99,139,0,Matches,2022-2023,Premier-League
Jeffrey Schlupp,gh GHA,"MF,FW",Crystal Palace,29.0,1992.0,28.1,66,46,28,29,9,22,43,51.2,21,39,8,31,23,89,38,0,Matches,2022-2023,Premier-League
Nélson Semedo,pt POR,DF,Wolves,28.0,1993.0,29.2,71,42,48,19,4,33,64,51.6,31,42,15,27,29,100,83,2,Matches,2022-2023,Premier-League
Antoine Semenyo,gh GHA,"FW,MF",Bournemouth,22.0,2000.0,2.9,1,0,0,0,1,1,6,16.7,5,10,1,9,2,3,4,0,Matches,2022-2023,Premier-League
Marcos Senesi,ar ARG,DF,Bournemouth,25.0,1997.0,27.7,50,35,28,22,0,23,44,52.3,21,38,20,18,43,93,146,2,Matches,2022-2023,Premier-League
Ryan Sessegnon,eng ENG,DF,Tottenham,22.0,2000.0,9.0,16,11,9,7,0,6,12,50.0,6,8,1,7,6,22,17,1,Matches,2022-2023,Premier-League
Luke Shaw,eng ENG,DF,Manchester Utd,27.0,1995.0,28.4,55,36,31,22,2,32,46,69.6,14,51,17,34,36,91,55,2,Matches,2022-2023,Premier-League
Jonjo Shelvey,eng ENG,MF,Newcastle Utd,30.0,1992.0,0.4,1,0,1,0,0,0,1,0.0,1,1,0,1,0,1,0,0,Matches,2022-2023,Premier-League
Jonjo Shelvey,eng ENG,MF,Nott'ham Forest,30.0,1992.0,6.0,2,1,0,1,1,1,9,11.1,8,7,2,5,5,7,10,1,Matches,2022-2023,Premier-League
Bernardo Silva,pt POR,"MF,FW",Manchester City,27.0,1994.0,24.5,44,23,11,25,8,18,45,40.0,27,23,6,17,16,60,6,0,Matches,2022-2023,Premier-League
Thiago Silva,br BRA,DF,Chelsea,37.0,1984.0,26.1,41,27,24,17,0,21,31,67.7,10,38,29,9,34,75,111,3,Matches,2022-2023,Premier-League
Ellis Simms,eng ENG,FW,Everton,21.0,2001.0,2.5,0,0,0,0,0,0,0,,0,0,0,0,0,0,1,0,Matches,2022-2023,Premier-League
Luis Sinisterra,co COL,FW,Leeds United,23.0,1999.0,9.6,21,14,8,9,4,11,19,57.9,8,11,1,10,8,29,2,0,Matches,2022-2023,Premier-League
Oliver Skipp,eng ENG,MF,Tottenham,21.0,2000.0,16.6,34,17,18,15,1,16,33,48.5,17,17,8,9,17,51,19,1,Matches,2022-2023,Premier-League
Adam Smith,eng ENG,DF,Bournemouth,31.0,1991.0,32.7,49,29,27,19,3,29,60,48.3,31,30,13,17,25,74,81,1,Matches,2022-2023,Premier-League
Emile Smith Rowe,eng ENG,"MF,FW",Arsenal,22.0,2000.0,1.9,1,1,1,0,0,1,3,33.3,2,1,0,1,0,1,2,0,Matches,2022-2023,Premier-League
Cédric Soares,pt POR,DF,Arsenal,30.0,1991.0,0.3,0,0,0,0,0,0,1,0.0,1,1,0,1,0,0,1,0,Matches,2022-2023,Premier-League
Cédric Soares,pt POR,DF,Fulham,30.0,1991.0,2.2,8,5,4,3,1,3,3,100.0,0,3,1,2,1,9,5,0,Matches,2022-2023,Premier-League
Dominic Solanke,eng ENG,"FW,MF",Bournemouth,24.0,1997.0,31.8,15,9,8,3,4,5,22,22.7,17,26,7,19,6,21,46,0,Matches,2022-2023,Premier-League
Manor Solomon,il ISR,FW,Fulham,23.0,1999.0,6.4,20,12,12,6,2,9,16,56.3,7,8,0,8,5,25,3,0,Matches,2022-2023,Premier-League
Tomáš Souček,cz CZE,MF,West Ham,27.0,1995.0,31.3,77,37,41,29,7,28,58,48.3,30,42,17,25,53,130,71,3,Matches,2022-2023,Premier-League
Boubakary Soumaré,fr FRA,MF,Leicester City,23.0,1999.0,18.1,57,34,29,26,2,23,44,52.3,21,15,4,11,33,90,27,1,Matches,2022-2023,Premier-League
Harry Souttar,au AUS,DF,Leicester City,23.0,1998.0,11.0,15,9,10,5,0,7,18,38.9,11,16,12,4,12,27,45,0,Matches,2022-2023,Premier-League
Çağlar Söyüncü,tr TUR,DF,Leicester City,26.0,1996.0,5.9,14,9,10,4,0,7,10,70.0,3,9,8,1,7,21,30,0,Matches,2022-2023,Premier-League
Djed Spence,eng ENG,"FW,DF",Tottenham,21.0,2000.0,0.1,0,0,0,0,0,0,0,,0,0,0,0,0,0,0,0,Matches,2022-2023,Premier-League
Jack Stacey,eng ENG,DF,Bournemouth,26.0,1996.0,3.3,5,4,3,1,1,2,5,40.0,3,3,1,2,5,10,15,0,Matches,2022-2023,Premier-League
Junior Stanislas,eng ENG,MF,Bournemouth,32.0,1989.0,0.7,0,0,0,0,0,0,0,,0,2,1,1,0,0,0,0,Matches,2022-2023,Premier-League
Jay Stansfield,eng ENG,FW,Fulham,19.0,2002.0,1.0,0,0,0,0,0,0,2,0.0,2,4,1,3,1,1,1,0,Matches,2022-2023,Premier-League
Jason Steele,eng ENG,GK,Brighton,31.0,1990.0,15.0,0,0,0,0,0,0,1,0.0,1,0,0,0,0,0,6,1,Matches,2022-2023,Premier-League
Jack Stephens,eng ENG,DF,Southampton,28.0,1994.0,0.5,2,2,2,0,0,1,1,100.0,0,1,1,0,1,3,2,0,Matches,2022-2023,Premier-League
Jack Stephens,eng ENG,DF,Bournemouth,28.0,1994.0,13.0,15,11,10,4,1,6,10,60.0,4,23,16,7,16,31,53,0,Matches,2022-2023,Premier-League
Raheem Sterling,eng ENG,"FW,MF",Chelsea,27.0,1994.0,21.0,18,10,5,4,9,8,14,57.1,6,17,0,17,2,20,5,0,Matches,2022-2023,Premier-League
John Stones,eng ENG,"DF,MF",Manchester City,28.0,1994.0,20.5,23,13,11,8,4,7,10,70.0,3,17,10,7,9,32,40,0,Matches,2022-2023,Premier-League
Pascal Struijk,nl NED,DF,Leeds United,22.0,1999.0,24.4,84,57,43,31,10,49,77,63.6,28,32,12,20,32,116,70,1,Matches,2022-2023,Premier-League
Kamaldeen Sulemana,gh GHA,"FW,MF",Southampton,20.0,2002.0,10.7,15,9,4,7,4,4,14,28.6,10,16,0,16,6,21,6,0,Matches,2022-2023,Premier-League
Crysencio Summerville,nl NED,FW,Leeds United,20.0,2001.0,15.8,30,20,14,14,2,11,23,47.8,12,20,2,18,13,43,11,0,Matches,2022-2023,Premier-League
Sam Surridge,eng ENG,FW,Nott'ham Forest,24.0,1998.0,3.6,5,0,1,3,1,1,4,25.0,3,5,2,3,0,5,7,0,Matches,2022-2023,Premier-League
Japhet Tanganga,eng ENG,DF,Tottenham,23.0,1999.0,1.6,3,2,3,0,0,1,5,20.0,4,1,0,1,2,5,8,0,Matches,2022-2023,Premier-League
Matt Targett,eng ENG,DF,Newcastle Utd,26.0,1995.0,6.8,13,10,8,3,2,9,24,37.5,15,8,3,5,9,22,16,0,Matches,2022-2023,Premier-League
James Tarkowski,eng ENG,DF,Everton,29.0,1992.0,38.0,51,26,36,13,2,20,39,51.3,19,99,78,21,51,102,201,3,Matches,2022-2023,Premier-League
Marcus Tavernier,eng ENG,"MF,FW",Bournemouth,23.0,1999.0,19.4,33,22,19,11,3,11,33,33.3,22,25,4,21,9,42,23,0,Matches,2022-2023,Premier-League
Tetê,br BRA,FW,Leicester City,22.0,2000.0,8.2,14,8,5,7,2,6,21,28.6,15,9,0,9,2,16,3,0,Matches,2022-2023,Premier-League
Kenny Tete,nl NED,DF,Fulham,26.0,1995.0,28.5,83,46,41,29,13,38,51,74.5,13,48,17,31,52,135,81,1,Matches,2022-2023,Premier-League
Luke Thomas,eng ENG,DF,Leicester City,21.0,2001.0,11.9,23,19,15,5,3,15,32,46.9,17,20,4,16,27,50,35,0,Matches,2022-2023,Premier-League
Youri Tielemans,be BEL,MF,Leicester City,25.0,1997.0,26.0,66,39,27,30,9,23,62,37.1,39,35,8,27,28,94,24,1,Matches,2022-2023,Premier-League
Kieran Tierney,sct SCO,DF,Arsenal,25.0,1997.0,8.8,20,11,9,9,2,12,16,75.0,4,8,2,6,11,31,25,0,Matches,2022-2023,Premier-League
Harry Toffolo,eng ENG,DF,Nott'ham Forest,26.0,1995.0,10.4,17,8,10,4,3,10,14,71.4,4,16,8,8,10,27,33,0,Matches,2022-2023,Premier-League
Takehiro Tomiyasu,jp JPN,DF,Arsenal,23.0,1998.0,7.4,27,18,12,10,5,13,18,72.2,5,7,0,7,14,41,15,1,Matches,2022-2023,Premier-League
James Tomkins,eng ENG,DF,Crystal Palace,33.0,1989.0,3.8,4,2,2,1,1,1,3,33.3,2,3,2,1,5,9,19,0,Matches,2022-2023,Premier-League
Ivan Toney,eng ENG,FW,Brentford,26.0,1996.0,32.8,23,13,4,9,10,7,23,30.4,16,24,9,15,14,37,36,0,Matches,2022-2023,Premier-League
Adama Traoré,es ESP,"FW,MF",Wolves,26.0,1996.0,16.6,14,7,7,4,3,4,9,44.4,5,8,1,7,3,17,17,0,Matches,2022-2023,Premier-League
Bertrand Traoré,bf BFA,"FW,MF",Aston Villa,26.0,1995.0,2.6,1,1,1,0,0,1,4,25.0,3,5,0,5,2,3,0,0,Matches,2022-2023,Premier-League
Boubacar Traoré,ml MLI,MF,Wolves,20.0,2001.0,4.6,12,5,4,5,3,3,7,42.9,4,4,2,2,7,19,1,0,Matches,2022-2023,Premier-League
Mark Travers,ie IRL,GK,Bournemouth,23.0,1999.0,11.5,0,0,0,0,0,0,0,,0,1,0,1,0,0,6,0,Matches,2022-2023,Premier-League
Kieran Trippier,eng ENG,DF,Newcastle Utd,31.0,1990.0,37.1,71,49,36,27,8,46,90,51.1,44,45,15,30,43,114,84,2,Matches,2022-2023,Premier-League
Leandro Trossard,be BEL,FW,Arsenal,27.0,1994.0,10.3,12,7,4,2,6,6,18,33.3,12,18,0,18,6,18,3,1,Matches,2022-2023,Premier-League
Leandro Trossard,be BEL,"FW,MF",Brighton,27.0,1994.0,14.6,10,6,7,1,2,1,8,12.5,7,17,0,17,6,16,1,0,Matches,2022-2023,Premier-League
Kostas Tsimikas,gr GRE,DF,Liverpool,26.0,1996.0,8.6,14,9,10,2,2,10,16,62.5,6,8,1,7,12,26,15,0,Matches,2022-2023,Premier-League
Deniz Undav,de GER,"FW,MF",Brighton,26.0,1996.0,7.0,7,4,2,2,3,2,8,25.0,6,4,1,3,0,7,1,0,Matches,2022-2023,Premier-League
Yan Valery,tn TUN,DF,Southampton,23.0,1999.0,0.5,0,0,0,0,0,0,0,,0,1,0,1,0,0,3,0,Matches,2022-2023,Premier-League
Virgil van Dijk,nl NED,DF,Liverpool,31.0,1991.0,31.5,27,14,13,11,3,8,19,42.1,11,24,16,8,31,58,138,3,Matches,2022-2023,Premier-League
Raphaël Varane,fr FRA,DF,Manchester Utd,29.0,1993.0,21.2,24,9,18,6,0,7,17,41.2,10,24,17,7,11,35,91,0,Matches,2022-2023,Premier-League
Jamie Vardy,eng ENG,FW,Leicester City,35.0,1987.0,20.6,9,5,4,2,3,1,8,12.5,7,17,3,14,2,11,30,0,Matches,2022-2023,Premier-League
Joël Veltman,nl NED,DF,Brighton,30.0,1992.0,24.3,62,32,44,14,4,37,57,64.9,20,27,8,19,19,81,51,0,Matches,2022-2023,Premier-League
Fabio Vieira,pt POR,"MF,FW",Arsenal,22.0,2000.0,5.7,6,4,3,0,3,3,5,60.0,2,5,0,5,4,10,2,0,Matches,2022-2023,Premier-League
Matías Viña,uy URU,DF,Bournemouth,24.0,1997.0,5.1,19,11,9,8,2,14,30,46.7,16,13,1,12,4,23,22,0,Matches,2022-2023,Premier-League
Rúben Vinagre,pt POR,"DF,MF",Everton,23.0,1999.0,0.3,2,2,1,1,0,1,2,50.0,1,0,0,0,0,2,1,0,Matches,2022-2023,Premier-League
Carlos Vinícius,br BRA,FW,Fulham,27.0,1995.0,12.3,4,1,0,2,2,0,4,0.0,4,7,0,7,0,4,10,0,Matches,2022-2023,Premier-League
Theo Walcott,eng ENG,"FW,MF",Southampton,33.0,1989.0,12.5,13,6,8,4,1,8,27,29.6,19,8,1,7,9,22,7,0,Matches,2022-2023,Premier-League
Kyle Walker,eng ENG,DF,Manchester City,32.0,1990.0,21.8,13,9,8,5,0,4,24,16.7,20,12,2,10,18,31,22,0,Matches,2022-2023,Premier-League
Kyle Walker-Peters,eng ENG,DF,Southampton,25.0,1997.0,29.4,61,32,34,24,3,22,43,51.2,21,47,8,39,27,88,52,0,Matches,2022-2023,Premier-League
Aaron Wan-Bissaka,eng ENG,DF,Manchester Utd,24.0,1997.0,15.9,40,25,20,17,3,23,25,92.0,2,24,8,16,22,62,41,0,Matches,2022-2023,Premier-League
Danny Ward,wls WAL,GK,Leicester City,29.0,1993.0,26.0,1,1,1,0,0,1,3,33.3,2,0,0,0,0,1,14,2,Matches,2022-2023,Premier-League
Joel Ward,eng ENG,DF,Crystal Palace,32.0,1989.0,25.1,50,36,30,11,9,30,41,73.2,11,32,16,16,25,75,80,1,Matches,2022-2023,Premier-League
James Ward-Prowse,eng ENG,MF,Southampton,27.0,1994.0,37.5,65,37,31,27,7,21,61,34.4,40,30,10,20,55,120,48,0,Matches,2022-2023,Premier-League
Ollie Watkins,eng ENG,FW,Aston Villa,26.0,1995.0,34.7,19,13,3,13,3,10,27,37.0,17,21,4,17,10,29,39,0,Matches,2022-2023,Premier-League
Adam Webster,eng ENG,DF,Brighton,27.0,1995.0,22.1,22,12,10,9,3,11,19,57.9,8,30,19,11,19,41,55,4,Matches,2022-2023,Premier-League
Wout Weghorst,nl NED,"FW,MF",Manchester Utd,29.0,1992.0,8.9,11,5,6,1,4,2,9,22.2,7,7,2,5,7,18,9,0,Matches,2022-2023,Premier-League
Danny Welbeck,eng ENG,FW,Brighton,31.0,1990.0,20.6,15,7,0,7,8,4,11,36.4,7,24,2,22,5,20,20,0,Matches,2022-2023,Premier-League
Ben White,eng ENG,DF,Arsenal,24.0,1997.0,33.9,60,31,23,30,7,42,70,60.0,28,47,11,36,22,82,79,1,Matches,2022-2023,Premier-League
Harvey White,eng ENG,MF,Tottenham,20.0,2001.0,0.1,0,0,0,0,0,0,1,0.0,1,0,0,0,0,0,0,0,Matches,2022-2023,Premier-League
Joseph Whitworth,eng ENG,GK,Crystal Palace,18.0,2004.0,2.0,0,0,0,0,0,0,0,,0,0,0,0,0,0,1,0,Matches,2022-2023,Premier-League
Neco Williams,wls WAL,DF,Nott'ham Forest,21.0,2001.0,20.9,72,47,49,17,6,38,71,53.5,33,33,8,25,33,105,48,0,Matches,2022-2023,Premier-League
Willian,br BRA,FW,Fulham,33.0,1988.0,23.6,13,8,8,3,2,7,25,28.0,18,13,0,13,9,22,9,0,Matches,2022-2023,Premier-League
Joe Willock,eng ENG,MF,Newcastle Utd,22.0,1999.0,28.4,51,30,13,26,12,25,58,43.1,33,54,8,46,25,76,17,0,Matches,2022-2023,Premier-League
Callum Wilson,eng ENG,FW,Newcastle Utd,30.0,1992.0,20.9,9,3,0,8,1,0,3,0.0,3,8,0,8,1,10,5,0,Matches,2022-2023,Premier-League
Harry Wilson,wls WAL,FW,Fulham,25.0,1997.0,12.2,21,13,9,9,3,8,18,44.4,10,17,2,15,6,27,14,0,Matches,2022-2023,Premier-League
Yoane Wissa,cd COD,FW,Brentford,25.0,1996.0,17.8,17,12,4,7,6,6,13,46.2,7,10,0,10,6,23,15,0,Matches,2022-2023,Premier-League
Maximilian Wöber,at AUT,DF,Leeds United,24.0,1998.0,14.1,25,18,9,15,1,16,24,66.7,8,32,14,18,27,52,67,1,Matches,2022-2023,Premier-League
Chris Wood,nz NZL,FW,Newcastle Utd,30.0,1991.0,5.0,5,4,0,3,2,3,5,60.0,2,2,2,0,1,6,7,0,Matches,2022-2023,Premier-League
Chris Wood,nz NZL,FW,Nott'ham Forest,30.0,1991.0,4.1,0,0,0,0,0,0,1,0.0,1,2,1,1,1,1,2,0,Matches,2022-2023,Premier-League
Joe Worrall,eng ENG,DF,Nott'ham Forest,25.0,1997.0,24.7,53,25,39,12,2,25,35,71.4,10,33,23,10,26,79,111,1,Matches,2022-2023,Premier-League
Granit Xhaka,ch SUI,MF,Arsenal,29.0,1992.0,33.3,34,27,11,18,5,16,41,39.0,25,28,10,18,15,49,45,1,Matches,2022-2023,Premier-League
Ryan Yates,eng ENG,MF,Nott'ham Forest,24.0,1997.0,20.4,38,19,19,16,3,14,22,63.6,8,26,8,18,10,48,44,0,Matches,2022-2023,Premier-League
Ashley Young,eng ENG,DF,Aston Villa,37.0,1985.0,22.6,50,27,34,15,1,37,50,74.0,13,25,11,14,21,71,65,0,Matches,2022-2023,Premier-League
Illia Zabarnyi,ua UKR,DF,Bournemouth,19.0,2002.0,3.3,4,2,4,0,0,3,7,42.9,4,7,2,5,3,7,14,0,Matches,2022-2023,Premier-League
Wilfried Zaha,ci CIV,"FW,MF",Crystal Palace,29.0,1992.0,25.4,32,20,12,12,8,8,21,38.1,13,21,1,20,16,48,9,0,Matches,2022-2023,Premier-League
Denis Zakaria,ch SUI,MF,Chelsea,25.0,1996.0,4.6,9,5,5,2,2,2,8,25.0,6,4,1,3,3,12,10,0,Matches,2022-2023,Premier-League
Jordan Zemura,zw ZIM,DF,Bournemouth,22.0,1999.0,16.2,39,24,24,14,1,23,44,52.3,21,31,9,22,16,55,32,0,Matches,2022-2023,Premier-League
Oleksandr Zinchenko,ua UKR,DF,Arsenal,25.0,1996.0,23.5,40,18,14,17,9,21,40,52.5,19,20,2,18,22,62,38,2,Matches,2022-2023,Premier-League
Hakim Ziyech,ma MAR,"FW,MF",Chelsea,29.0,1993.0,7.3,20,12,12,5,3,4,9,44.4,5,8,0,8,5,25,5,1,Matches,2022-2023,Premier-League
Kurt Zouma,fr FRA,DF,West Ham,27.0,1994.0,22.1,9,4,4,5,0,5,8,62.5,3,17,14,3,30,39,120,1,Matches,2022-2023,Premier-League
Martin Ødegaard,no NOR,MF,Arsenal,23.0,1998.0,34.7,36,23,12,14,10,14,47,29.8,33,20,5,15,6,42,12,1,Matches,2022-2023,Premier-League
Max Aarons,eng ENG,DF,Bournemouth,23.0,2000.0,13.7,29,19,20,7,2,20,34,58.8,14,9,5,4,8,37,27,0,Matches,2023-2024,Premier-League
Joshua Acheampong,eng ENG,DF,Chelsea,17.0,2006.0,0.1,0,0,0,0,0,0,0,,0,3,3,0,0,0,0,0,Matches,2023-2024,Premier-League
Tyler Adams,us USA,MF,Bournemouth,24.0,1999.0,1.3,4,3,1,3,0,2,3,66.7,1,2,0,2,4,8,2,0,Matches,2023-2024,Premier-League
Tosin Adarabioyo,eng ENG,DF,Fulham,25.0,1997.0,18.0,21,11,16,5,0,12,21,57.1,9,16,11,5,25,46,80,0,Matches,2023-2024,Premier-League
Elijah Adebayo,eng ENG,FW,Luton Town,25.0,1998.0,15.8,4,1,1,0,3,1,12,8.3,11,13,2,11,6,10,25,0,Matches,2023-2024,Premier-League
Simon Adingra,ci CIV,FW,Brighton,21.0,2002.0,24.7,45,20,23,11,11,19,42,45.2,23,31,1,30,19,64,22,0,Matches,2023-2024,Premier-League
Nayef Aguerd,ma MAR,DF,West Ham,27.0,1996.0,20.6,26,14,19,7,0,16,22,72.7,6,33,24,9,17,43,85,2,Matches,2023-2024,Premier-League
Brandon Aguilera,cr CRC,FW,Nott'ham Forest,20.0,2003.0,0.1,0,0,0,0,0,0,0,,0,0,0,0,0,0,0,0,Matches,2023-2024,Premier-League
Naouirou Ahamada,fr FRA,"MF,FW",Crystal Palace,21.0,2002.0,3.9,13,9,5,6,2,8,17,47.1,9,3,0,3,2,15,4,0,Matches,2023-2024,Premier-League
Anel Ahmedhodžić,ba BIH,DF,Sheffield Utd,24.0,1999.0,29.4,64,36,48,14,2,30,49,61.2,19,43,26,17,34,98,137,2,Matches,2023-2024,Premier-League
Ola Aina,ng NGA,DF,Nott'ham Forest,26.0,1996.0,18.8,47,31,31,12,4,29,40,72.5,11,19,3,16,18,65,51,1,Matches,2023-2024,Premier-League
Rayan Aït-Nouri,dz ALG,"DF,MF",Wolves,22.0,2001.0,25.9,71,44,41,23,7,28,49,57.1,21,32,6,26,15,86,38,0,Matches,2023-2024,Premier-League
Kristoffer Ajer,no NOR,DF,Brentford,25.0,1998.0,20.4,38,21,25,9,4,23,36,63.9,13,26,11,15,25,63,79,1,Matches,2023-2024,Premier-League
Manuel Akanji,ch SUI,"DF,MF",Manchester City,28.0,1995.0,27.9,42,28,16,18,8,22,39,56.4,17,28,12,16,23,65,70,3,Matches,2023-2024,Premier-League
Nathan Aké,nl NED,DF,Manchester City,28.0,1995.0,22.7,26,16,15,8,3,13,20,65.0,7,17,2,15,14,40,54,0,Matches,2023-2024,Premier-League
Thiago Alcántara,es ESP,MF,Liverpool,32.0,1991.0,0.1,0,0,0,0,0,0,0,,0,0,0,0,0,0,0,0,Matches,2023-2024,Premier-League
Trent Alexander-Arnold,eng ENG,DF,Liverpool,24.0,1998.0,23.9,39,26,26,11,2,27,87,31.0,60,22,2,20,31,70,48,5,Matches,2023-2024,Premier-League
Alisson,br BRA,GK,Liverpool,30.0,1992.0,28.0,0,0,0,0,0,0,1,0.0,1,0,0,0,0,0,11,4,Matches,2023-2024,Premier-League
Miguel Almirón,py PAR,FW,Newcastle Utd,29.0,1994.0,21.5,36,24,13,15,8,11,29,37.9,18,29,2,27,10,46,13,0,Matches,2023-2024,Premier-League
Edson Álvarez,mx MEX,MF,West Ham,25.0,1997.0,26.4,80,39,47,26,7,31,66,47.0,35,59,20,39,42,122,81,0,Matches,2023-2024,Premier-League
Julián Álvarez,ar ARG,"MF,FW",Manchester City,23.0,2000.0,29.4,24,13,5,8,11,8,32,25.0,24,30,0,30,2,26,14,1,Matches,2023-2024,Premier-League
Zeki Amdouni,ch SUI,FW,Burnley,22.0,2000.0,21.7,27,18,1,15,11,7,25,28.0,18,23,10,13,9,36,10,0,Matches,2023-2024,Premier-League
Sofyan Amrabat,ma MAR,"MF,DF",Manchester Utd,26.0,1996.0,10.4,27,16,17,8,2,17,31,54.8,14,20,7,13,8,35,19,2,Matches,2023-2024,Premier-League
Joachim Andersen,dk DEN,DF,Crystal Palace,27.0,1996.0,37.9,56,35,33,21,2,29,39,74.4,10,33,18,15,41,97,207,1,Matches,2023-2024,Premier-League
Elliot Anderson,eng ENG,"MF,FW",Newcastle Utd,20.0,2002.0,11.4,24,18,12,9,3,15,29,51.7,14,23,4,19,8,32,23,0,Matches,2023-2024,Premier-League
Jaidon Anthony,eng ENG,FW,Bournemouth,23.0,1999.0,1.7,3,1,1,0,2,1,7,14.3,6,3,0,3,1,4,3,0,Matches,2023-2024,Premier-League
Michail Antonio,jm JAM,FW,West Ham,33.0,1990.0,18.8,15,8,5,6,4,3,11,27.3,8,16,3,13,4,19,4,0,Matches,2023-2024,Premier-League
Antony,br BRA,FW,Manchester Utd,23.0,2000.0,14.7,40,21,15,19,6,20,40,50.0,20,29,1,28,12,52,9,0,Matches,2023-2024,Premier-League
Oliver Arblaster,eng ENG,MF,Sheffield Utd,19.0,2004.0,10.5,23,14,11,8,4,7,15,46.7,8,17,7,10,16,39,9,0,Matches,2023-2024,Premier-League
Cameron Archer,eng ENG,"FW,MF",Sheffield Utd,22.0,2001.0,20.4,18,13,6,6,6,8,18,44.4,10,22,3,19,1,19,11,0,Matches,2023-2024,Premier-League
Cameron Archer,eng ENG,MF,Aston Villa,22.0,2001.0,0.1,0,0,0,0,0,0,0,,0,0,0,0,0,0,0,0,Matches,2023-2024,Premier-League
Alphonse Areola,fr FRA,GK,West Ham,30.0,1993.0,30.0,1,1,1,0,0,1,3,33.3,2,0,0,0,1,2,16,0,Matches,2023-2024,Premier-League
Lorenz Assignon,tg TOG,DF,Burnley,23.0,2000.0,13.7,35,17,18,13,4,14,27,51.9,13,22,7,15,19,54,43,1,Matches,2023-2024,Premier-League
Serge Aurier,ci CIV,"DF,MF",Nott'ham Forest,30.0,1992.0,9.3,20,14,9,11,0,5,11,45.5,6,10,3,7,9,29,36,1,Matches,2023-2024,Premier-League
Taiwo Awoniyi,ng NGA,FW,Nott'ham Forest,25.0,1997.0,11.6,9,7,1,4,4,1,2,50.0,1,7,2,5,1,10,9,0,Matches,2023-2024,Premier-League
Jordan Ayew,gh GHA,"FW,MF",Crystal Palace,31.0,1991.0,28.3,65,36,23,28,14,21,42,50.0,21,43,2,41,16,81,15,0,Matches,2023-2024,Premier-League
Benoît Badiashile,fr FRA,DF,Chelsea,22.0,2001.0,14.9,21,15,12,9,0,9,14,64.3,5,21,14,7,18,39,66,2,Matches,2023-2024,Premier-League
Leon Bailey,jm JAM,"MF,FW",Aston Villa,25.0,1997.0,23.0,13,7,7,4,2,5,20,25.0,15,18,1,17,9,22,6,0,Matches,2023-2024,Premier-League
Stefan Bajcetic,es ESP,MF,Liverpool,18.0,2004.0,0.3,4,1,3,1,0,3,5,60.0,2,0,0,0,0,4,0,0,Matches,2023-2024,Premier-League
George Baldock,gr GRE,DF,Sheffield Utd,30.0,1993.0,10.8,18,10,10,7,1,6,15,40.0,9,14,8,6,10,28,33,0,Matches,2023-2024,Premier-League
Carlos Baleba,cm CMR,MF,Brighton,19.0,2004.0,14.7,40,20,17,19,4,23,46,50.0,23,35,7,28,18,58,30,3,Matches,2023-2024,Premier-League
Fodé Ballo-Touré,sn SEN,"DF,MF",Fulham,26.0,1997.0,0.8,4,2,1,3,0,1,2,50.0,1,1,0,1,3,7,2,0,Matches,2023-2024,Premier-League
Shandon Baptiste,gd GRN,MF,Brentford,25.0,1998.0,2.5,4,4,2,2,0,1,5,20.0,4,5,1,4,3,7,6,0,Matches,2023-2024,Premier-League
Valentín Barco,ar ARG,"DF,FW",Brighton,19.0,2004.0,3.4,11,5,4,5,2,6,8,75.0,2,3,0,3,4,15,3,1,Matches,2023-2024,Premier-League
Ross Barkley,eng ENG,MF,Luton Town,29.0,1993.0,29.1,47,19,16,21,10,11,48,22.9,37,25,9,16,25,72,51,2,Matches,2023-2024,Premier-League
Harvey Barnes,eng ENG,"FW,MF",Newcastle Utd,25.0,1997.0,8.9,6,1,3,2,1,1,2,50.0,1,1,0,1,5,11,3,0,Matches,2023-2024,Premier-League
Chris Basham,eng ENG,"DF,MF",Sheffield Utd,35.0,1988.0,3.6,7,2,4,3,0,2,9,22.2,7,9,4,5,5,12,17,0,Matches,2023-2024,Premier-League
Calvin Bassey,ng NGA,DF,Fulham,23.0,1999.0,25.6,49,29,33,15,1,21,29,72.4,8,32,11,21,28,77,84,4,Matches,2023-2024,Premier-League
Owen Beck,wls WAL,DF,Liverpool,20.0,2002.0,0.1,2,1,1,1,0,0,0,,0,0,0,0,0,2,1,0,Matches,2023-2024,Premier-League
Donny van de Beek,nl NED,DF,Manchester Utd,26.0,1997.0,0.0,0,0,0,0,0,0,0,,0,1,0,1,0,0,0,0,Matches,2023-2024,Premier-League
Amari'i Bell,jm JAM,DF,Luton Town,29.0,1994.0,19.1,50,33,30,19,1,22,35,62.9,13,33,15,18,25,75,60,1,Matches,2023-2024,Premier-League
Jean-Ricner Bellegarde,fr FRA,"MF,FW",Wolves,25.0,1998.0,10.6,17,10,9,6,2,7,15,46.7,8,18,2,16,8,25,14,0,Matches,2023-2024,Premier-League
Anis Ben Slimane,tn TUN,MF,Sheffield Utd,22.0,2001.0,4.7,11,6,5,2,4,4,10,40.0,6,7,1,6,5,16,7,0,Matches,2023-2024,Premier-League
Saïd Benrahma,dz ALG,"FW,MF",West Ham,27.0,1995.0,6.9,8,4,5,3,0,4,15,26.7,11,8,0,8,5,13,7,0,Matches,2023-2024,Premier-League
Rodrigo Bentancur,uy URU,MF,Tottenham,26.0,1997.0,11.2,23,15,10,11,2,10,24,41.7,14,15,4,11,17,40,16,1,Matches,2023-2024,Premier-League
Daniel Bentley,eng ENG,GK,Wolves,30.0,1993.0,4.3,0,0,0,0,0,0,1,0.0,1,0,0,0,0,0,1,0,Matches,2023-2024,Premier-League
Jóhann Berg Guðmundsson,is ISL,"MF,FW",Burnley,32.0,1990.0,13.2,13,4,6,5,2,7,16,43.8,9,14,0,14,16,29,16,0,Matches,2023-2024,Premier-League
Sander Berge,no NOR,MF,Burnley,25.0,1998.0,33.4,76,46,35,36,5,34,58,58.6,24,49,20,29,23,99,60,2,Matches,2023-2024,Premier-League
Luke Berry,eng ENG,"MF,DF",Luton Town,31.0,1992.0,3.6,7,2,2,4,1,2,3,66.7,1,6,1,5,0,7,3,0,Matches,2023-2024,Premier-League
Beto,gw GNB,FW,Everton,25.0,1998.0,10.6,14,6,1,6,7,4,12,33.3,8,11,0,11,1,15,14,0,Matches,2023-2024,Premier-League
Jordan Beyer,de GER,DF,Burnley,23.0,2000.0,13.7,35,20,22,12,1,14,24,58.3,10,22,15,7,16,51,68,1,Matches,2023-2024,Premier-League
Philip Billing,dk DEN,MF,Bournemouth,27.0,1996.0,15.5,33,16,7,22,4,9,27,33.3,18,31,5,26,20,53,28,1,Matches,2023-2024,Premier-League
Yves Bissouma,ml MLI,MF,Tottenham,26.0,1996.0,23.0,80,52,32,36,12,41,61,67.2,20,28,5,23,37,117,43,3,Matches,2023-2024,Premier-League
Benicio Boaitey,eng ENG,"FW,DF",Brighton,19.0,2004.0,0.4,0,0,0,0,0,0,1,0.0,1,1,0,1,0,0,2,0,Matches,2023-2024,Premier-League
Oscar Bobb,no NOR,"FW,MF",Manchester City,20.0,2003.0,3.4,7,3,1,2,4,2,4,50.0,2,4,0,4,5,12,1,0,Matches,2023-2024,Premier-League
Jayden Bogle,eng ENG,DF,Sheffield Utd,23.0,2000.0,31.0,66,36,43,21,2,35,70,50.0,35,42,11,31,32,98,97,0,Matches,2023-2024,Premier-League
Willy Boly,ci CIV,DF,Nott'ham Forest,32.0,1991.0,16.0,46,29,36,9,1,22,40,55.0,18,32,21,11,25,71,90,0,Matches,2023-2024,Premier-League
Sven Botman,nl NED,DF,Newcastle Utd,23.0,2000.0,15.3,20,13,14,6,0,8,13,61.5,5,20,16,4,9,29,61,3,Matches,2023-2024,Premier-League
Jarrod Bowen,eng ENG,FW,West Ham,26.0,1996.0,33.5,42,28,14,14,14,13,35,37.1,22,37,5,32,19,61,14,0,Matches,2023-2024,Premier-League
Conor Bradley,nir NIR,DF,Liverpool,20.0,2003.0,8.4,33,25,14,12,7,24,38,63.2,14,17,1,16,10,43,14,0,Matches,2023-2024,Premier-League
Jarrad Branthwaite,eng ENG,DF,Everton,21.0,2002.0,34.6,66,32,42,22,2,45,62,72.6,17,51,36,15,50,116,163,2,Matches,2023-2024,Premier-League
Ben Brereton,cl CHI,"FW,MF",Sheffield Utd,24.0,1999.0,12.3,9,4,4,4,1,4,10,40.0,6,9,3,6,3,12,12,0,Matches,2023-2024,Premier-League
Rhian Brewster,eng ENG,"FW,MF",Sheffield Utd,23.0,2000.0,3.8,5,1,1,2,2,0,2,0.0,2,2,0,2,1,6,2,0,Matches,2023-2024,Premier-League
Armando Broja,al ALB,FW,Chelsea,21.0,2001.0,5.0,3,0,0,1,2,1,2,50.0,1,5,1,4,0,3,3,0,Matches,2023-2024,Premier-League
Armando Broja,al ALB,FW,Fulham,21.0,2001.0,1.0,0,0,0,0,0,0,0,,0,1,0,1,0,0,0,0,Matches,2023-2024,Premier-League
Andre Brooks,eng ENG,"MF,DF",Sheffield Utd,19.0,2003.0,10.4,22,13,7,11,4,9,21,42.9,12,13,1,12,14,36,20,0,Matches,2023-2024,Premier-League
David Brooks,wls WAL,"FW,MF",Bournemouth,26.0,1997.0,3.1,5,4,2,1,2,2,4,50.0,2,3,0,3,2,7,2,0,Matches,2023-2024,Premier-League
Jacob Brown,sct SCO,"MF,FW",Luton Town,25.0,1998.0,11.3,19,12,7,7,5,7,18,38.9,11,20,1,19,8,27,22,0,Matches,2023-2024,Premier-League
Josh Brownhill,eng ENG,MF,Burnley,27.0,1995.0,25.0,61,35,23,28,10,27,37,73.0,10,33,8,25,34,95,40,1,Matches,2023-2024,Premier-League
Jacob Bruun Larsen,dk DEN,"MF,FW",Burnley,24.0,1998.0,13.9,9,4,4,3,2,7,21,33.3,14,16,2,14,7,16,23,0,Matches,2023-2024,Premier-League
Hugo Bueno,es ESP,"DF,MF",Wolves,20.0,2002.0,8.2,21,14,12,7,2,12,19,63.2,7,17,4,13,6,27,24,0,Matches,2023-2024,Premier-League
Santiago Bueno,uy URU,DF,Wolves,24.0,1998.0,9.1,13,7,5,7,1,5,11,45.5,6,22,12,10,6,19,33,0,Matches,2023-2024,Premier-League
Facundo Buonanotte,ar ARG,"FW,MF",Brighton,18.0,2004.0,15.2,42,22,13,22,7,14,44,31.8,30,22,3,19,8,50,5,0,Matches,2023-2024,Premier-League
Reece Burke,eng ENG,DF,Luton Town,26.0,1996.0,18.4,37,23,17,14,6,12,26,46.2,14,25,18,7,18,55,78,1,Matches,2023-2024,Premier-League
Dan Burn,eng ENG,DF,Newcastle Utd,31.0,1992.0,30.3,61,33,37,20,4,26,61,42.6,35,55,25,30,37,98,124,1,Matches,2023-2024,Premier-League
Mason Burstow,eng ENG,FW,Chelsea,19.0,2003.0,0.1,0,0,0,0,0,0,0,,0,0,0,0,0,0,0,0,Matches,2023-2024,Premier-League
Moisés Caicedo,ec ECU,MF,Chelsea,21.0,2001.0,31.8,91,46,38,42,11,36,60,60.0,24,59,25,34,37,128,44,4,Matches,2023-2024,Premier-League
Tom Cairney,sct SCO,MF,Fulham,32.0,1991.0,16.5,24,16,10,12,2,13,25,52.0,12,16,4,12,13,37,6,0,Matches,2023-2024,Premier-League
Dominic Calvert-Lewin,eng ENG,FW,Everton,26.0,1997.0,24.1,13,6,2,6,5,2,15,13.3,13,14,4,10,4,17,38,0,Matches,2023-2024,Premier-League
Thomas Cannon,ie IRL,FW,Everton,20.0,2002.0,0.0,0,0,0,0,0,0,0,,0,0,0,0,0,0,0,0,Matches,2023-2024,Premier-League
Diego Carlos,br BRA,DF,Aston Villa,30.0,1993.0,20.2,27,16,22,4,1,13,21,61.9,8,24,19,5,13,40,78,3,Matches,2023-2024,Premier-League
Cesare Casadei,it ITA,"FW,MF",Chelsea,20.0,2003.0,0.9,5,3,2,1,2,2,5,40.0,3,1,0,1,0,5,4,0,Matches,2023-2024,Premier-League
Casemiro,br BRA,"MF,DF",Manchester Utd,31.0,1992.0,22.0,83,56,43,32,8,51,106,48.1,55,74,33,41,18,101,71,1,Matches,2023-2024,Premier-League
Kaelan Casey,eng ENG,DF,West Ham,18.0,2004.0,0.0,0,0,0,0,0,0,0,,0,0,0,0,0,0,1,0,Matches,2023-2024,Premier-League
Matty Cash,pl POL,DF,Aston Villa,25.0,1997.0,23.8,54,31,24,24,6,29,59,49.2,30,35,14,21,18,72,59,0,Matches,2023-2024,Premier-League
Timothy Castagne,be BEL,DF,Fulham,27.0,1995.0,29.3,49,24,23,16,10,26,44,59.1,18,38,10,28,38,87,69,1,Matches,2023-2024,Premier-League
Jonny Castro,es ESP,MF,Wolves,29.0,1994.0,0.1,0,0,0,0,0,0,1,0.0,1,1,1,0,0,0,0,0,Matches,2023-2024,Premier-League
Trevoh Chalobah,eng ENG,DF,Chelsea,24.0,1999.0,10.6,16,12,10,2,4,10,15,66.7,5,8,7,1,8,24,51,0,Matches,2023-2024,Premier-League
Calum Chambers,eng ENG,"MF,DF",Aston Villa,28.0,1995.0,1.7,3,0,3,0,0,0,1,0.0,1,2,1,1,2,5,4,0,Matches,2023-2024,Premier-League
Youssef Chermiti,pt POR,FW,Everton,19.0,2004.0,2.3,3,2,2,1,0,1,5,20.0,4,4,1,3,1,4,2,0,Matches,2023-2024,Premier-League
Ben Chilwell,eng ENG,DF,Chelsea,26.0,1996.0,8.4,15,10,5,9,1,5,8,62.5,3,11,3,8,4,19,19,1,Matches,2023-2024,Premier-League
Tawanda Chirewa,zw ZIM,"MF,FW",Wolves,19.0,2003.0,1.6,7,3,3,3,1,2,3,66.7,1,0,0,0,1,8,0,0,Matches,2023-2024,Premier-League
Leon Chiwome,eng ENG,FW,Wolves,17.0,2006.0,1.9,2,1,0,1,1,1,2,50.0,1,3,1,2,0,2,2,0,Matches,2023-2024,Premier-League
Tahith Chong,nl NED,"MF,FW",Luton Town,23.0,1999.0,22.0,36,22,19,13,4,15,33,45.5,18,30,6,24,8,44,11,1,Matches,2023-2024,Premier-League
Ryan Christie,sct SCO,MF,Bournemouth,28.0,1995.0,32.3,86,44,34,35,17,39,92,42.4,53,52,11,41,52,138,53,1,Matches,2023-2024,Premier-League
Carney Chukwuemeka,eng ENG,"MF,FW",Chelsea,19.0,2003.0,2.5,6,4,3,3,0,1,3,33.3,2,1,1,0,0,6,1,0,Matches,2023-2024,Premier-League
Bobby Clark,eng ENG,MF,Liverpool,18.0,2005.0,1.0,2,1,1,1,0,1,5,20.0,4,6,2,4,1,3,1,0,Matches,2023-2024,Premier-League
Jordan Clark,eng ENG,MF,Luton Town,29.0,1993.0,14.5,30,17,14,11,5,11,39,28.2,28,24,3,21,11,41,15,1,Matches,2023-2024,Premier-League
Nathaniel Clyne,eng ENG,DF,Crystal Palace,32.0,1991.0,14.9,24,15,11,11,2,14,21,66.7,7,18,6,12,10,34,33,0,Matches,2023-2024,Premier-League
Séamus Coleman,ie IRL,DF,Everton,34.0,1988.0,7.4,17,14,10,3,4,11,16,68.8,5,12,4,8,7,24,26,1,Matches,2023-2024,Premier-League
Nathan Collins,ie IRL,DF,Brentford,22.0,2001.0,29.5,38,20,24,12,2,19,29,65.5,10,46,30,16,44,82,141,4,Matches,2023-2024,Premier-League
Levi Colwill,eng ENG,DF,Chelsea,20.0,2003.0,20.0,48,30,26,17,5,26,34,76.5,8,28,10,18,26,74,66,0,Matches,2023-2024,Premier-League
Lewis Cook,eng ENG,MF,Bournemouth,26.0,1997.0,31.0,61,41,24,30,7,34,63,54.0,29,32,11,21,65,126,46,1,Matches,2023-2024,Premier-League
Jack Cork,eng ENG,MF,Burnley,34.0,1989.0,0.3,2,0,0,2,0,1,3,33.3,2,0,0,0,1,3,1,0,Matches,2023-2024,Premier-League
Maxwel Cornet,ci CIV,"MF,FW",West Ham,26.0,1996.0,1.2,3,2,3,0,0,1,5,20.0,4,2,0,2,2,5,1,0,Matches,2023-2024,Premier-League
Vladimír Coufal,cz CZE,DF,West Ham,30.0,1992.0,34.8,64,41,50,12,2,38,75,50.7,37,49,15,34,43,107,97,0,Matches,2023-2024,Premier-League
Philippe Coutinho,br BRA,"MF,FW",Aston Villa,31.0,1992.0,0.3,0,0,0,0,0,0,1,0.0,1,0,0,0,0,0,0,0,Matches,2023-2024,Premier-League
Aaron Cresswell,eng ENG,"DF,FW",West Ham,33.0,1989.0,4.8,3,2,1,1,1,2,3,66.7,1,5,3,2,3,6,7,0,Matches,2023-2024,Premier-League
Marc Cucurella,es ESP,DF,Chelsea,25.0,1998.0,19.8,62,38,36,21,5,34,64,53.1,30,36,13,23,22,84,48,0,Matches,2023-2024,Premier-League
Josh Cullen,ie IRL,MF,Burnley,27.0,1996.0,22.9,42,29,15,22,5,26,46,56.5,20,31,19,12,15,57,26,1,Matches,2023-2024,Premier-League
Matheus Cunha,br BRA,"FW,MF",Wolves,24.0,1999.0,27.1,30,16,8,17,5,13,35,37.1,22,28,7,21,13,43,21,1,Matches,2023-2024,Premier-League
Sam Curtis,ie IRL,DF,Sheffield Utd,17.0,2005.0,0.3,1,0,1,0,0,1,2,50.0,1,2,0,2,0,1,0,0,Matches,2023-2024,Premier-League
Mahmoud Dahoud,de GER,MF,Brighton,27.0,1996.0,5.0,9,4,2,4,3,3,9,33.3,6,4,1,3,1,10,5,0,Matches,2023-2024,Premier-League
Ameen Al-Dakhil,be BEL,DF,Burnley,21.0,2002.0,11.7,12,5,4,7,1,1,10,10.0,9,13,6,7,12,24,38,2,Matches,2023-2024,Premier-League
Diogo Dalot,pt POR,DF,Manchester Utd,24.0,1999.0,35.3,81,51,58,12,11,51,74,68.9,23,44,16,28,37,118,111,0,Matches,2023-2024,Premier-League
Mikkel Damsgaard,dk DEN,MF,Brentford,23.0,2000.0,9.4,29,17,13,9,7,14,40,35.0,26,23,1,22,11,40,10,1,Matches,2023-2024,Premier-League
Danilo,br BRA,MF,Nott'ham Forest,22.0,2001.0,19.9,36,18,22,12,2,21,46,45.7,25,34,8,26,35,71,42,0,Matches,2023-2024,Premier-League
Arnaut Danjuma,nl NED,"MF,FW",Everton,26.0,1997.0,6.6,6,4,2,3,1,1,4,25.0,3,4,0,4,3,9,0,0,Matches,2023-2024,Premier-League
Jayden Danns,eng ENG,FW,Liverpool,17.0,2006.0,0.1,0,0,0,0,0,0,0,,0,0,0,0,0,0,0,0,Matches,2023-2024,Premier-League
Josh Dasilva,eng ENG,"DF,FW",Brentford,24.0,1998.0,0.3,2,1,0,1,1,0,0,,0,0,0,0,0,2,0,0,Matches,2023-2024,Premier-League
David Datro Fofana,ci CIV,FW,Burnley,20.0,2002.0,9.8,10,5,3,5,2,3,6,50.0,3,9,3,6,1,11,2,0,Matches,2023-2024,Premier-League
Ben Davies,wls WAL,DF,Tottenham,30.0,1993.0,12.1,24,17,13,8,3,16,21,76.2,5,17,15,2,10,34,35,0,Matches,2023-2024,Premier-League
Tom Davies,eng ENG,MF,Sheffield Utd,25.0,1998.0,2.5,10,5,4,3,3,3,9,33.3,6,2,1,1,3,13,6,1,Matches,2023-2024,Premier-League
Craig Dawson,eng ENG,DF,Wolves,33.0,1990.0,24.5,30,20,23,6,1,22,34,64.7,12,51,39,12,16,46,120,1,Matches,2023-2024,Premier-League
Kevin De Bruyne,be BEL,MF,Manchester City,32.0,1991.0,13.6,14,9,1,5,8,7,20,35.0,13,5,0,5,4,18,4,0,Matches,2023-2024,Premier-League
Bobby De Cordova-Reid,jm JAM,FW,Fulham,30.0,1993.0,15.8,22,14,5,15,2,4,16,25.0,12,24,2,22,5,27,14,0,Matches,2023-2024,Premier-League
Hannes Delcroix,be BEL,DF,Burnley,24.0,1999.0,6.5,10,6,6,4,0,3,4,75.0,1,9,3,6,9,19,26,0,Matches,2023-2024,Premier-League
Leander Dendoncker,be BEL,MF,Aston Villa,28.0,1995.0,1.3,6,4,3,2,1,4,5,80.0,1,5,2,3,2,8,3,1,Matches,2023-2024,Premier-League
Moussa Diaby,fr FRA,"FW,MF",Aston Villa,24.0,1999.0,24.2,12,5,5,4,3,4,22,18.2,18,8,1,7,9,21,6,0,Matches,2023-2024,Premier-League
Amad Diallo,ci CIV,"FW,MF",Manchester Utd,21.0,2002.0,4.3,10,3,1,6,3,3,7,42.9,4,3,1,2,1,11,6,0,Matches,2023-2024,Premier-League
Amadou Diallo,eng ENG,MF,Newcastle Utd,20.0,2003.0,0.0,0,0,0,0,0,0,0,,0,0,0,0,0,0,0,0,Matches,2023-2024,Premier-League
Rúben Dias,pt POR,DF,Manchester City,26.0,1997.0,28.4,39,20,14,21,4,19,26,73.1,7,32,17,15,30,69,77,0,Matches,2023-2024,Premier-League
Luis Díaz,co COL,FW,Liverpool,26.0,1997.0,29.2,35,25,5,17,13,7,30,23.3,23,15,0,15,3,38,8,0,Matches,2023-2024,Premier-League
Eric Dier,eng ENG,DF,Tottenham,29.0,1994.0,2.2,2,1,2,0,0,2,2,100.0,0,3,3,0,2,4,12,0,Matches,2023-2024,Premier-League
Lucas Digne,fr FRA,DF,Aston Villa,30.0,1993.0,26.8,47,19,35,9,3,25,44,56.8,19,20,2,18,26,73,67,0,Matches,2023-2024,Premier-League
Issa Diop,fr FRA,DF,Fulham,26.0,1997.0,15.8,30,16,23,5,2,15,20,75.0,5,28,19,9,17,47,80,1,Matches,2023-2024,Premier-League
Axel Disasi,fr FRA,DF,Chelsea,25.0,1998.0,28.7,33,19,20,10,3,23,30,76.7,7,26,19,7,18,51,102,2,Matches,2023-2024,Premier-League
Ben Doak,sct SCO,FW,Liverpool,17.0,2005.0,0.2,0,0,0,0,0,0,0,,0,0,0,0,0,0,0,0,Matches,2023-2024,Premier-League
Lewis Dobbin,eng ENG,MF,Everton,20.0,2003.0,2.6,9,7,3,5,1,5,9,55.6,4,5,1,4,1,10,0,0,Matches,2023-2024,Premier-League
Matt Doherty,ie IRL,"DF,MF",Wolves,31.0,1992.0,12.8,31,18,17,10,4,12,23,52.2,11,15,5,10,7,38,47,0,Matches,2023-2024,Premier-League
Jeremy Doku,be BEL,"FW,MF",Manchester City,21.0,2002.0,17.7,39,22,13,12,14,9,20,45.0,11,14,0,14,9,48,5,0,Matches,2023-2024,Premier-League
Nicolás Domínguez,ar ARG,"MF,FW",Nott'ham Forest,25.0,1998.0,16.6,63,34,35,27,1,23,48,47.9,25,31,5,26,18,81,24,0,Matches,2023-2024,Premier-League
Jamie Donley,nir NIR,FW,Tottenham,18.0,2005.0,0.0,0,0,0,0,0,0,0,,0,0,0,0,0,0,3,0,Matches,2023-2024,Premier-League
Abdoulaye Doucouré,ml MLI,"FW,MF",Everton,30.0,1993.0,29.2,43,27,20,14,9,18,46,39.1,28,23,3,20,15,58,19,0,Matches,2023-2024,Premier-League
Cheick Doucouré,ml MLI,MF,Crystal Palace,23.0,2000.0,10.2,34,17,15,13,6,18,30,60.0,12,13,2,11,20,54,12,0,Matches,2023-2024,Premier-League
Alfie Doughty,eng ENG,DF,Luton Town,23.0,1999.0,32.5,63,40,29,18,16,37,82,45.1,45,51,9,42,31,94,43,4,Matches,2023-2024,Premier-League
Tommy Doyle,eng ENG,MF,Wolves,21.0,2001.0,13.6,26,13,11,10,5,14,23,60.9,9,22,9,13,12,38,18,0,Matches,2023-2024,Premier-League
Radu Drăgușin,ro ROU,DF,Tottenham,21.0,2002.0,4.8,5,3,5,0,0,3,3,100.0,0,5,4,1,8,13,19,0,Matches,2023-2024,Premier-League
Martin Dúbravka,sk SVK,GK,Newcastle Utd,34.0,1989.0,22.1,0,0,0,0,0,0,4,0.0,4,0,0,0,0,0,8,1,Matches,2023-2024,Premier-League
Paul Dummett,wls WAL,DF,Newcastle Utd,31.0,1991.0,0.2,1,0,1,0,0,1,1,100.0,0,0,0,0,0,1,1,0,Matches,2023-2024,Premier-League
Lewis Dunk,eng ENG,DF,Brighton,31.0,1991.0,31.9,27,14,17,9,1,13,36,36.1,23,49,37,12,31,58,90,1,Matches,2023-2024,Premier-League
Jáder Durán,co COL,"FW,MF",Aston Villa,19.0,2003.0,5.3,6,5,3,1,2,1,6,16.7,5,6,0,6,1,7,10,0,Matches,2023-2024,Premier-League
George Earthy,eng ENG,FW,West Ham,18.0,2004.0,0.4,0,0,0,0,0,0,1,0.0,1,0,0,0,1,1,0,0,Matches,2023-2024,Premier-League
Ederson,br BRA,GK,Manchester City,29.0,1993.0,30.9,0,0,0,0,0,0,1,0.0,1,0,0,0,0,0,10,1,Matches,2023-2024,Premier-League
Odsonne Édouard,fr FRA,"FW,MF",Crystal Palace,25.0,1998.0,17.3,24,12,8,8,8,4,19,21.1,15,17,1,16,6,30,19,0,Matches,2023-2024,Premier-League
John Egan,ie IRL,DF,Sheffield Utd,30.0,1992.0,5.4,6,4,4,2,0,4,11,36.4,7,10,4,6,13,19,39,1,Matches,2023-2024,Premier-League
Hjalmar Ekdal,se SWE,DF,Burnley,24.0,1998.0,4.9,4,2,2,2,0,2,4,50.0,2,10,5,5,6,10,21,0,Matches,2023-2024,Premier-League
Anthony Elanga,se SWE,"FW,MF",Nott'ham Forest,21.0,2002.0,27.0,33,19,20,6,7,17,37,45.9,20,22,2,20,8,41,20,1,Matches,2023-2024,Premier-League
Harvey Elliott,eng ENG,"MF,FW",Liverpool,20.0,2003.0,15.0,27,17,8,14,5,10,31,32.3,21,27,0,27,6,33,7,0,Matches,2023-2024,Premier-League
Mohamed Elneny,eg EGY,MF,Arsenal,31.0,1992.0,0.3,0,0,0,0,0,0,1,0.0,1,0,0,0,1,1,0,0,Matches,2023-2024,Premier-League
Emerson,br BRA,DF,Tottenham,24.0,1999.0,12.9,36,24,23,10,3,21,43,48.8,22,23,10,13,20,56,50,1,Matches,2023-2024,Premier-League
Julio Enciso,py PAR,"MF,FW",Brighton,19.0,2004.0,5.3,6,2,3,2,1,2,7,28.6,5,11,0,11,0,6,3,0,Matches,2023-2024,Premier-League
Wataru Endo,jp JPN,MF,Liverpool,30.0,1993.0,19.1,48,28,11,31,6,20,61,32.8,41,24,2,22,20,68,31,3,Matches,2023-2024,Premier-League
Christian Eriksen,dk DEN,MF,Manchester Utd,31.0,1992.0,12.7,18,13,5,10,3,12,33,36.4,21,17,6,11,4,22,13,0,Matches,2023-2024,Premier-League
Maxime Estève,fr FRA,DF,Burnley,21.0,2002.0,14.5,27,10,15,12,0,18,32,56.3,14,21,10,11,27,54,56,0,Matches,2023-2024,Premier-League
Pervis Estupiñán,ec ECU,DF,Brighton,25.0,1998.0,13.8,26,13,12,11,3,14,30,46.7,16,14,4,10,21,47,20,0,Matches,2023-2024,Premier-League
Jonny Evans,nir NIR,DF,Manchester Utd,35.0,1988.0,15.5,22,14,20,2,0,12,21,57.1,9,25,18,7,23,45,76,0,Matches,2023-2024,Premier-League
Eberechi Eze,eng ENG,"MF,FW",Crystal Palace,25.0,1998.0,22.8,35,17,4,18,13,15,31,48.4,16,27,2,25,11,46,6,0,Matches,2023-2024,Premier-League
Łukasz Fabiański,pl POL,GK,West Ham,38.0,1985.0,8.0,1,0,1,0,0,1,2,50.0,1,0,0,0,1,2,4,0,Matches,2023-2024,Premier-League
Romain Faivre,fr FRA,"MF,FW",Bournemouth,25.0,1998.0,0.5,1,1,0,1,0,0,3,0.0,3,0,0,0,0,1,0,0,Matches,2023-2024,Premier-League
Ansu Fati,es ESP,"MF,FW",Brighton,20.0,2002.0,5.8,5,3,1,2,2,1,11,9.1,10,8,0,8,3,8,3,0,Matches,2023-2024,Premier-League
Felipe,br BRA,DF,Nott'ham Forest,34.0,1989.0,4.2,12,9,9,3,0,9,12,75.0,3,4,1,3,4,16,12,0,Matches,2023-2024,Premier-League
Evan Ferguson,ie IRL,FW,Brighton,18.0,2004.0,15.2,14,6,4,7,3,5,14,35.7,9,10,3,7,2,16,8,0,Matches,2023-2024,Premier-League
Bruno Fernandes,pt POR,"MF,FW",Manchester Utd,28.0,1994.0,34.6,68,38,27,25,16,30,88,34.1,58,49,6,43,27,95,50,2,Matches,2023-2024,Premier-League
Enzo Fernández,ar ARG,MF,Chelsea,22.0,2001.0,24.5,50,22,22,18,10,27,65,41.5,38,36,13,23,17,67,28,0,Matches,2023-2024,Premier-League
John Fleck,sct SCO,"MF,DF",Sheffield Utd,31.0,1991.0,1.0,1,0,0,1,0,0,1,0.0,1,0,0,0,0,1,1,0,Matches,2023-2024,Premier-League
Mark Flekken,nl NED,GK,Brentford,30.0,1993.0,36.5,1,1,1,0,0,1,5,20.0,4,1,0,1,0,1,17,1,Matches,2023-2024,Premier-League
Phil Foden,eng ENG,"FW,MF",Manchester City,23.0,2000.0,31.7,31,20,11,10,10,13,31,41.9,18,30,0,30,13,44,18,1,Matches,2023-2024,Premier-League
Wes Foderingham,eng ENG,GK,Sheffield Utd,32.0,1991.0,29.4,5,3,5,0,0,5,6,83.3,1,0,0,0,0,5,18,6,Matches,2023-2024,Premier-League
Pablo Fornals,es ESP,"MF,FW",West Ham,27.0,1996.0,4.7,10,6,4,3,3,5,16,31.3,11,8,1,7,6,16,7,0,Matches,2023-2024,Premier-League
Omari Forson,eng ENG,FW,Manchester Utd,19.0,2004.0,0.8,2,0,0,2,0,1,1,100.0,0,0,0,0,0,2,0,0,Matches,2023-2024,Premier-League
Lyle Foster,za RSA,"FW,MF",Burnley,22.0,2000.0,21.1,19,10,5,6,8,6,17,35.3,11,13,3,10,3,22,34,0,Matches,2023-2024,Premier-League
Matheus França,br BRA,"MF,FW",Crystal Palace,19.0,2004.0,2.6,3,3,2,1,0,1,7,14.3,6,4,0,4,1,4,1,0,Matches,2023-2024,Premier-League
Nathan Fraser,ie IRL,FW,Wolves,18.0,2005.0,2.1,5,2,2,1,2,1,3,33.3,2,2,1,1,1,6,2,0,Matches,2023-2024,Premier-League
Cody Gakpo,nl NED,"FW,MF",Liverpool,24.0,1999.0,18.3,27,17,8,14,5,8,25,32.0,17,21,4,17,14,41,7,0,Matches,2023-2024,Premier-League
Conor Gallagher,eng ENG,MF,Chelsea,23.0,2000.0,34.8,85,52,37,31,17,33,77,42.9,44,50,11,39,43,128,34,0,Matches,2023-2024,Premier-League
Idrissa Gana Gueye,sn SEN,MF,Everton,33.0,1989.0,20.9,73,44,32,27,14,29,46,63.0,17,24,7,17,28,101,16,0,Matches,2023-2024,Premier-League
Alejandro Garnacho,ar ARG,FW,Manchester Utd,19.0,2004.0,28.5,22,15,7,6,9,12,45,26.7,33,26,2,24,18,40,18,0,Matches,2023-2024,Premier-League
James Garner,eng ENG,MF,Everton,22.0,2001.0,33.4,83,44,32,38,13,35,82,42.7,47,45,14,31,45,128,47,1,Matches,2023-2024,Premier-League
Saman Ghoddos,ir IRN,DF,Brentford,29.0,1993.0,8.2,28,19,19,7,2,17,31,54.8,14,9,2,7,5,33,12,0,Matches,2023-2024,Premier-League
Morgan Gibbs-White,eng ENG,"MF,FW",Nott'ham Forest,23.0,2000.0,35.1,36,24,6,20,10,14,33,42.4,19,31,8,23,17,53,21,0,Matches,2023-2024,Premier-League
Bryan Gil,es ESP,"FW,MF",Tottenham,22.0,2001.0,2.3,1,0,0,0,1,1,4,25.0,3,3,0,3,3,4,4,0,Matches,2023-2024,Premier-League
Alfie Gilchrist,eng ENG,DF,Chelsea,19.0,2003.0,2.3,4,0,4,0,0,2,5,40.0,3,6,3,3,3,7,11,0,Matches,2023-2024,Premier-League
Ryan Giles,eng ENG,"DF,MF",Luton Town,23.0,2000.0,5.6,8,6,4,3,1,2,7,28.6,5,2,0,2,4,12,22,0,Matches,2023-2024,Premier-League
Billy Gilmour,sct SCO,MF,Brighton,22.0,2001.0,23.6,26,16,14,10,2,11,35,31.4,24,23,9,14,11,37,14,1,Matches,2023-2024,Premier-League
Ben Godfrey,eng ENG,DF,Everton,25.0,1998.0,12.4,30,20,17,8,5,15,28,53.6,13,14,8,6,16,46,57,0,Matches,2023-2024,Premier-League
André Gomes,pt POR,"MF,FW",Everton,30.0,1993.0,5.6,7,4,2,3,2,3,13,23.1,10,10,1,9,3,10,4,1,Matches,2023-2024,Premier-League
João Gomes,br BRA,MF,Wolves,22.0,2001.0,29.4,128,74,67,49,12,44,99,44.4,55,51,8,43,18,146,29,2,Matches,2023-2024,Premier-League
Toti Gomes,pt POR,DF,Wolves,24.0,1999.0,30.8,44,25,32,8,4,24,37,64.9,13,40,19,21,26,70,93,2,Matches,2023-2024,Premier-League
Joe Gomez,eng ENG,DF,Liverpool,26.0,1997.0,19.8,47,31,24,16,7,30,63,47.6,33,26,4,22,19,66,50,2,Matches,2023-2024,Premier-League
Sergio Gómez,es ESP,"FW,MF",Manchester City,22.0,2000.0,0.6,1,0,0,1,0,1,2,50.0,1,0,0,0,1,2,0,0,Matches,2023-2024,Premier-League
Enso Gonzalez,py PAR,"MF,DF",Wolves,18.0,2005.0,0.0,0,0,0,0,0,0,1,0.0,1,0,0,0,0,0,0,0,Matches,2023-2024,Premier-League
Anthony Gordon,eng ENG,FW,Newcastle Utd,22.0,2001.0,32.1,55,34,16,28,11,22,64,34.4,42,27,0,27,7,62,7,0,Matches,2023-2024,Premier-League
Kaide Gordon,eng ENG,FW,Liverpool,18.0,2004.0,0.0,0,0,0,0,0,0,0,,0,0,0,0,0,0,0,0,Matches,2023-2024,Premier-League
Daniel Gore,eng ENG,MF,Manchester Utd,18.0,2004.0,0.0,1,1,0,1,0,1,1,100.0,0,0,0,0,1,2,0,0,Matches,2023-2024,Premier-League
Ryan Gravenberch,nl NED,MF,Liverpool,21.0,2002.0,12.5,26,12,5,13,8,12,29,41.4,17,20,2,18,14,40,11,0,Matches,2023-2024,Premier-League
Ivo Grbić,hr CRO,GK,Sheffield Utd,27.0,1996.0,8.6,0,0,0,0,0,0,1,0.0,1,1,0,1,0,0,9,1,Matches,2023-2024,Premier-League
Jack Grealish,eng ENG,"FW,MF",Manchester City,27.0,1995.0,11.2,13,8,6,7,0,6,12,50.0,6,13,2,11,6,19,5,0,Matches,2023-2024,Premier-League
Pascal Groß,de GER,"MF,DF",Brighton,32.0,1991.0,34.6,70,46,33,21,16,31,72,43.1,41,41,8,33,22,92,32,3,Matches,2023-2024,Premier-League
Marc Guéhi,eng ENG,DF,Crystal Palace,23.0,2000.0,22.5,28,19,21,7,0,14,24,58.3,10,22,17,5,18,46,89,1,Matches,2023-2024,Premier-League
Bruno Guimarães,br BRA,MF,Newcastle Utd,25.0,1997.0,36.3,88,53,45,32,11,40,77,51.9,37,52,14,38,35,123,20,0,Matches,2023-2024,Premier-League
Malo Gusto,fr FRA,DF,Chelsea,20.0,2003.0,19.5,55,27,34,15,6,35,52,67.3,17,28,4,24,17,72,43,1,Matches,2023-2024,Premier-League
Joško Gvardiol,hr CRO,DF,Manchester City,21.0,2002.0,25.9,55,33,21,24,10,21,38,55.3,17,36,12,24,27,82,37,3,Matches,2023-2024,Premier-League
Erling Haaland,no NOR,FW,Manchester City,23.0,2000.0,28.4,6,3,0,3,3,2,3,66.7,1,11,1,10,2,8,16,0,Matches,2023-2024,Premier-League
Antwoine Hackford,eng ENG,FW,Sheffield Utd,19.0,2004.0,0.1,0,0,0,0,0,0,0,,0,0,0,0,0,0,0,0,Matches,2023-2024,Premier-League
Lewis Hall,eng ENG,DF,Newcastle Utd,18.0,2004.0,8.7,28,18,17,10,1,17,28,60.7,11,17,2,15,12,40,22,1,Matches,2023-2024,Premier-League
Gustavo Hamer,nl NED,MF,Sheffield Utd,26.0,1997.0,32.3,39,21,17,15,7,16,59,27.1,43,33,9,24,29,68,35,0,Matches,2023-2024,Premier-League
Luke Harris,wls WAL,MF,Fulham,18.0,2005.0,0.8,1,1,1,0,0,0,1,0.0,1,0,0,0,0,1,0,0,Matches,2023-2024,Premier-League
Jack Harrison,eng ENG,"MF,FW",Everton,26.0,1996.0,24.6,37,22,12,12,13,17,49,34.7,32,25,5,20,12,49,24,0,Matches,2023-2024,Premier-League
Daiki Hashioka,jp JPN,DF,Luton Town,24.0,1999.0,6.6,11,5,6,4,1,5,11,45.5,6,12,7,5,8,19,20,0,Matches,2023-2024,Premier-League
Kai Havertz,de GER,"MF,FW",Arsenal,24.0,1999.0,29.3,35,15,7,21,7,14,39,35.9,25,26,1,25,20,55,22,0,Matches,2023-2024,Premier-League
Jan Paul van Hecke,nl NED,DF,Brighton,23.0,2000.0,26.3,47,26,25,19,3,27,45,60.0,18,49,27,22,30,77,76,4,Matches,2023-2024,Premier-League
Hwang Hee-chan,kr KOR,"FW,MF",Wolves,27.0,1996.0,23.5,20,10,11,8,1,9,24,37.5,15,19,1,18,10,30,9,0,Matches,2023-2024,Premier-League
Dean Henderson,eng ENG,GK,Crystal Palace,26.0,1997.0,18.0,1,1,1,0,0,1,2,50.0,1,0,0,0,0,1,8,2,Matches,2023-2024,Premier-League
Rico Henry,eng ENG,DF,Brentford,26.0,1997.0,4.5,7,5,3,3,1,6,7,85.7,1,8,3,5,5,12,5,1,Matches,2023-2024,Premier-League
Son Heung-min,kr KOR,FW,Tottenham,31.0,1992.0,32.6,21,13,6,7,8,10,21,47.6,11,4,1,3,8,29,4,0,Matches,2023-2024,Premier-League
Aaron Hickey,sct SCO,DF,Brentford,21.0,2002.0,7.9,16,9,9,3,4,7,7,100.0,0,7,3,4,3,19,10,0,Matches,2023-2024,Premier-League
James Hill,eng ENG,DF,Bournemouth,21.0,2002.0,0.8,3,2,1,2,0,1,1,100.0,0,3,2,1,3,6,8,0,Matches,2023-2024,Premier-League
Jack Hinshelwood,eng ENG,DF,Brighton,18.0,2005.0,9.7,14,5,7,4,3,5,13,38.5,8,6,2,4,14,28,18,0,Matches,2023-2024,Premier-League
Mason Holgate,eng ENG,DF,Sheffield Utd,26.0,1996.0,7.9,12,7,5,6,1,5,12,41.7,7,12,5,7,11,23,40,0,Matches,2023-2024,Premier-League
Callum Hudson-Odoi,eng ENG,"FW,MF",Nott'ham Forest,22.0,2000.0,20.6,18,8,4,5,9,7,28,25.0,21,16,1,15,7,25,12,1,Matches,2023-2024,Premier-League
Will Hughes,eng ENG,MF,Crystal Palace,28.0,1995.0,21.0,61,33,30,20,11,24,48,50.0,24,36,14,22,21,82,25,0,Matches,2023-2024,Premier-League
Pierre Højbjerg,dk DEN,MF,Tottenham,27.0,1995.0,14.6,32,18,13,17,2,13,34,38.2,21,21,7,14,19,51,30,3,Matches,2023-2024,Premier-League
Rasmus Højlund,dk DEN,FW,Manchester Utd,20.0,2003.0,24.0,11,7,2,3,6,5,13,38.5,8,9,1,8,1,12,19,0,Matches,2023-2024,Premier-League
Igor,br BRA,DF,Brighton,25.0,1998.0,18.2,25,18,7,16,2,17,29,58.6,12,22,9,13,14,39,52,1,Matches,2023-2024,Premier-League
Danny Ings,eng ENG,FW,West Ham,31.0,1992.0,4.5,6,2,0,6,0,4,13,30.8,9,4,1,3,3,9,7,0,Matches,2023-2024,Premier-League
Tim Iroegbunam,eng ENG,MF,Aston Villa,20.0,2003.0,1.8,7,5,4,2,1,4,9,44.4,5,3,0,3,2,9,3,0,Matches,2023-2024,Premier-League
Alexander Isak,se SWE,FW,Newcastle Utd,23.0,1999.0,25.1,5,0,2,1,2,2,8,25.0,6,16,1,15,6,11,13,0,Matches,2023-2024,Premier-League
Alex Iwobi,ng NGA,MF,Everton,27.0,1996.0,1.6,2,0,1,0,1,2,3,66.7,1,2,0,2,1,3,0,0,Matches,2023-2024,Premier-League
Alex Iwobi,ng NGA,"FW,MF",Fulham,27.0,1996.0,24.4,29,18,12,15,2,12,25,48.0,13,16,0,16,14,43,9,0,Matches,2023-2024,Premier-League
Nicolas Jackson,sn SEN,FW,Chelsea,22.0,2001.0,31.1,21,13,5,8,8,5,24,20.8,19,20,5,15,4,25,17,0,Matches,2023-2024,Premier-League
Reece James,eng ENG,DF,Chelsea,23.0,1999.0,4.7,14,9,10,3,1,8,10,80.0,2,4,4,0,3,17,7,1,Matches,2023-2024,Premier-League
Vitaly Janelt,de GER,"MF,DF",Brentford,25.0,1998.0,33.9,63,38,29,25,9,32,64,50.0,32,35,9,26,36,99,64,3,Matches,2023-2024,Premier-League
Daniel Jebbison,eng ENG,FW,Sheffield Utd,19.0,2003.0,0.2,0,0,0,0,0,0,0,,0,1,0,1,0,0,0,0,Matches,2023-2024,Premier-League
Mathias Jensen,dk DEN,MF,Brentford,27.0,1996.0,24.5,54,32,25,22,7,26,95,27.4,69,41,6,35,23,77,25,1,Matches,2023-2024,Premier-League
Gabriel Jesus,br BRA,FW,Arsenal,26.0,1997.0,16.4,24,17,11,5,8,5,18,27.8,13,23,1,22,13,37,12,0,Matches,2023-2024,Premier-League
Raúl Jiménez,mx MEX,FW,Fulham,32.0,1991.0,15.5,18,12,4,8,6,7,20,35.0,13,11,3,8,4,22,13,0,Matches,2023-2024,Premier-League
João Pedro,br BRA,"FW,MF",Brighton,21.0,2001.0,22.7,31,14,10,13,8,14,24,58.3,10,15,2,13,11,42,28,0,Matches,2023-2024,Premier-League
Joelinton,br BRA,"MF,FW",Newcastle Utd,26.0,1996.0,14.2,39,27,21,15,3,14,38,36.8,24,23,7,16,19,58,11,1,Matches,2023-2024,Premier-League
Ben Johnson,eng ENG,"DF,FW",West Ham,23.0,2000.0,6.0,11,7,7,3,1,9,14,64.3,5,2,1,1,5,16,14,0,Matches,2023-2024,Premier-League
Brennan Johnson,wls WAL,FW,Tottenham,22.0,2001.0,23.2,26,15,14,5,7,12,31,38.7,19,37,1,36,10,36,12,1,Matches,2023-2024,Premier-League
Brennan Johnson,wls WAL,"FW,MF",Nott'ham Forest,22.0,2001.0,2.6,4,1,1,1,2,2,4,50.0,2,4,1,3,0,4,0,0,Matches,2023-2024,Premier-League
Joseph Johnson,eng ENG,DF,Luton Town,17.0,2006.0,0.9,0,0,0,0,0,0,1,0.0,1,0,0,0,0,0,0,0,Matches,2023-2024,Premier-League
Sam Johnstone,eng ENG,GK,Crystal Palace,30.0,1993.0,20.0,1,0,1,0,0,1,1,100.0,0,0,0,0,1,2,5,0,Matches,2023-2024,Premier-League
Curtis Jones,eng ENG,MF,Liverpool,22.0,2001.0,13.0,27,14,12,12,3,10,23,43.5,13,22,0,22,7,34,8,0,Matches,2023-2024,Premier-League
Jorginho,it ITA,MF,Arsenal,31.0,1991.0,10.2,24,10,6,10,8,11,23,47.8,12,17,1,16,12,36,7,1,Matches,2023-2024,Premier-League
Diogo Jota,pt POR,FW,Liverpool,26.0,1996.0,12.7,23,13,6,13,4,10,23,43.5,13,9,1,8,7,30,4,0,Matches,2023-2024,Premier-League
Mads Juel Andersen,dk DEN,DF,Luton Town,25.0,1997.0,4.4,6,5,4,2,0,4,4,100.0,0,9,6,3,8,14,29,0,Matches,2023-2024,Premier-League
Hamed Junior Traorè,ci CIV,MF,Bournemouth,23.0,2000.0,0.5,1,0,1,0,0,1,3,33.3,2,3,0,3,0,1,0,0,Matches,2023-2024,Premier-League
Mathias Jørgensen,dk DEN,DF,Brentford,33.0,1990.0,12.1,17,12,15,1,1,11,19,57.9,8,9,5,4,12,29,40,0,Matches,2023-2024,Premier-League
Issa Kaboré,bf BFA,DF,Luton Town,22.0,2001.0,19.2,52,28,23,21,8,24,45,53.3,21,22,11,11,16,68,56,2,Matches,2023-2024,Premier-League
Sasa Kalajdzic,at AUT,FW,Wolves,26.0,1997.0,1.8,6,2,3,2,1,1,2,50.0,1,3,0,3,1,7,6,0,Matches,2023-2024,Premier-League
Boubacar Kamara,fr FRA,MF,Aston Villa,23.0,1999.0,18.4,43,29,16,21,6,24,47,51.1,23,21,7,14,21,64,16,0,Matches,2023-2024,Premier-League
Willy Kambwala,fr FRA,DF,Manchester Utd,18.0,2004.0,3.7,3,1,1,2,0,1,3,33.3,2,6,3,3,4,7,14,1,Matches,2023-2024,Premier-League
Thomas Kaminski,be BEL,GK,Luton Town,30.0,1992.0,37.8,2,1,2,0,0,2,6,33.3,4,1,0,1,0,2,14,2,Matches,2023-2024,Premier-League
Loris Karius,de GER,GK,Newcastle Utd,30.0,1993.0,1.0,0,0,0,0,0,0,0,,0,0,0,0,0,0,1,0,Matches,2023-2024,Premier-League
Michael Keane,eng ENG,DF,Everton,30.0,1993.0,4.9,7,3,3,3,1,1,7,14.3,6,5,4,1,5,12,18,1,Matches,2023-2024,Premier-League
Thilo Kehrer,de GER,"DF,MF",West Ham,26.0,1996.0,0.2,1,1,0,1,0,0,0,,0,2,2,0,0,1,0,0,Matches,2023-2024,Premier-League
Caoimhín Kelleher,ie IRL,GK,Liverpool,24.0,1998.0,10.0,0,0,0,0,0,0,0,,0,0,0,0,0,0,4,1,Matches,2023-2024,Premier-League
Lloyd Kelly,eng ENG,DF,Bournemouth,24.0,1998.0,17.3,24,19,10,9,5,14,25,56.0,11,22,12,10,13,37,67,0,Matches,2023-2024,Premier-League
Omari Kellyman,eng ENG,FW,Aston Villa,17.0,2005.0,0.4,1,0,0,1,0,1,2,50.0,1,0,0,0,0,1,0,0,Matches,2023-2024,Premier-League
Milos Kerkez,hu HUN,DF,Bournemouth,19.0,2003.0,21.9,47,26,31,13,3,30,42,71.4,12,31,11,20,20,67,60,2,Matches,2023-2024,Premier-League
Kaine Kesler-Hayden,eng ENG,"MF,DF",Aston Villa,20.0,2002.0,0.1,0,0,0,0,0,0,0,,0,0,0,0,0,0,0,0,Matches,2023-2024,Premier-League
Max Kilman,eng ENG,DF,Wolves,26.0,1997.0,38.0,47,21,40,6,1,24,32,75.0,8,64,37,27,39,86,182,4,Matches,2023-2024,Premier-League
Jakub Kiwior,pl POL,DF,Arsenal,23.0,2000.0,10.5,20,12,11,8,1,14,19,73.7,5,11,3,8,8,28,28,1,Matches,2023-2024,Premier-League
Justin Kluivert,nl NED,"MF,FW",Bournemouth,24.0,1999.0,21.3,28,14,5,12,11,8,30,26.7,22,16,1,15,8,36,11,0,Matches,2023-2024,Premier-League
Luca Koleosho,it ITA,"MF,FW",Burnley,18.0,2004.0,10.8,7,4,2,5,0,2,10,20.0,8,13,0,13,2,9,0,0,Matches,2023-2024,Premier-League
Ibrahima Konaté,fr FRA,DF,Liverpool,24.0,1999.0,17.5,36,22,22,13,1,18,24,75.0,6,18,12,6,20,56,51,1,Matches,2023-2024,Premier-League
Ezri Konsa,eng ENG,DF,Aston Villa,25.0,1997.0,34.1,54,32,28,23,3,23,27,85.2,4,36,20,16,28,82,73,3,Matches,2023-2024,Premier-League
Cheikhou Kouyaté,sn SEN,MF,Nott'ham Forest,33.0,1989.0,2.4,8,5,3,3,2,1,4,25.0,3,4,1,3,2,10,10,0,Matches,2023-2024,Premier-League
Mateo Kovačić,hr CRO,MF,Manchester City,29.0,1994.0,17.2,36,25,16,15,5,18,28,64.3,10,23,1,22,10,46,10,0,Matches,2023-2024,Premier-League
Emil Krafth,se SWE,DF,Newcastle Utd,28.0,1994.0,10.1,21,14,10,7,4,12,25,48.0,13,8,3,5,9,30,21,0,Matches,2023-2024,Premier-League
Mohammed Kudus,gh GHA,"FW,MF",West Ham,22.0,2000.0,27.6,65,47,27,27,11,20,40,50.0,20,25,0,25,11,76,9,1,Matches,2023-2024,Premier-League
Dejan Kulusevski,se SWE,"FW,MF",Tottenham,23.0,2000.0,30.7,62,33,19,20,23,25,67,37.3,42,24,1,23,18,80,2,1,Matches,2023-2024,Premier-League
Adam Lallana,eng ENG,"MF,FW",Brighton,35.0,1988.0,9.4,8,3,4,4,0,0,4,0.0,4,2,1,1,3,11,1,0,Matches,2023-2024,Premier-League
Tariq Lamptey,gh GHA,"DF,FW",Brighton,22.0,2000.0,10.2,21,14,14,5,2,13,22,59.1,9,7,3,4,6,27,6,0,Matches,2023-2024,Premier-League
Aymeric Laporte,es ESP,DF,Manchester City,29.0,1994.0,0.1,0,0,0,0,0,0,0,,0,1,1,0,0,0,1,0,Matches,2023-2024,Premier-League
Yasser Larouci,dz ALG,DF,Sheffield Utd,22.0,2001.0,5.9,17,9,10,5,2,10,14,71.4,4,6,1,5,7,24,20,1,Matches,2023-2024,Premier-League
Jamaal Lascelles,eng ENG,DF,Newcastle Utd,29.0,1993.0,12.0,14,9,7,7,0,6,11,54.5,5,17,12,5,5,19,42,0,Matches,2023-2024,Premier-League
Roméo Lavia,be BEL,MF,Chelsea,19.0,2004.0,0.4,1,0,0,1,0,0,0,,0,0,0,0,0,1,1,0,Matches,2023-2024,Premier-League
Mario Lemina,ga GAB,MF,Wolves,29.0,1993.0,33.0,90,58,46,33,11,25,47,53.2,22,36,9,27,41,131,64,0,Matches,2023-2024,Premier-League
Clément Lenglet,fr FRA,DF,Aston Villa,28.0,1995.0,12.8,13,9,7,5,1,7,13,53.8,6,19,11,8,7,20,47,1,Matches,2023-2024,Premier-League
Bernd Leno,de GER,GK,Fulham,31.0,1992.0,38.0,0,0,0,0,0,0,0,,0,0,0,0,0,0,14,1,Matches,2023-2024,Premier-League
Jefferson Lerma,co COL,"MF,DF",Crystal Palace,28.0,1994.0,26.7,42,25,15,23,4,19,40,47.5,21,31,12,19,36,78,72,0,Matches,2023-2024,Premier-League
Rico Lewis,eng ENG,"DF,MF",Manchester City,18.0,2004.0,9.0,10,7,4,4,2,3,7,42.9,4,7,1,6,4,14,6,0,Matches,2023-2024,Premier-League
Keane Lewis-Potter,eng ENG,"FW,DF",Brentford,22.0,2001.0,16.0,17,7,5,11,1,7,15,46.7,8,10,2,8,7,24,23,0,Matches,2023-2024,Premier-League
Victor Lindelöf,se SWE,DF,Manchester Utd,29.0,1994.0,14.8,15,10,8,7,0,5,13,38.5,8,18,9,9,12,27,40,1,Matches,2023-2024,Premier-League
Valentino Livramento,eng ENG,DF,Newcastle Utd,20.0,2002.0,14.6,23,13,15,6,2,10,21,47.6,11,16,7,9,25,48,41,1,Matches,2023-2024,Premier-League
Giovani Lo Celso,ar ARG,MF,Tottenham,27.0,1996.0,5.6,22,13,10,8,4,9,14,64.3,5,4,1,3,5,27,2,0,Matches,2023-2024,Premier-League
Tom Lockyer,wls WAL,DF,Luton Town,28.0,1994.0,13.0,25,16,17,6,2,15,22,68.2,7,23,13,10,23,48,68,0,Matches,2023-2024,Premier-League
Sean Longstaff,eng ENG,MF,Newcastle Utd,25.0,1997.0,30.5,54,30,17,29,8,24,63,38.1,39,43,7,36,17,71,23,0,Matches,2023-2024,Premier-League
Max Lowe,eng ENG,"DF,MF",Sheffield Utd,26.0,1997.0,5.6,21,10,13,5,3,8,15,53.3,7,10,4,6,5,26,15,0,Matches,2023-2024,Premier-League
Douglas Luiz,br BRA,MF,Aston Villa,25.0,1998.0,33.3,58,38,21,27,10,25,53,47.2,28,32,8,24,23,81,18,2,Matches,2023-2024,Premier-League
Saša Lukić,rs SRB,MF,Fulham,26.0,1996.0,12.5,33,19,9,17,7,18,39,46.2,21,18,5,13,16,49,19,1,Matches,2023-2024,Premier-League
Ian Maatsen,nl NED,"FW,MF",Chelsea,21.0,2002.0,2.3,3,2,1,1,1,0,4,0.0,4,4,0,4,3,6,10,0,Matches,2023-2024,Premier-League
Alexis Mac Allister,ar ARG,MF,Liverpool,24.0,1998.0,28.9,99,55,35,50,14,59,125,47.2,66,65,8,57,35,134,25,1,Matches,2023-2024,Premier-League
James Maddison,eng ENG,MF,Tottenham,26.0,1996.0,23.7,33,19,5,18,10,15,29,51.7,14,15,3,12,13,46,10,1,Matches,2023-2024,Premier-League
Noni Madueke,eng ENG,FW,Chelsea,21.0,2002.0,11.7,16,10,8,4,4,11,34,32.4,23,11,0,11,4,20,14,0,Matches,2023-2024,Premier-League
Gabriel Magalhães,br BRA,DF,Arsenal,25.0,1997.0,33.8,48,28,24,22,2,17,22,77.3,5,44,33,11,31,79,100,1,Matches,2023-2024,Premier-League
Harry Maguire,eng ENG,DF,Manchester Utd,30.0,1993.0,18.4,24,17,14,10,0,12,22,54.5,10,33,24,9,25,49,83,1,Matches,2023-2024,Premier-League
Kobbie Mainoo,eng ENG,MF,Manchester Utd,18.0,2005.0,21.4,47,27,20,16,11,21,45,46.7,24,20,12,8,22,69,30,1,Matches,2023-2024,Premier-League
Orel Mangala,be BEL,MF,Nott'ham Forest,25.0,1998.0,17.4,27,13,16,10,1,14,29,48.3,15,12,6,6,26,53,32,0,Matches,2023-2024,Premier-League
Benson Manuel,ao ANG,"MF,FW",Burnley,26.0,1997.0,1.3,3,2,2,1,0,0,0,,0,1,0,1,0,3,0,0,Matches,2023-2024,Premier-League
Solly March,eng ENG,"FW,DF",Brighton,29.0,1994.0,6.2,19,14,9,7,3,8,14,57.1,6,5,0,5,11,30,8,0,Matches,2023-2024,Premier-League
Anthony Martial,fr FRA,FW,Manchester Utd,27.0,1995.0,5.0,4,1,1,1,2,1,1,100.0,0,4,0,4,0,4,3,0,Matches,2023-2024,Premier-League
Gabriel Martinelli,br BRA,FW,Arsenal,22.0,2001.0,22.4,30,24,9,12,9,13,32,40.6,19,23,1,22,5,35,9,1,Matches,2023-2024,Premier-League
Emiliano Martínez,ar ARG,GK,Aston Villa,30.0,1992.0,33.5,0,0,0,0,0,0,0,,0,0,0,0,0,0,12,3,Matches,2023-2024,Premier-League
Lisandro Martínez,ar ARG,DF,Manchester Utd,25.0,1998.0,7.2,12,8,8,4,0,5,12,41.7,7,10,8,2,5,17,26,0,Matches,2023-2024,Premier-League
Han-Noah Massengo,fr FRA,"MF,DF",Burnley,22.0,2001.0,0.2,1,1,1,0,0,0,0,,0,1,0,1,0,1,0,0,Matches,2023-2024,Premier-League
Pape Matar Sarr,sn SEN,MF,Tottenham,20.0,2002.0,23.0,34,24,11,17,6,15,36,41.7,21,21,5,16,31,65,28,1,Matches,2023-2024,Premier-League
Jean-Philippe Mateta,fr FRA,FW,Crystal Palace,26.0,1997.0,25.4,22,15,4,11,7,6,10,60.0,4,13,4,9,4,26,14,0,Matches,2023-2024,Premier-League
Joël Matip,cm CMR,DF,Liverpool,31.0,1991.0,8.7,12,6,7,4,1,8,12,66.7,4,16,12,4,9,21,43,0,Matches,2023-2024,Premier-League
Alex Matos,eng ENG,MF,Chelsea,18.0,2004.0,0.0,0,0,0,0,0,0,0,,0,0,0,0,0,0,0,0,Matches,2023-2024,Premier-League
Remi Matthews,eng ENG,GK,Crystal Palace,29.0,1994.0,0.0,0,0,0,0,0,0,0,,0,0,0,0,0,0,1,0,Matches,2023-2024,Premier-League
Neal Maupay,fr FRA,FW,Brentford,26.0,1996.0,14.7,10,7,4,5,1,3,13,23.1,10,11,0,11,2,12,3,0,Matches,2023-2024,Premier-League
Neal Maupay,fr FRA,FW,Everton,26.0,1996.0,1.2,0,0,0,0,0,0,1,0.0,1,2,0,2,0,0,1,0,Matches,2023-2024,Premier-League
Konstantinos Mavropanos,gr GRE,DF,West Ham,25.0,1997.0,16.7,28,16,17,9,2,17,21,81.0,4,21,13,8,23,51,79,3,Matches,2023-2024,Premier-League
Bryan Mbeumo,cm CMR,FW,Brentford,23.0,1999.0,21.8,15,10,6,6,3,5,19,26.3,14,26,2,24,7,22,13,0,Matches,2023-2024,Premier-League
James Mcatee,eng ENG,"MF,FW",Sheffield Utd,20.0,2002.0,20.2,32,21,9,13,10,13,33,39.4,20,20,0,20,11,43,18,0,Matches,2023-2024,Premier-League
James Mcatee,eng ENG,MF,Manchester City,20.0,2002.0,0.0,0,0,0,0,0,0,0,,0,1,0,1,0,0,0,0,Matches,2023-2024,Premier-League
Oliver McBurnie,sct SCO,FW,Sheffield Utd,27.0,1996.0,14.2,17,7,4,7,6,5,12,41.7,7,18,2,16,5,22,28,0,Matches,2023-2024,Premier-League
James McConnell,eng ENG,MF,Liverpool,18.0,2004.0,0.0,0,0,0,0,0,0,0,,0,1,0,1,1,1,0,0,Matches,2023-2024,Premier-League
John McGinn,sct SCO,"MF,FW",Aston Villa,28.0,1994.0,33.3,59,35,18,34,7,32,77,41.6,45,33,4,29,21,80,21,0,Matches,2023-2024,Premier-League
Scott McKenna,sct SCO,DF,Nott'ham Forest,26.0,1996.0,4.6,4,0,3,1,0,2,3,66.7,1,6,4,2,5,9,27,0,Matches,2023-2024,Premier-League
Dwight McNeil,eng ENG,"MF,FW",Everton,23.0,1999.0,32.1,44,27,16,14,14,24,55,43.6,31,44,7,37,22,66,37,0,Matches,2023-2024,Premier-League
Scott McTominay,sct SCO,"MF,FW",Manchester Utd,26.0,1996.0,21.1,49,25,23,24,2,22,33,66.7,11,34,12,22,14,63,54,0,Matches,2023-2024,Premier-League
Ben Mee,eng ENG,DF,Brentford,33.0,1989.0,14.1,26,15,12,12,2,17,22,77.3,5,21,13,8,13,39,63,1,Matches,2023-2024,Premier-League
Hannibal Mejbri,tn TUN,"MF,FW",Manchester Utd,20.0,2003.0,1.5,3,3,1,2,0,1,3,33.3,2,1,1,0,0,3,0,0,Matches,2023-2024,Premier-League
Teden Mengi,eng ENG,DF,Luton Town,21.0,2002.0,27.4,54,22,33,20,1,19,30,63.3,11,39,27,12,57,111,140,1,Matches,2023-2024,Premier-League
Chris Mepham,wls WAL,DF,Bournemouth,25.0,1997.0,6.9,12,11,9,3,0,9,14,64.3,5,13,6,7,7,19,30,1,Matches,2023-2024,Premier-League
Lewis Miley,eng ENG,MF,Newcastle Utd,17.0,2006.0,13.4,33,21,6,20,7,15,32,46.9,17,20,3,17,8,41,18,2,Matches,2023-2024,Premier-League
James Milner,eng ENG,"DF,MF",Brighton,37.0,1986.0,8.6,20,14,9,10,1,9,14,64.3,5,9,0,9,8,28,16,0,Matches,2023-2024,Premier-League
Tyrone Mings,eng ENG,DF,Aston Villa,30.0,1993.0,0.3,0,0,0,0,0,0,0,,0,0,0,0,1,1,1,0,Matches,2023-2024,Premier-League
Tyrick Mitchell,eng ENG,"DF,MF",Crystal Palace,23.0,1999.0,35.6,105,60,75,21,9,43,60,71.7,17,63,10,53,26,131,104,0,Matches,2023-2024,Premier-League
Kaoru Mitoma,jp JPN,FW,Brighton,26.0,1997.0,16.5,13,6,3,7,3,5,19,26.3,14,15,1,14,5,18,12,0,Matches,2023-2024,Premier-League
Aleksandar Mitrović,rs SRB,FW,Fulham,28.0,1994.0,0.4,0,0,0,0,0,0,0,,0,0,0,0,0,0,0,0,Matches,2023-2024,Premier-League
Jakub Moder,pl POL,"MF,DF",Brighton,24.0,1999.0,6.9,19,10,9,5,5,9,18,50.0,9,8,2,6,2,21,12,0,Matches,2023-2024,Premier-League
Gonzalo Montiel,ar ARG,DF,Nott'ham Forest,26.0,1997.0,8.9,22,19,12,8,2,16,29,55.2,13,8,3,5,9,31,31,1,Matches,2023-2024,Premier-League
Kieffer Moore,wls WAL,"FW,MF",Bournemouth,30.0,1992.0,1.2,0,0,0,0,0,0,0,,0,0,0,0,0,0,0,0,Matches,2023-2024,Premier-League
Mikey Moore,eng ENG,MF,Tottenham,15.0,2007.0,0.0,0,0,0,0,0,0,0,,0,0,0,0,0,0,1,0,Matches,2023-2024,Premier-League
Álex Moreno,es ESP,DF,Aston Villa,30.0,1993.0,11.5,18,12,18,0,0,12,19,63.2,7,11,2,9,13,31,37,0,Matches,2023-2024,Premier-League
Carlton Morris,eng ENG,"FW,MF",Luton Town,27.0,1995.0,31.8,15,8,4,6,5,9,15,60.0,6,24,5,19,1,16,53,0,Matches,2023-2024,Premier-League
Mason Mount,eng ENG,"MF,FW",Manchester Utd,24.0,1999.0,5.7,22,14,6,10,6,6,16,37.5,10,6,1,5,6,28,3,0,Matches,2023-2024,Premier-League
Divin Mubama,eng ENG,FW,West Ham,18.0,2004.0,0.9,0,0,0,0,0,0,0,,0,0,0,0,0,0,0,0,Matches,2023-2024,Premier-League
Mykhailo Mudryk,ua UKR,FW,Chelsea,22.0,2001.0,17.5,21,12,9,7,5,10,32,31.3,22,14,1,13,9,30,9,0,Matches,2023-2024,Premier-League
Rodrigo Muniz,br BRA,FW,Fulham,22.0,2001.0,17.7,7,3,1,5,1,1,6,16.7,5,9,3,6,6,13,20,0,Matches,2023-2024,Premier-League
Daniel Muñoz,co COL,"DF,MF",Crystal Palace,27.0,1996.0,16.0,55,35,31,14,10,19,38,50.0,19,29,7,22,24,79,47,0,Matches,2023-2024,Premier-League
Finley Munroe,eng ENG,MF,Aston Villa,18.0,2005.0,0.0,0,0,0,0,0,0,0,,0,0,0,0,0,0,0,0,Matches,2023-2024,Premier-League
Arijanet Muric,xk KVX,GK,Burnley,24.0,1998.0,10.0,1,1,1,0,0,1,1,100.0,0,0,0,0,0,1,10,4,Matches,2023-2024,Premier-League
Murillo,br BRA,DF,Nott'ham Forest,21.0,2002.0,31.0,50,31,36,13,1,19,33,57.6,14,41,24,17,37,87,188,0,Matches,2023-2024,Premier-League
Alex Murphy,ie IRL,"DF,FW",Newcastle Utd,19.0,2004.0,0.1,1,1,0,1,0,1,2,50.0,1,1,0,1,1,2,0,0,Matches,2023-2024,Premier-League
Jacob Murphy,eng ENG,"FW,DF",Newcastle Utd,28.0,1995.0,13.2,20,10,8,4,8,12,26,46.2,14,17,0,17,6,26,16,0,Matches,2023-2024,Premier-League
Vitaliy Mykolenko,ua UKR,DF,Everton,24.0,1999.0,27.4,69,38,46,21,2,41,66,62.1,25,36,11,25,36,105,92,0,Matches,2023-2024,Premier-League
Marvelous Nakamba,zw ZIM,MF,Luton Town,29.0,1994.0,12.6,40,24,24,14,2,24,42,57.1,18,23,6,17,11,51,11,1,Matches,2023-2024,Premier-League
Michael Ndiweni,eng ENG,FW,Newcastle Utd,19.0,2003.0,0.0,0,0,0,0,0,0,0,,0,0,0,0,0,0,0,0,Matches,2023-2024,Premier-League
Reiss Nelson,eng ENG,FW,Arsenal,23.0,1999.0,3.0,9,6,5,1,3,8,10,80.0,2,5,1,4,1,10,5,0,Matches,2023-2024,Premier-League
Zack Nelson,eng ENG,"MF,DF",Luton Town,18.0,2004.0,0.1,1,0,1,0,0,0,0,,0,0,0,0,0,1,0,0,Matches,2023-2024,Premier-League
Neto,br BRA,GK,Bournemouth,34.0,1989.0,32.0,0,0,0,0,0,0,0,,0,1,0,1,1,1,12,3,Matches,2023-2024,Premier-League
Pedro Neto,pt POR,"FW,MF",Wolves,23.0,2000.0,16.8,7,3,3,2,2,5,15,33.3,10,5,1,4,5,12,2,0,Matches,2023-2024,Premier-League
Moussa Niakhate,sn SEN,DF,Nott'ham Forest,27.0,1996.0,16.2,42,25,33,9,0,20,25,80.0,5,19,12,7,14,56,51,0,Matches,2023-2024,Premier-League
Eddie Nketiah,eng ENG,FW,Arsenal,24.0,1999.0,12.0,12,7,2,6,4,2,7,28.6,5,11,0,11,4,16,4,0,Matches,2023-2024,Premier-League
Christopher Nkunku,fr FRA,"FW,MF",Chelsea,25.0,1997.0,4.9,5,4,0,4,1,1,2,50.0,1,4,1,3,2,7,4,0,Matches,2023-2024,Premier-League
Rhys Norrington-Davies,wls WAL,DF,Sheffield Utd,24.0,1999.0,1.2,1,1,1,0,0,0,1,0.0,1,2,0,2,1,2,2,0,Matches,2023-2024,Premier-League
Oliver Norwood,nir NIR,MF,Sheffield Utd,32.0,1991.0,16.0,41,26,18,18,5,20,47,42.6,27,24,9,15,21,62,39,0,Matches,2023-2024,Premier-League
Matheus Nunes,pt POR,MF,Wolves,24.0,1998.0,2.0,3,1,3,0,0,2,6,33.3,4,0,0,0,6,9,1,0,Matches,2023-2024,Premier-League
Matheus Nunes,pt POR,MF,Manchester City,24.0,1998.0,7.3,10,4,1,7,2,5,16,31.3,11,7,1,6,1,11,8,1,Matches,2023-2024,Premier-League
Darwin Núñez,uy URU,FW,Liverpool,24.0,1999.0,22.7,22,12,2,10,10,11,23,47.8,12,18,6,12,3,25,9,0,Matches,2023-2024,Premier-League
Ethan Nwaneri,eng ENG,FW,Arsenal,16.0,2007.0,0.2,0,0,0,0,0,0,0,,0,1,0,1,0,0,0,0,Matches,2023-2024,Premier-League
Christian Nørgaard,dk DEN,MF,Brentford,29.0,1994.0,27.8,81,50,42,31,8,32,87,36.8,55,48,6,42,54,135,50,0,Matches,2023-2024,Premier-League
Mark O'Mahony,ie IRL,FW,Brighton,18.0,2005.0,0.7,1,0,1,0,0,1,2,50.0,1,2,1,1,0,1,1,0,Matches,2023-2024,Premier-League
Dara O'Shea,ie IRL,DF,Burnley,24.0,1999.0,32.1,39,20,22,14,3,11,26,42.3,15,41,30,11,35,74,158,2,Matches,2023-2024,Premier-League
Michael Obafemi,ie IRL,"FW,MF",Burnley,23.0,2000.0,0.2,0,0,0,0,0,0,0,,0,1,0,1,0,0,0,0,Matches,2023-2024,Premier-League
Wilson Odobert,fr FRA,"MF,FW",Burnley,18.0,2004.0,23.3,17,13,8,5,4,6,22,27.3,16,26,2,24,6,23,14,0,Matches,2023-2024,Premier-League
Odeluga Offiah,eng ENG,DF,Brighton,20.0,2002.0,1.4,1,0,1,0,0,1,1,100.0,0,0,0,0,1,2,0,0,Matches,2023-2024,Premier-League
Chiedozie Ogbene,ie IRL,"MF,DF",Luton Town,26.0,1997.0,22.2,17,10,10,7,0,12,22,54.5,10,14,3,11,7,24,34,2,Matches,2023-2024,Premier-League
Angelo Ogbonna,it ITA,DF,West Ham,35.0,1988.0,7.1,11,5,9,2,0,6,7,85.7,1,13,10,3,3,14,29,0,Matches,2023-2024,Premier-League
Michael Olakigbe,eng ENG,"DF,FW",Brentford,19.0,2004.0,0.7,3,0,2,1,0,2,4,50.0,2,7,0,7,1,4,0,1,Matches,2023-2024,Premier-League
Michael Olise,fr FRA,"FW,MF",Crystal Palace,21.0,2001.0,14.2,19,10,7,10,2,8,24,33.3,16,21,0,21,11,30,9,0,Matches,2023-2024,Premier-League
Robin Olsen,se SWE,GK,Aston Villa,33.0,1990.0,4.5,0,0,0,0,0,0,0,,0,0,0,0,0,0,1,0,Matches,2023-2024,Premier-League
Andrew Omobamidele,ie IRL,DF,Nott'ham Forest,21.0,2002.0,8.7,10,3,9,1,0,5,8,62.5,3,12,8,4,13,23,42,1,Matches,2023-2024,Premier-League
Amadou Onana,be BEL,MF,Everton,21.0,2001.0,23.2,71,38,32,31,8,21,42,50.0,21,25,6,19,21,92,31,0,Matches,2023-2024,Premier-League
André Onana,cm CMR,GK,Manchester Utd,27.0,1996.0,38.0,2,0,2,0,0,2,2,100.0,0,0,0,0,0,2,11,2,Matches,2023-2024,Premier-League
Ryan One,sct SCO,FW,Sheffield Utd,17.0,2006.0,0.1,0,0,0,0,0,0,0,,0,0,0,0,0,0,0,0,Matches,2023-2024,Premier-League
Tyler Onyango,eng ENG,MF,Everton,20.0,2003.0,0.0,0,0,0,0,0,0,0,,0,0,0,0,0,0,0,0,Matches,2023-2024,Premier-League
Fred Onyedinma,eng ENG,"DF,MF",Luton Town,26.0,1996.0,4.5,10,6,7,3,0,5,12,41.7,7,3,0,3,1,11,13,0,Matches,2023-2024,Premier-League
Frank Onyeka,ng NGA,MF,Brentford,25.0,1998.0,12.9,37,24,9,23,5,16,29,55.2,13,15,7,8,23,60,17,0,Matches,2023-2024,Premier-League
Divock Origi,be BEL,FW,Nott'ham Forest,28.0,1995.0,6.7,6,4,5,0,1,0,0,,0,6,0,6,2,8,4,0,Matches,2023-2024,Premier-League
Stefan Ortega,de GER,GK,Manchester City,30.0,1992.0,7.1,0,0,0,0,0,0,0,,0,0,0,0,0,0,2,1,Matches,2023-2024,Premier-League
Ben Osborn,eng ENG,"DF,MF",Sheffield Utd,28.0,1994.0,15.2,22,9,11,9,2,8,17,47.1,9,18,2,16,8,30,30,0,Matches,2023-2024,Premier-League
Gabriel Osho,ng NGA,DF,Luton Town,24.0,1998.0,20.5,41,22,21,19,1,16,27,59.3,11,37,20,17,31,72,92,0,Matches,2023-2024,Premier-League
William Osula,dk DEN,FW,Sheffield Utd,19.0,2003.0,8.7,2,2,1,0,1,1,2,50.0,1,3,1,2,2,4,9,0,Matches,2023-2024,Premier-League
Dango Ouattara,bf BFA,"FW,DF",Bournemouth,21.0,2002.0,13.7,45,27,22,11,12,19,34,55.9,15,18,3,15,22,67,35,0,Matches,2023-2024,Premier-League
David Ozoh,eng ENG,"MF,DF",Crystal Palace,18.0,2005.0,1.7,10,6,3,6,1,5,6,83.3,1,2,0,2,0,10,2,0,Matches,2023-2024,Premier-League
João Palhinha,pt POR,MF,Fulham,28.0,1995.0,30.0,152,75,80,60,12,103,152,67.8,49,57,9,48,46,198,58,0,Matches,2023-2024,Premier-League
Cole Palmer,eng ENG,"FW,MF",Chelsea,21.0,2002.0,29.0,23,12,9,6,8,8,19,42.1,11,20,2,18,20,43,13,2,Matches,2023-2024,Premier-League
Cole Palmer,eng ENG,MF,Manchester City,21.0,2002.0,0.1,0,0,0,0,0,0,0,,0,0,0,0,0,0,0,0,Matches,2023-2024,Premier-League
Emerson Palmieri,it ITA,DF,West Ham,28.0,1994.0,34.9,106,68,48,42,16,57,90,63.3,33,47,15,32,43,149,96,0,Matches,2023-2024,Premier-League
Lucas Paquetá,br BRA,"FW,MF",West Ham,25.0,1997.0,29.1,71,48,38,26,7,25,52,48.1,27,28,1,27,21,92,28,2,Matches,2023-2024,Premier-League
Ben Parkinson,eng ENG,FW,Newcastle Utd,18.0,2005.0,0.3,0,0,0,0,0,0,0,,0,1,0,1,0,0,1,0,Matches,2023-2024,Premier-League
Thomas Partey,gh GHA,"MF,DF",Arsenal,30.0,1993.0,8.8,14,11,9,4,1,5,10,50.0,5,9,3,6,11,25,9,0,Matches,2023-2024,Premier-League
Nathan Patterson,sct SCO,DF,Everton,21.0,2001.0,11.2,34,24,21,11,2,14,37,37.8,23,14,3,11,9,43,33,0,Matches,2023-2024,Premier-League
Myles Peart-Harris,eng ENG,"DF,MF",Brentford,20.0,2002.0,0.1,0,0,0,0,0,0,0,,0,0,0,0,0,0,1,0,Matches,2023-2024,Premier-League
Sydie Peck,eng ENG,MF,Sheffield Utd,18.0,2004.0,0.1,0,0,0,0,0,0,0,,0,0,0,0,0,0,0,0,Matches,2023-2024,Premier-League
Facundo Pellistri,uy URU,"FW,MF",Manchester Utd,21.0,2001.0,1.9,5,3,4,1,0,1,3,33.3,2,7,1,6,1,6,5,0,Matches,2023-2024,Premier-League
Andreas Pereira,br BRA,MF,Fulham,27.0,1996.0,29.0,25,12,4,12,9,11,41,26.8,30,16,2,14,4,29,12,0,Matches,2023-2024,Premier-League
Ivan Perišić,hr CRO,FW,Tottenham,34.0,1989.0,1.1,3,2,1,1,1,3,5,60.0,2,1,0,1,2,5,1,0,Matches,2023-2024,Premier-League
Đorđe Petrović,rs SRB,GK,Chelsea,23.0,1999.0,22.1,0,0,0,0,0,0,0,,0,0,0,0,0,0,12,3,Matches,2023-2024,Premier-League
Kalvin Phillips,eng ENG,MF,West Ham,27.0,1995.0,3.4,11,6,2,8,1,5,9,55.6,4,4,1,3,4,15,2,1,Matches,2023-2024,Premier-League
Kalvin Phillips,eng ENG,MF,Manchester City,27.0,1995.0,1.0,3,3,1,1,1,0,0,,0,0,0,0,2,5,2,0,Matches,2023-2024,Premier-League
Jaden Philogene Bidace,eng ENG,FW,Aston Villa,21.0,2002.0,0.0,0,0,0,0,0,0,0,,0,0,0,0,0,0,0,0,Matches,2023-2024,Premier-League
Jordan Pickford,eng ENG,GK,Everton,29.0,1994.0,38.0,1,0,1,0,0,1,1,100.0,0,3,0,3,0,1,19,1,Matches,2023-2024,Premier-League
Ethan Pinnock,jm JAM,DF,Brentford,30.0,1993.0,28.0,35,23,22,13,0,9,20,45.0,11,40,24,16,43,78,170,3,Matches,2023-2024,Premier-League
Nick Pope,eng ENG,GK,Newcastle Utd,31.0,1992.0,14.9,0,0,0,0,0,0,1,0.0,1,0,0,0,0,0,7,2,Matches,2023-2024,Premier-League
Pedro Porro,es ESP,DF,Tottenham,23.0,1999.0,34.3,91,63,43,34,14,62,120,51.7,58,63,18,45,34,125,102,3,Matches,2023-2024,Premier-League
Jarell Quansah,eng ENG,DF,Liverpool,20.0,2003.0,13.2,25,22,17,7,1,14,20,70.0,6,16,8,8,17,42,39,1,Matches,2023-2024,Premier-League
Ionuț Radu,ro ROU,GK,Bournemouth,26.0,1997.0,2.0,0,0,0,0,0,0,0,,0,0,0,0,0,0,0,0,Matches,2023-2024,Premier-League
Jesurun Rak Sakyi,eng ENG,"MF,FW",Crystal Palace,20.0,2002.0,1.5,4,1,3,1,0,2,3,66.7,1,2,0,2,3,7,1,0,Matches,2023-2024,Premier-League
Aaron Ramsdale,eng ENG,GK,Arsenal,25.0,1998.0,6.0,0,0,0,0,0,0,0,,0,0,0,0,0,0,3,2,Matches,2023-2024,Premier-League
Aaron Ramsey,eng ENG,"MF,FW",Burnley,20.0,2003.0,5.9,17,14,7,5,5,8,16,50.0,8,11,2,9,1,18,10,0,Matches,2023-2024,Premier-League
Jacob Ramsey,eng ENG,"FW,MF",Aston Villa,22.0,2001.0,9.5,16,8,7,6,3,5,15,33.3,10,15,2,13,3,19,8,0,Matches,2023-2024,Premier-League
Marcus Rashford,eng ENG,FW,Manchester Utd,25.0,1997.0,25.2,19,12,9,4,6,9,26,34.6,17,15,1,14,4,23,21,0,Matches,2023-2024,Premier-League
David Raya,es ESP,GK,Arsenal,27.0,1995.0,32.0,1,1,1,0,0,1,1,100.0,0,0,0,0,0,1,8,5,Matches,2023-2024,Premier-League
Tim Ream,us USA,DF,Fulham,35.0,1987.0,16.7,20,9,13,5,2,9,18,50.0,9,23,15,8,25,45,61,2,Matches,2023-2024,Premier-League
Nathan Redmond,eng ENG,"FW,MF",Burnley,29.0,1994.0,1.6,2,1,0,0,2,1,4,25.0,3,1,0,1,0,2,3,0,Matches,2023-2024,Premier-League
Harrison Reed,eng ENG,MF,Fulham,28.0,1995.0,14.7,29,18,9,17,3,13,31,41.9,18,19,9,10,11,40,24,0,Matches,2023-2024,Premier-League
Sergio Reguilón,es ESP,DF,Manchester Utd,26.0,1996.0,4.6,13,8,6,2,5,8,17,47.1,9,10,0,10,5,18,7,0,Matches,2023-2024,Premier-League
Sergio Reguilón,es ESP,DF,Brentford,26.0,1996.0,12.4,45,20,26,18,1,24,40,60.0,16,23,6,17,16,61,41,1,Matches,2023-2024,Premier-League
Gio Reyna,us USA,"FW,MF",Nott'ham Forest,20.0,2002.0,2.6,7,3,4,0,3,3,6,50.0,3,3,0,3,2,9,0,0,Matches,2023-2024,Premier-League
Rodrigo Ribeiro,pt POR,"MF,FW",Nott'ham Forest,18.0,2005.0,0.2,0,0,0,0,0,0,1,0.0,1,1,0,1,1,1,0,0,Matches,2023-2024,Premier-League
Declan Rice,eng ENG,MF,Arsenal,24.0,1999.0,35.8,83,51,37,38,8,32,57,56.1,25,37,11,26,44,127,52,0,Matches,2023-2024,Premier-League
Chris Richards,us USA,"DF,MF",Crystal Palace,23.0,2000.0,23.3,46,28,21,22,3,20,30,66.7,10,32,12,20,27,73,109,0,Matches,2023-2024,Premier-League
Richarlison,br BRA,FW,Tottenham,26.0,1997.0,16.6,16,11,4,8,4,2,10,20.0,8,32,6,26,8,24,23,0,Matches,2023-2024,Premier-League
Jaïro Riedewald,nl NED,"MF,FW",Crystal Palace,26.0,1996.0,2.6,9,3,2,4,3,3,6,50.0,3,0,0,0,2,11,2,0,Matches,2023-2024,Premier-League
Matt Ritchie,sct SCO,"FW,MF",Newcastle Utd,33.0,1989.0,1.4,5,3,2,2,1,2,4,50.0,2,3,2,1,1,6,5,0,Matches,2023-2024,Premier-League
Connor Roberts,wls WAL,DF,Burnley,27.0,1995.0,9.1,12,5,6,4,2,8,17,47.1,9,8,6,2,4,16,25,2,Matches,2023-2024,Premier-League
Andrew Robertson,sct SCO,DF,Liverpool,29.0,1994.0,18.8,35,24,21,11,3,26,43,60.5,17,20,6,14,13,48,40,0,Matches,2023-2024,Premier-League
Antonee Robinson,us USA,DF,Fulham,25.0,1997.0,36.3,93,58,60,26,7,52,110,47.3,58,56,8,48,80,173,117,3,Matches,2023-2024,Premier-League
Jack Robinson,eng ENG,DF,Sheffield Utd,29.0,1993.0,32.1,43,28,29,14,0,25,39,64.1,14,49,33,16,33,76,132,2,Matches,2023-2024,Premier-League
Rodri,es ESP,MF,Manchester City,27.0,1996.0,32.6,70,43,25,33,12,29,60,48.3,31,32,8,24,26,96,41,4,Matches,2023-2024,Premier-League
Jay Rodriguez,eng ENG,FW,Burnley,34.0,1989.0,9.1,14,9,7,4,3,7,13,53.8,6,11,1,10,1,15,8,0,Matches,2023-2024,Premier-League
Mads Roerslev,dk DEN,DF,Brentford,24.0,1999.0,22.1,48,31,34,9,5,27,54,50.0,27,15,3,12,19,67,71,0,Matches,2023-2024,Premier-League
Morgan Rogers,eng ENG,"MF,FW",Aston Villa,21.0,2002.0,7.1,8,1,3,2,3,2,11,18.2,9,11,0,11,3,11,11,0,Matches,2023-2024,Premier-League
Cristian Romero,ar ARG,DF,Tottenham,25.0,1998.0,31.0,66,40,35,25,6,32,44,72.7,12,46,22,24,44,110,106,1,Matches,2023-2024,Premier-League
Joe Rothwell,eng ENG,MF,Bournemouth,28.0,1995.0,4.3,7,2,4,2,1,2,8,25.0,6,4,2,2,3,10,2,0,Matches,2023-2024,Premier-League
Pelly Ruddock Mpanzu,cd COD,MF,Luton Town,30.0,1993.0,12.2,13,5,6,6,1,5,9,55.6,4,15,7,8,9,22,16,3,Matches,2023-2024,Premier-League
José Sá,pt POR,GK,Wolves,30.0,1993.0,33.7,0,0,0,0,0,0,1,0.0,1,3,0,3,0,0,21,5,Matches,2023-2024,Premier-League
Dominic Sadi,eng ENG,FW,Bournemouth,19.0,2003.0,0.0,0,0,0,0,0,0,0,,0,0,0,0,0,0,0,0,Matches,2023-2024,Premier-League
Bukayo Saka,eng ENG,FW,Arsenal,21.0,2001.0,32.4,66,35,22,24,20,26,59,44.1,33,43,2,41,15,81,24,1,Matches,2023-2024,Premier-League
Mohamed Salah,eg EGY,FW,Liverpool,31.0,1992.0,28.2,17,11,1,8,8,6,21,28.6,15,19,1,18,2,19,1,0,Matches,2023-2024,Premier-League
William Saliba,fr FRA,DF,Arsenal,22.0,2001.0,38.0,41,26,28,12,1,20,27,74.1,7,32,17,15,29,70,81,3,Matches,2023-2024,Premier-League
Albert Sambi Lokonga,be BEL,MF,Luton Town,23.0,1999.0,14.5,29,18,14,12,3,17,24,70.8,7,23,13,10,11,40,14,0,Matches,2023-2024,Premier-League
Davinson Sánchez,co COL,DF,Tottenham,27.0,1996.0,0.9,0,0,0,0,0,0,0,,0,3,2,1,1,1,2,0,Matches,2023-2024,Premier-League
Robert Sánchez,es ESP,GK,Chelsea,25.0,1997.0,15.9,0,0,0,0,0,0,0,,0,0,0,0,0,0,11,3,Matches,2023-2024,Premier-League
Jadon Sancho,eng ENG,"FW,MF",Manchester Utd,23.0,2000.0,0.9,1,0,1,0,0,1,3,33.3,2,1,0,1,1,2,0,0,Matches,2023-2024,Premier-League
Ibrahim Sangaré,ci CIV,MF,Nott'ham Forest,25.0,1997.0,11.5,42,23,25,13,4,12,29,41.4,17,24,7,17,16,58,21,0,Matches,2023-2024,Premier-League
Andrey Santos,br BRA,MF,Nott'ham Forest,19.0,2004.0,0.1,0,0,0,0,0,0,0,,0,1,0,1,0,0,0,0,Matches,2023-2024,Premier-League
Pablo Sarabia,es ESP,"MF,FW",Wolves,31.0,1992.0,19.4,20,13,8,8,4,12,36,33.3,24,17,1,16,10,30,9,0,Matches,2023-2024,Premier-League
Dane Scarlett,eng ENG,FW,Tottenham,19.0,2004.0,0.2,1,1,0,0,1,0,1,0.0,1,0,0,0,0,1,0,0,Matches,2023-2024,Premier-League
Kevin Schade,de GER,"FW,MF",Brentford,21.0,2001.0,3.7,3,1,1,2,0,0,5,0.0,5,2,0,2,1,4,4,0,Matches,2023-2024,Premier-League
Fabian Schär,ch SUI,DF,Newcastle Utd,31.0,1991.0,33.9,42,24,27,13,2,18,40,45.0,22,50,38,12,36,78,133,1,Matches,2023-2024,Premier-League
Jeffrey Schlupp,gh GHA,"FW,MF",Crystal Palace,30.0,1992.0,15.0,38,24,14,16,8,9,18,50.0,9,13,2,11,8,46,24,0,Matches,2023-2024,Premier-League
Alex Scott,eng ENG,MF,Bournemouth,19.0,2003.0,11.3,24,15,8,10,6,12,28,42.9,16,14,4,10,12,36,18,2,Matches,2023-2024,Premier-League
Matz Sels,be BEL,GK,Nott'ham Forest,31.0,1992.0,16.0,0,0,0,0,0,0,0,,0,0,0,0,0,0,11,1,Matches,2023-2024,Premier-League
Nélson Semedo,pt POR,"DF,MF",Wolves,29.0,1993.0,34.3,79,48,52,19,8,38,64,59.4,26,44,8,36,36,115,85,1,Matches,2023-2024,Premier-League
Antoine Semenyo,gh GHA,FW,Bournemouth,23.0,2000.0,23.4,24,17,7,9,8,9,27,33.3,18,39,2,37,6,30,21,0,Matches,2023-2024,Premier-League
Marcos Senesi,ar ARG,DF,Bournemouth,26.0,1997.0,24.9,55,32,28,23,4,24,56,42.9,32,50,23,27,35,90,109,1,Matches,2023-2024,Premier-League
Luke Shaw,eng ENG,DF,Manchester Utd,28.0,1995.0,10.7,11,8,7,3,1,9,15,60.0,6,18,11,7,6,17,39,0,Matches,2023-2024,Premier-League
James Shea,eng ENG,GK,Luton Town,32.0,1991.0,0.2,0,0,0,0,0,0,0,,0,0,0,0,0,0,2,0,Matches,2023-2024,Premier-League
Bernardo Silva,pt POR,"MF,FW",Manchester City,28.0,1994.0,28.6,51,23,13,25,13,25,57,43.9,32,32,4,28,17,68,15,1,Matches,2023-2024,Premier-League
Fábio Silva,pt POR,FW,Wolves,21.0,2002.0,2.9,7,4,3,4,0,2,3,66.7,1,1,0,1,2,9,0,0,Matches,2023-2024,Premier-League
Thiago Silva,br BRA,DF,Chelsea,38.0,1984.0,28.1,29,15,22,6,1,20,34,58.8,14,33,24,9,26,55,153,4,Matches,2023-2024,Premier-League
Luis Sinisterra,co COL,"FW,MF",Bournemouth,24.0,1999.0,7.8,23,12,9,10,4,9,16,56.3,7,18,0,18,8,31,4,0,Matches,2023-2024,Premier-League
Oliver Skipp,eng ENG,"MF,DF",Tottenham,22.0,2000.0,7.9,18,12,9,6,3,11,18,61.1,7,12,1,11,3,21,9,0,Matches,2023-2024,Premier-League
Adam Smith,eng ENG,DF,Bournemouth,32.0,1991.0,23.9,37,23,18,11,8,19,39,48.7,20,28,11,17,21,58,62,0,Matches,2023-2024,Premier-League
Emile Smith Rowe,eng ENG,MF,Arsenal,23.0,2000.0,3.9,4,1,2,2,0,2,4,50.0,2,3,1,2,3,7,1,0,Matches,2023-2024,Premier-League
Cédric Soares,pt POR,DF,Arsenal,31.0,1991.0,0.7,0,0,0,0,0,0,0,,0,0,0,0,0,0,0,0,Matches,2023-2024,Premier-League
Dominic Solanke,eng ENG,FW,Bournemouth,25.0,1997.0,36.9,23,11,3,13,7,10,29,34.5,19,24,5,19,7,30,43,0,Matches,2023-2024,Premier-League
Manor Solomon,il ISR,FW,Tottenham,24.0,1999.0,2.2,3,3,1,1,1,1,2,50.0,1,4,0,4,3,6,2,0,Matches,2023-2024,Premier-League
Tomáš Souček,cz CZE,MF,West Ham,28.0,1995.0,31.9,53,35,24,26,3,21,47,44.7,26,55,28,27,37,90,109,0,Matches,2023-2024,Premier-League
Vinicius Souza,br BRA,MF,Sheffield Utd,24.0,1999.0,29.6,125,76,59,51,15,41,74,55.4,33,57,17,40,32,157,75,1,Matches,2023-2024,Premier-League
Jason Steele,eng ENG,GK,Brighton,32.0,1990.0,17.0,0,0,0,0,0,0,3,0.0,3,0,0,0,0,0,8,1,Matches,2023-2024,Premier-League
Raheem Sterling,eng ENG,"FW,MF",Chelsea,28.0,1994.0,22.0,21,10,7,8,6,12,26,46.2,14,13,0,13,13,34,9,1,Matches,2023-2024,Premier-League
John Stones,eng ENG,"DF,MF",Manchester City,29.0,1994.0,11.8,2,1,1,0,1,0,3,0.0,3,11,7,4,10,12,21,0,Matches,2023-2024,Premier-League
Thomas Strakosha,al ALB,GK,Brentford,28.0,1995.0,1.5,0,0,0,0,0,0,0,,0,0,0,0,0,0,0,0,Matches,2023-2024,Premier-League
Dominik Szoboszlai,hu HUN,MF,Liverpool,22.0,2000.0,23.4,32,19,12,12,8,16,50,32.0,34,37,2,35,15,47,16,1,Matches,2023-2024,Premier-League
Matt Targett,eng ENG,DF,Newcastle Utd,27.0,1995.0,0.9,2,0,1,1,0,1,1,100.0,0,1,0,1,0,2,2,0,Matches,2023-2024,Premier-League
James Tarkowski,eng ENG,DF,Everton,30.0,1992.0,38.0,61,42,46,14,1,27,48,56.3,21,82,56,26,56,117,191,2,Matches,2023-2024,Premier-League
Jimi Tauriainen,eng ENG,FW,Chelsea,19.0,2004.0,0.0,0,0,0,0,0,0,0,,0,0,0,0,0,0,0,0,Matches,2023-2024,Premier-League
Nuno Tavares,pt POR,DF,Nott'ham Forest,23.0,2000.0,5.1,11,7,9,1,1,8,9,88.9,1,6,0,6,1,12,21,0,Matches,2023-2024,Premier-League
Marcus Tavernier,eng ENG,FW,Bournemouth,24.0,1999.0,23.5,53,34,25,22,6,26,48,54.2,22,31,3,28,5,58,23,0,Matches,2023-2024,Premier-League
Charlie Taylor,eng ENG,DF,Burnley,29.0,1993.0,25.9,35,20,19,14,2,17,35,48.6,18,27,11,16,19,54,78,0,Matches,2023-2024,Premier-League
Kenny Tete,nl NED,DF,Fulham,27.0,1995.0,9.6,27,17,19,6,2,11,19,57.9,8,10,3,7,16,43,35,0,Matches,2023-2024,Premier-League
Luke Thomas,eng ENG,DF,Sheffield Utd,22.0,2001.0,10.2,20,9,13,6,1,8,14,57.1,6,23,5,18,10,30,27,0,Matches,2023-2024,Premier-League
Youri Tielemans,be BEL,"MF,FW",Aston Villa,26.0,1997.0,18.0,41,20,17,18,6,16,40,40.0,24,23,3,20,15,56,9,0,Matches,2023-2024,Premier-League
Jurriën Timber,nl NED,DF,Arsenal,22.0,2001.0,0.8,2,2,1,1,0,0,0,,0,1,0,1,0,2,1,0,Matches,2023-2024,Premier-League
Harry Toffolo,eng ENG,DF,Nott'ham Forest,27.0,1995.0,16.2,26,14,20,6,0,15,24,62.5,9,34,13,21,14,40,49,0,Matches,2023-2024,Premier-League
Takehiro Tomiyasu,jp JPN,DF,Arsenal,24.0,1998.0,12.8,20,9,15,4,1,11,18,61.1,7,10,4,6,18,38,33,0,Matches,2023-2024,Premier-League
James Tomkins,eng ENG,DF,Crystal Palace,34.0,1989.0,0.1,0,0,0,0,0,0,0,,0,0,0,0,1,1,0,0,Matches,2023-2024,Premier-League
Sandro Tonali,it ITA,MF,Newcastle Utd,23.0,2000.0,4.9,7,7,4,2,1,3,9,33.3,6,3,0,3,2,9,4,0,Matches,2023-2024,Premier-League
Ivan Toney,eng ENG,FW,Brentford,27.0,1996.0,16.1,15,5,2,7,6,6,14,42.9,8,5,1,4,10,25,18,0,Matches,2023-2024,Premier-League
Pau Torres,es ESP,DF,Aston Villa,26.0,1997.0,27.4,29,18,17,11,1,14,30,46.7,16,28,12,16,14,43,75,0,Matches,2023-2024,Premier-League
Andros Townsend,eng ENG,"MF,FW",Luton Town,32.0,1991.0,13.4,21,13,11,2,8,13,27,48.1,14,12,0,12,5,26,10,0,Matches,2023-2024,Premier-League
James Trafford,eng ENG,GK,Burnley,20.0,2002.0,28.0,2,1,2,0,0,2,2,100.0,0,0,0,0,1,3,18,1,Matches,2023-2024,Premier-League
Adama Traoré,es ESP,"FW,MF",Fulham,27.0,1996.0,4.2,4,3,1,2,1,3,6,50.0,3,2,0,2,1,5,2,0,Matches,2023-2024,Premier-League
Bénie Traoré,ci CIV,"FW,MF",Sheffield Utd,20.0,2002.0,4.3,4,2,1,2,1,0,4,0.0,4,4,1,3,1,5,1,0,Matches,2023-2024,Premier-League
Bertrand Traoré,bf BFA,"DF,FW",Aston Villa,27.0,1995.0,0.1,1,1,1,0,0,0,0,,0,0,0,0,0,1,1,0,Matches,2023-2024,Premier-League
Boubacar Traoré,ml MLI,MF,Wolves,21.0,2001.0,9.1,35,23,16,17,2,9,21,42.9,12,12,2,10,5,40,7,0,Matches,2023-2024,Premier-League
Mark Travers,ie IRL,GK,Bournemouth,24.0,1999.0,4.0,0,0,0,0,0,0,0,,0,0,0,0,0,0,2,0,Matches,2023-2024,Premier-League
Mike Trésor,be BEL,"FW,MF",Burnley,24.0,1999.0,4.7,10,6,9,1,0,8,18,44.4,10,5,0,5,1,11,1,0,Matches,2023-2024,Premier-League
Kieran Trippier,eng ENG,DF,Newcastle Utd,32.0,1990.0,24.8,57,27,30,16,11,37,77,48.1,40,41,8,33,24,81,57,3,Matches,2023-2024,Premier-League
Leandro Trossard,be BEL,"FW,MF",Arsenal,28.0,1994.0,18.3,27,16,8,9,10,9,25,36.0,16,27,1,26,8,35,6,0,Matches,2023-2024,Premier-League
Auston Trusty,us USA,DF,Sheffield Utd,24.0,1998.0,28.6,47,30,31,13,3,21,43,48.8,22,41,22,19,35,82,153,3,Matches,2023-2024,Premier-League
Kostas Tsimikas,gr GRE,DF,Liverpool,27.0,1996.0,7.5,19,13,9,6,4,9,15,60.0,6,9,1,8,6,25,10,0,Matches,2023-2024,Premier-League
Matt Turner,us USA,GK,Nott'ham Forest,29.0,1994.0,17.0,0,0,0,0,0,0,0,,0,0,0,0,0,0,8,4,Matches,2023-2024,Premier-League
Destiny Udogie,it ITA,DF,Tottenham,20.0,2002.0,26.6,68,33,41,16,11,27,49,55.1,22,27,8,19,37,105,80,5,Matches,2023-2024,Premier-League
Lesley Ugochukwu,fr FRA,MF,Chelsea,19.0,2004.0,3.3,14,10,4,8,2,4,10,40.0,6,6,2,4,1,15,5,0,Matches,2023-2024,Premier-League
Enes Ünal,tr TUR,"FW,MF",Bournemouth,26.0,1997.0,3.6,6,4,2,3,1,2,5,40.0,3,4,2,2,1,7,6,0,Matches,2023-2024,Premier-League
Virgil van Dijk,nl NED,DF,Liverpool,32.0,1991.0,35.3,40,23,24,13,3,12,14,85.7,2,47,34,13,39,79,144,0,Matches,2023-2024,Premier-League
Raphaël Varane,fr FRA,DF,Manchester Utd,30.0,1993.0,15.3,18,11,10,7,1,10,14,71.4,4,23,18,5,15,33,88,0,Matches,2023-2024,Premier-League
Alejo Véliz,ar ARG,FW,Tottenham,19.0,2003.0,0.6,1,0,1,0,0,0,0,,0,0,0,0,0,1,0,0,Matches,2023-2024,Premier-League
Joël Veltman,nl NED,DF,Brighton,31.0,1992.0,17.6,54,41,32,17,5,39,58,67.2,19,17,7,10,18,72,57,1,Matches,2023-2024,Premier-League
Micky van de Ven,nl NED,DF,Tottenham,22.0,2001.0,26.0,49,35,34,12,3,24,33,72.7,9,25,15,10,18,67,78,1,Matches,2023-2024,Premier-League
Bart Verbruggen,nl NED,GK,Brighton,20.0,2002.0,21.0,1,1,1,0,0,1,2,50.0,1,0,0,0,0,1,11,3,Matches,2023-2024,Premier-League
Guglielmo Vicario,it ITA,GK,Tottenham,26.0,1996.0,38.0,0,0,0,0,0,0,1,0.0,1,0,0,0,1,1,31,2,Matches,2023-2024,Premier-League
Fabio Vieira,pt POR,"MF,FW",Arsenal,23.0,2000.0,3.3,3,2,2,0,1,3,3,100.0,0,0,0,0,2,5,2,0,Matches,2023-2024,Premier-League
Carlos Vinícius,br BRA,FW,Fulham,28.0,1995.0,3.5,3,2,0,1,2,0,4,0.0,4,4,0,4,0,3,1,0,Matches,2023-2024,Premier-League
Vitinho,br BRA,"DF,MF",Burnley,24.0,1999.0,25.7,64,34,36,22,6,43,86,50.0,43,44,6,38,12,76,47,4,Matches,2023-2024,Premier-League
Odisseas Vlachodimos,gr GRE,GK,Nott'ham Forest,29.0,1994.0,5.0,0,0,0,0,0,0,1,0.0,1,0,0,0,0,0,1,0,Matches,2023-2024,Premier-League
Kyle Walker,eng ENG,DF,Manchester City,33.0,1990.0,30.7,38,24,19,17,2,19,39,48.7,20,19,6,13,27,65,40,1,Matches,2023-2024,Premier-League
Aaron Wan-Bissaka,eng ENG,DF,Manchester Utd,25.0,1997.0,19.8,42,25,18,20,4,19,26,73.1,7,29,15,14,41,83,68,1,Matches,2023-2024,Premier-League
Joel Ward,eng ENG,DF,Crystal Palace,33.0,1989.0,22.0,45,28,26,18,1,30,47,63.8,17,17,10,7,14,59,94,1,Matches,2023-2024,Premier-League
James Ward-Prowse,eng ENG,MF,West Ham,28.0,1994.0,33.3,45,29,14,23,8,18,44,40.9,26,31,9,22,38,83,49,0,Matches,2023-2024,Premier-League
Lewis Warrington,eng ENG,FW,Everton,20.0,2002.0,0.0,0,0,0,0,0,0,0,,0,0,0,0,0,0,0,0,Matches,2023-2024,Premier-League
Deivid Washington,br BRA,"DF,FW",Chelsea,18.0,2005.0,0.1,1,1,1,0,0,0,1,0.0,1,0,0,0,0,1,0,0,Matches,2023-2024,Premier-League
Ollie Watkins,eng ENG,FW,Aston Villa,27.0,1995.0,35.7,12,7,0,5,7,5,11,45.5,6,26,4,22,4,16,20,0,Matches,2023-2024,Premier-League
Adam Webster,eng ENG,DF,Brighton,28.0,1995.0,12.7,14,12,8,5,1,6,18,33.3,12,16,12,4,16,30,43,1,Matches,2023-2024,Premier-League
Danny Welbeck,eng ENG,"FW,MF",Brighton,32.0,1990.0,18.8,35,17,9,17,9,10,17,58.8,7,12,0,12,9,44,17,1,Matches,2023-2024,Premier-League
Timo Werner,de GER,FW,Tottenham,27.0,1996.0,9.0,7,4,3,4,0,5,18,27.8,13,12,0,12,3,10,2,0,Matches,2023-2024,Premier-League
Adam Wharton,eng ENG,MF,Crystal Palace,19.0,2004.0,14.4,48,32,18,22,8,23,46,50.0,23,17,3,14,20,68,24,1,Matches,2023-2024,Premier-League
Ethan Wheatley,eng ENG,FW,Manchester Utd,17.0,2006.0,0.2,1,1,0,1,0,1,1,100.0,0,2,0,2,2,3,0,0,Matches,2023-2024,Premier-League
Ben White,eng ENG,DF,Arsenal,25.0,1997.0,33.2,48,28,20,22,6,26,58,44.8,32,48,22,26,32,80,77,1,Matches,2023-2024,Premier-League
Joe White,eng ENG,MF,Newcastle Utd,20.0,2002.0,0.1,1,1,1,0,0,0,0,,0,0,0,0,0,1,0,0,Matches,2023-2024,Premier-League
Neco Williams,wls WAL,DF,Nott'ham Forest,22.0,2001.0,18.2,69,40,42,18,9,35,56,62.5,21,44,13,31,22,91,53,0,Matches,2023-2024,Premier-League
Willian,br BRA,FW,Fulham,34.0,1988.0,22.8,18,11,6,7,5,3,21,14.3,18,13,0,13,9,27,12,1,Matches,2023-2024,Premier-League
Joe Willock,eng ENG,MF,Newcastle Utd,23.0,1999.0,4.7,13,7,7,6,0,4,11,36.4,7,7,0,7,1,14,1,0,Matches,2023-2024,Premier-League
Callum Wilson,eng ENG,FW,Newcastle Utd,31.0,1992.0,11.0,5,3,0,2,3,0,4,0.0,4,6,0,6,2,7,4,0,Matches,2023-2024,Premier-League
Harry Wilson,wls WAL,FW,Fulham,26.0,1997.0,18.0,21,14,9,8,4,11,28,39.3,17,27,3,24,10,31,12,0,Matches,2023-2024,Premier-League
Yoane Wissa,cd COD,FW,Brentford,26.0,1996.0,27.7,28,16,13,10,5,5,20,25.0,15,24,3,21,9,37,15,0,Matches,2023-2024,Premier-League
Chris Wood,nz NZL,FW,Nott'ham Forest,31.0,1991.0,20.1,7,4,1,4,2,3,9,33.3,6,11,3,8,1,8,26,0,Matches,2023-2024,Premier-League
Cauley Woodrow,eng ENG,"FW,MF",Luton Town,28.0,1994.0,4.7,16,10,8,4,4,9,16,56.3,7,7,1,6,1,17,14,0,Matches,2023-2024,Premier-League
Joe Worrall,eng ENG,DF,Nott'ham Forest,26.0,1997.0,4.9,7,5,6,1,0,3,6,50.0,3,5,4,1,3,10,32,1,Matches,2023-2024,Premier-League
Yehor Yarmoliuk,ua UKR,MF,Brentford,19.0,2004.0,7.6,17,11,6,8,3,7,17,41.2,10,17,4,13,6,23,5,0,Matches,2023-2024,Premier-League
Ryan Yates,eng ENG,MF,Nott'ham Forest,25.0,1997.0,22.1,66,40,39,21,6,20,36,55.6,16,42,15,27,21,87,44,1,Matches,2023-2024,Premier-League
Ashley Young,eng ENG,"DF,MF",Everton,38.0,1985.0,25.3,53,38,28,19,6,30,54,55.6,24,24,6,18,22,75,50,3,Matches,2023-2024,Premier-League
Illia Zabarnyi,ua UKR,DF,Bournemouth,20.0,2002.0,37.0,59,32,29,29,1,23,50,46.0,27,53,34,19,33,92,143,4,Matches,2023-2024,Premier-League
Nicolò Zaniolo,it ITA,"FW,MF",Aston Villa,24.0,1999.0,9.3,19,9,10,7,2,9,17,52.9,8,13,0,13,1,20,11,0,Matches,2023-2024,Premier-League
Anass Zaroury,ma MAR,"FW,MF",Burnley,22.0,2000.0,1.7,1,0,1,0,0,0,4,0.0,4,2,0,2,0,1,1,1,Matches,2023-2024,Premier-League
Oleksandr Zinchenko,ua UKR,DF,Arsenal,26.0,1996.0,19.1,50,30,19,24,7,35,52,67.3,17,18,3,15,20,70,26,2,Matches,2023-2024,Premier-League
Kurt Zouma,fr FRA,DF,West Ham,28.0,1994.0,31.5,23,17,14,9,0,10,16,62.5,6,38,28,10,29,52,160,0,Matches,2023-2024,Premier-League
Martin Ødegaard,no NOR,MF,Arsenal,24.0,1998.0,34.3,49,17,18,21,10,17,58,29.3,41,23,1,22,15,64,5,0,Matches,2023-2024,Premier-League
Sabit Abdulai,gh GHA,MF,Getafe,21.0,1999.0,0.7,2,0,1,1,0,1,3,33.3,2,0,0,0,0,2,0,0,Matches,2020-2021,La-Liga
Marcos Acuña,ar ARG,DF,Sevilla,28.0,1991.0,25.9,62,42,34,20,8,23,41,56.1,18,23,2,21,23,85,30,1,Matches,2020-2021,La-Liga
Bobby Adekanye,nl NED,"FW,MF",Cádiz,21.0,1999.0,0.4,0,0,0,0,0,0,1,0.0,1,0,0,0,0,0,1,0,Matches,2020-2021,La-Liga
Martin Agirregabiria,es ESP,"DF,MF",Alavés,24.0,1996.0,17.3,32,18,17,12,3,17,33,51.5,16,9,3,6,27,59,36,0,Matches,2020-2021,La-Liga
Joseph Aidoo,gh GHA,DF,Celta Vigo,24.0,1995.0,14.3,26,17,17,9,0,12,21,57.1,9,7,4,3,25,51,88,1,Matches,2020-2021,La-Liga
Carlos Akapo,gq EQG,DF,Cádiz,27.0,1993.0,9.6,18,14,14,4,0,10,18,55.6,8,16,3,13,19,37,33,0,Matches,2020-2021,La-Liga
Paul Akouokou,ci CIV,MF,Betis,22.0,1997.0,4.2,11,8,2,8,1,5,8,62.5,3,3,1,2,6,17,7,0,Matches,2020-2021,La-Liga
Jony Álamo,es ESP,MF,Elche,18.0,2001.0,0.8,2,1,1,0,1,0,1,0.0,1,0,0,0,1,3,0,0,Matches,2020-2021,La-Liga
Jordi Alba,es ESP,"DF,FW",Barcelona,31.0,1989.0,33.6,45,30,22,16,7,24,52,46.2,28,21,2,19,49,94,48,0,Matches,2020-2021,La-Liga
Raúl Albiol,es ESP,DF,Villarreal,34.0,1985.0,34.6,22,15,19,3,0,13,18,72.2,5,32,22,10,22,44,146,2,Matches,2020-2021,La-Liga
Paco Alcácer,es ESP,FW,Villarreal,26.0,1993.0,17.2,6,3,1,2,3,3,7,42.9,4,8,0,8,9,15,6,0,Matches,2020-2021,La-Liga
Pedro Alcalá,es ESP,DF,Cádiz,31.0,1989.0,10.1,8,4,6,2,0,3,5,60.0,2,19,13,6,16,24,50,0,Matches,2020-2021,La-Liga
Rubén Alcaraz,es ESP,MF,Valladolid,29.0,1991.0,24.1,54,29,32,21,1,30,80,37.5,50,35,8,27,31,85,28,0,Matches,2020-2021,La-Liga
Iván Alejo,es ESP,"MF,FW",Cádiz,25.0,1995.0,9.2,14,10,8,4,2,4,23,17.4,19,14,1,13,3,17,10,0,Matches,2020-2021,La-Liga
Carles Aleñá,es ESP,MF,Barcelona,22.0,1998.0,0.5,1,0,1,0,0,0,0,,0,0,0,0,0,1,0,0,Matches,2020-2021,La-Liga
Carles Aleñá,es ESP,"MF,FW",Getafe,22.0,1998.0,15.2,15,10,3,9,3,7,25,28.0,18,14,1,13,2,17,2,0,Matches,2020-2021,La-Liga
Alfon,es ESP,MF,Celta Vigo,21.0,1999.0,0.4,0,0,0,0,0,0,0,,0,0,0,0,0,0,0,0,Matches,2020-2021,La-Liga
Sergio Álvarez,es ESP,"MF,DF",Eibar,28.0,1992.0,17.4,42,25,13,26,3,8,22,36.4,14,22,5,17,22,64,24,2,Matches,2020-2021,La-Liga
Yeray Álvarez,es ESP,DF,Athletic Club,25.0,1995.0,21.6,19,12,11,8,0,9,21,42.9,12,12,5,7,53,72,73,0,Matches,2020-2021,La-Liga
Emmanuel Amankwaa Akurugu,gh GHA,DF,Getafe,18.0,2001.0,0.5,0,0,0,0,0,0,1,0.0,1,1,0,1,2,2,1,0,Matches,2020-2021,La-Liga
Jon Ander Garrido,es ESP,MF,Cádiz,30.0,1989.0,8.9,18,10,8,7,3,10,26,38.5,16,12,4,8,14,32,13,0,Matches,2020-2021,La-Liga
Marcos André,br BRA,FW,Valladolid,23.0,1996.0,13.1,8,2,2,2,4,0,8,0.0,8,15,2,13,2,10,9,0,Matches,2020-2021,La-Liga
Ángel,es ESP,GK,Granada,18.0,2002.0,1.0,0,0,0,0,0,0,0,,0,0,0,0,0,0,1,0,Matches,2020-2021,La-Liga
José Ángel,es ESP,DF,Eibar,30.0,1989.0,10.0,15,8,9,4,2,8,12,66.7,4,7,0,7,13,28,17,1,Matches,2020-2021,La-Liga
Miguel Ángel Rubio,es ESP,DF,Valladolid,22.0,1998.0,1.5,0,0,0,0,0,0,0,,0,2,2,0,3,3,11,0,Matches,2020-2021,La-Liga
José Antonio Miranda,gq EQG,"MF,DF",Getafe,22.0,1998.0,0.3,0,0,0,0,0,0,1,0.0,1,1,0,1,0,0,0,0,Matches,2020-2021,La-Liga
Aritz Arambarri,es ESP,DF,Real Sociedad,22.0,1998.0,0.3,1,1,0,1,0,1,2,50.0,1,0,0,0,0,1,0,0,Matches,2020-2021,La-Liga
Mauro Arambarri,uy URU,MF,Getafe,24.0,1995.0,33.1,64,39,22,35,7,23,80,28.8,57,40,5,35,42,106,28,0,Matches,2020-2021,La-Liga
Néstor Araujo,mx MEX,DF,Celta Vigo,28.0,1991.0,27.0,24,16,14,9,1,7,15,46.7,8,23,18,5,43,67,89,2,Matches,2020-2021,La-Liga
Ronald Araújo,uy URU,DF,Barcelona,21.0,1999.0,16.8,22,11,12,8,2,9,9,100.0,0,24,15,9,20,42,47,1,Matches,2020-2021,La-Liga
Anaitz Arbilla,es ESP,DF,Eibar,33.0,1987.0,31.2,45,26,31,11,3,27,54,50.0,27,36,11,25,69,114,73,1,Matches,2020-2021,La-Liga
Unai Arietaleanizbeaskoa,es ESP,"FW,MF",Eibar,21.0,1999.0,0.5,1,0,0,0,1,0,0,,0,0,0,0,0,1,0,0,Matches,2020-2021,La-Liga
Sergio Arribas,es ESP,"MF,FW",Real Madrid,18.0,2001.0,1.5,3,1,2,1,0,1,3,33.3,2,2,0,2,4,7,2,0,Matches,2020-2021,La-Liga
Sergio Asenjo,es ESP,GK,Villarreal,31.0,1989.0,36.0,0,0,0,0,0,0,1,0.0,1,0,0,0,0,0,13,2,Matches,2020-2021,La-Liga
Marco Asensio,es ESP,"FW,MF",Real Madrid,24.0,1996.0,20.8,12,6,7,4,1,3,24,12.5,21,15,0,15,11,23,10,0,Matches,2020-2021,La-Liga
Iago Aspas,es ESP,FW,Celta Vigo,32.0,1987.0,31.8,11,3,2,7,2,2,23,8.7,21,25,2,23,16,27,21,0,Matches,2020-2021,La-Liga
Miguel Atienza,es ESP,MF,Eibar,21.0,1999.0,9.3,20,9,5,15,0,8,23,34.8,15,14,1,13,9,29,12,0,Matches,2020-2021,La-Liga
Ezequiel Ávila,ar ARG,"FW,MF",Osasuna,26.0,1994.0,2.2,6,2,3,1,2,2,4,50.0,2,1,0,1,1,7,0,0,Matches,2020-2021,La-Liga
Ramon Azeez,ng NGA,MF,Granada,27.0,1992.0,1.1,1,1,0,1,0,0,0,,0,0,0,0,1,2,1,0,Matches,2020-2021,La-Liga
Carlos Bacca,co COL,FW,Villarreal,33.0,1986.0,8.7,9,5,5,3,1,3,5,60.0,2,5,0,5,3,12,2,0,Matches,2020-2021,La-Liga
Édgar Badía,es ESP,GK,Elche,28.0,1992.0,30.0,1,0,1,0,0,1,3,33.3,2,0,0,0,0,1,17,3,Matches,2020-2021,La-Liga
Alex Baena,es ESP,MF,Villarreal,19.0,2001.0,1.5,4,3,1,2,1,1,3,33.3,2,1,1,0,1,5,1,0,Matches,2020-2021,La-Liga
Miguel Baeza,es ESP,"MF,FW",Celta Vigo,20.0,2000.0,6.0,7,6,5,2,0,5,13,38.5,8,3,0,3,3,10,2,0,Matches,2020-2021,La-Liga
Mikel Balenziaga,es ESP,DF,Athletic Club,32.0,1988.0,18.8,26,15,11,12,3,9,18,50.0,9,22,7,15,7,33,46,0,Matches,2020-2021,La-Liga
Barcia,es ESP,DF,Granada,19.0,2000.0,1.0,1,1,1,0,0,0,0,,0,1,1,0,3,4,9,0,Matches,2020-2021,La-Liga
Enis Bardhi,mk MKD,MF,Levante,25.0,1995.0,18.7,28,12,8,16,4,10,36,27.8,26,8,2,6,21,49,14,0,Matches,2020-2021,La-Liga
Kike Barja,es ESP,"MF,FW",Osasuna,23.0,1997.0,15.9,10,5,6,1,3,5,24,20.8,19,10,1,9,16,26,8,0,Matches,2020-2021,La-Liga
Marc Baró,es ESP,DF,Cádiz,20.0,1999.0,1.0,2,1,2,0,0,0,2,0.0,2,1,0,1,2,4,2,1,Matches,2020-2021,La-Liga
Antonio Barragán,es ESP,DF,Elche,33.0,1987.0,24.8,28,14,21,5,2,12,21,57.1,9,22,8,14,33,61,67,1,Matches,2020-2021,La-Liga
Ander Barrenetxea,es ESP,"MF,FW",Real Sociedad,18.0,2001.0,14.5,29,19,5,18,6,9,24,37.5,15,20,0,20,6,35,8,0,Matches,2020-2021,La-Liga
Marc Bartra,es ESP,DF,Betis,29.0,1991.0,18.8,27,16,18,8,1,12,22,54.5,10,19,5,14,40,67,74,3,Matches,2020-2021,La-Liga
Álvaro Bastida,es ESP,MF,Cádiz,16.0,2004.0,0.4,0,0,0,0,0,0,0,,0,0,0,0,0,0,0,0,Matches,2020-2021,La-Liga
Rodrigo Battaglia,ar ARG,MF,Alavés,29.0,1991.0,27.7,38,16,21,14,3,16,50,32.0,34,30,14,16,29,67,40,1,Matches,2020-2021,La-Liga
Jon Bautista,es ESP,FW,Real Sociedad,25.0,1995.0,4.1,5,3,0,2,3,0,3,0.0,3,3,1,2,2,7,4,0,Matches,2020-2021,La-Liga
Fran Beltrán,es ESP,"MF,FW",Celta Vigo,21.0,1999.0,15.5,30,22,15,12,3,8,24,33.3,16,14,1,13,16,46,24,0,Matches,2020-2021,La-Liga
Sergio Benito,es ESP,FW,Valladolid,21.0,1999.0,0.0,0,0,0,0,0,0,0,,0,0,0,0,0,0,0,0,Matches,2020-2021,La-Liga
Karim Benzema,fr FRA,FW,Real Madrid,32.0,1987.0,32.2,8,6,4,2,2,5,15,33.3,10,9,2,7,8,16,24,0,Matches,2020-2021,La-Liga
Yuri Berchiche,es ESP,DF,Athletic Club,30.0,1990.0,18.7,24,19,14,5,5,10,24,41.7,14,14,0,14,11,35,29,0,Matches,2020-2021,La-Liga
Álex Berenguer,es ESP,"MF,FW",Athletic Club,25.0,1995.0,25.3,47,31,21,20,6,9,51,17.6,42,48,3,45,18,65,27,0,Matches,2020-2021,La-Liga
Pedro Bigas,es ESP,DF,Eibar,29.0,1990.0,17.0,11,9,7,4,0,7,14,50.0,7,12,6,6,23,34,54,0,Matches,2020-2021,La-Liga
Alejandro Blanco,es ESP,MF,Valencia,21.0,1998.0,6.4,8,4,4,4,0,3,18,16.7,15,5,0,5,8,16,9,0,Matches,2020-2021,La-Liga
Antonio Blanco,es ESP,"MF,FW",Real Madrid,20.0,2000.0,2.4,7,2,4,2,1,3,7,42.9,4,6,2,4,3,10,5,0,Matches,2020-2021,La-Liga
Rubén Blanco,es ESP,GK,Celta Vigo,25.0,1995.0,18.2,0,0,0,0,0,0,0,,0,0,0,0,0,0,7,3,Matches,2020-2021,La-Liga
Alejandro Blesa,es ESP,MF,Levante,18.0,2002.0,0.1,0,0,0,0,0,0,0,,0,0,0,0,0,0,0,0,Matches,2020-2021,La-Liga
Yann Bodiger,fr FRA,MF,Cádiz,25.0,1995.0,2.8,2,2,1,1,0,1,6,16.7,5,7,3,4,8,10,4,0,Matches,2020-2021,La-Liga
Yassine Bounou,ma MAR,GK,Sevilla,29.0,1991.0,33.0,1,1,1,0,0,0,2,0.0,2,0,0,0,0,1,12,2,Matches,2020-2021,La-Liga
Lucas Boyé,ar ARG,FW,Elche,24.0,1996.0,29.9,47,31,13,27,7,10,49,20.4,39,37,2,35,19,66,21,0,Matches,2020-2021,La-Liga
Martin Braithwaite,dk DEN,FW,Barcelona,29.0,1991.0,13.1,8,4,2,3,3,1,6,16.7,5,2,0,2,6,14,7,0,Matches,2020-2021,La-Liga
Darko Brašanac,rs SRB,MF,Osasuna,28.0,1992.0,10.1,10,6,6,4,0,5,16,31.3,11,8,1,7,7,17,10,0,Matches,2020-2021,La-Liga
Álvaro Bravo,es ESP,MF,Granada,22.0,1998.0,0.2,1,1,1,0,0,1,2,50.0,1,0,0,0,1,2,0,0,Matches,2020-2021,La-Liga
Claudio Bravo,cl CHI,GK,Betis,37.0,1983.0,20.0,0,0,0,0,0,0,1,0.0,1,0,0,0,0,0,11,0,Matches,2020-2021,La-Liga
Yan Brice Eteki,cm CMR,MF,Granada,22.0,1997.0,14.7,23,15,10,12,1,8,19,42.1,11,13,3,10,13,36,16,1,Matches,2020-2021,La-Liga
Juan Brunet,ar ARG,MF,Granada,22.0,1998.0,0.3,0,0,0,0,0,0,0,,0,0,0,0,0,0,1,0,Matches,2020-2021,La-Liga
Ante Budimir,hr CRO,FW,Osasuna,29.0,1991.0,18.1,20,12,2,11,7,4,15,26.7,11,17,4,13,2,22,17,1,Matches,2020-2021,La-Liga
Esteban Burgos,ar ARG,DF,Eibar,28.0,1992.0,12.3,7,6,4,3,0,1,5,20.0,4,8,7,1,23,30,54,2,Matches,2020-2021,La-Liga
Burgui,es ESP,MF,Alavés,26.0,1993.0,0.2,3,1,2,1,0,1,1,100.0,0,0,0,0,0,3,0,0,Matches,2020-2021,La-Liga
Sergio Busquets,es ESP,MF,Barcelona,32.0,1988.0,28.0,63,35,21,29,13,27,76,35.5,49,27,4,23,53,116,18,2,Matches,2020-2021,La-Liga
Erick Cabaco,uy URU,DF,Getafe,25.0,1995.0,14.7,24,14,11,12,1,12,22,54.5,10,8,6,2,13,37,51,1,Matches,2020-2021,La-Liga
Cala,es ESP,DF,Cádiz,30.0,1989.0,25.2,21,12,15,6,0,11,21,52.4,10,18,8,10,35,56,91,0,Matches,2020-2021,La-Liga
Jonathan Calleri,ar ARG,FW,Osasuna,26.0,1993.0,17.2,15,6,2,4,9,3,17,17.6,14,18,2,16,1,16,10,1,Matches,2020-2021,La-Liga
Dani Calvo,es ESP,DF,Elche,26.0,1994.0,19.8,20,13,13,7,0,7,10,70.0,3,18,12,6,11,31,71,0,Matches,2020-2021,La-Liga
José Campaña,es ESP,MF,Levante,27.0,1993.0,8.3,14,6,3,6,5,5,14,35.7,9,2,0,2,13,27,4,0,Matches,2020-2021,La-Liga
Sergio Canales,es ESP,"MF,FW",Betis,29.0,1991.0,27.8,16,9,9,6,1,3,21,14.3,18,18,0,18,13,29,5,0,Matches,2020-2021,La-Liga
Álex Cantero,es ESP,FW,Levante,20.0,2000.0,2.6,2,1,0,2,0,1,2,50.0,1,1,0,1,0,2,3,0,Matches,2020-2021,La-Liga
Ander Capa,es ESP,DF,Athletic Club,28.0,1992.0,23.7,37,18,22,13,2,18,37,48.6,19,21,8,13,25,62,57,0,Matches,2020-2021,La-Liga
Étienne Capoue,fr FRA,MF,Villarreal,32.0,1988.0,13.2,20,10,14,6,0,8,18,44.4,10,7,1,6,20,40,23,0,Matches,2020-2021,La-Liga
Isaac Carcelen,es ESP,DF,Cádiz,27.0,1993.0,28.7,68,43,36,25,7,33,60,55.0,27,37,12,25,49,117,89,0,Matches,2020-2021,La-Liga
Cárdenas,es ESP,GK,Levante,23.0,1997.0,8.0,0,0,0,0,0,0,1,0.0,1,0,0,0,3,3,5,1,Matches,2020-2021,La-Liga
Marc Cardona,es ESP,"FW,DF",Osasuna,25.0,1995.0,0.6,1,0,1,0,0,1,1,100.0,0,0,0,0,0,1,0,0,Matches,2020-2021,La-Liga
Diego Carlos,br BRA,DF,Sevilla,27.0,1993.0,31.0,22,13,17,4,1,8,16,50.0,8,35,27,8,31,53,114,1,Matches,2020-2021,La-Liga
Juan Carlos,es ESP,"MF,FW",Huesca,29.0,1991.0,3.2,5,3,4,1,0,2,15,13.3,13,7,0,7,1,6,1,0,Matches,2020-2021,La-Liga
Yannick Carrasco,be BEL,"DF,MF",Atlético Madrid,26.0,1993.0,24.2,27,15,14,6,7,15,34,44.1,19,24,0,24,17,44,16,1,Matches,2020-2021,La-Liga
Sergio Carreira,es ESP,DF,Celta Vigo,19.0,2000.0,2.9,3,0,2,1,0,1,1,100.0,0,2,0,2,1,4,7,0,Matches,2020-2021,La-Liga
Guido Carrillo,ar ARG,FW,Elche,29.0,1991.0,11.1,9,8,1,7,1,2,8,25.0,6,2,1,1,4,13,14,0,Matches,2020-2021,La-Liga
Dani Carvajal,es ESP,DF,Real Madrid,28.0,1992.0,10.6,27,20,12,10,5,11,20,55.0,9,19,1,18,13,40,27,0,Matches,2020-2021,La-Liga
William Carvalho,pt POR,MF,Betis,28.0,1992.0,13.6,19,11,7,11,1,5,21,23.8,16,11,3,8,11,30,14,1,Matches,2020-2021,La-Liga
Casemiro,br BRA,MF,Real Madrid,28.0,1992.0,32.2,84,49,50,30,4,33,73,45.2,40,50,17,33,70,154,62,0,Matches,2020-2021,La-Liga
Sofian Chakla,ma MAR,DF,Villarreal,26.0,1993.0,0.1,0,0,0,0,0,0,0,,0,0,0,0,0,0,0,0,Matches,2020-2021,La-Liga
Sofian Chakla,ma MAR,DF,Getafe,26.0,1993.0,10.0,12,8,10,1,1,5,7,71.4,2,3,2,1,14,26,48,1,Matches,2020-2021,La-Liga
Chema,es ESP,"DF,MF",Getafe,28.0,1992.0,6.2,11,5,6,5,0,5,7,71.4,2,1,0,1,10,21,23,0,Matches,2020-2021,La-Liga
Denis Cheryshev,ru RUS,MF,Valencia,29.0,1990.0,12.2,19,15,6,7,6,6,26,23.1,20,15,1,14,12,31,15,0,Matches,2020-2021,La-Liga
Samuel Chukwueze,ng NGA,"MF,FW",Villarreal,21.0,1999.0,15.2,12,7,4,4,4,3,17,17.6,14,8,0,8,10,22,3,0,Matches,2020-2021,La-Liga
Víctor Chust,es ESP,DF,Real Madrid,20.0,2000.0,1.1,1,1,0,1,0,0,2,0.0,2,2,2,0,1,2,5,0,Matches,2020-2021,La-Liga
Cifu,es ESP,DF,Elche,29.0,1990.0,5.0,10,7,7,3,0,7,13,53.8,6,5,1,4,8,18,10,0,Matches,2020-2021,La-Liga
Alberto Cifuentes,es ESP,GK,Cádiz,41.0,1979.0,2.0,0,0,0,0,0,0,0,,0,0,0,0,0,0,0,0,Matches,2020-2021,La-Liga
Jasper Cillessen,nl NED,GK,Valencia,31.0,1989.0,10.0,0,0,0,0,0,0,0,,0,0,0,0,0,0,0,0,Matches,2020-2021,La-Liga
Carlos Clerc,es ESP,DF,Levante,28.0,1992.0,30.9,56,29,33,16,7,22,39,56.4,17,26,4,22,37,93,55,1,Matches,2020-2021,La-Liga
Coke,es ESP,DF,Levante,33.0,1987.0,9.3,24,10,14,7,3,14,27,51.9,13,13,1,12,14,38,27,0,Matches,2020-2021,La-Liga
Francis Coquelin,fr FRA,MF,Villarreal,29.0,1991.0,8.2,19,14,4,12,3,8,19,42.1,11,8,2,6,21,40,11,1,Matches,2020-2021,La-Liga
Iñigo Córdoba,es ESP,"FW,MF",Athletic Club,23.0,1997.0,1.1,0,0,0,0,0,0,3,0.0,3,4,0,4,2,2,1,0,Matches,2020-2021,La-Liga
Iñigo Córdoba,es ESP,MF,Alavés,23.0,1997.0,2.4,6,4,1,3,2,2,10,20.0,8,7,0,7,3,9,2,0,Matches,2020-2021,La-Liga
Ángel Correa,ar ARG,"FW,MF",Atlético Madrid,25.0,1995.0,26.6,38,21,10,23,5,15,45,33.3,30,18,1,17,22,60,16,0,Matches,2020-2021,La-Liga
Rober Correa,es ESP,DF,Eibar,27.0,1992.0,12.6,16,9,8,6,2,8,12,66.7,4,9,1,8,20,36,31,0,Matches,2020-2021,La-Liga
Thierry Correia,pt POR,DF,Valencia,21.0,1999.0,23.7,47,27,32,10,5,21,43,48.8,22,24,6,18,42,89,63,1,Matches,2020-2021,La-Liga
Diego Costa,es ESP,FW,Atlético Madrid,31.0,1988.0,2.3,1,0,1,0,0,1,3,33.3,2,0,0,0,0,1,2,0,Matches,2020-2021,La-Liga
Jaume Costa,es ESP,"DF,MF",Villarreal,32.0,1988.0,3.9,10,6,4,6,0,7,9,77.8,2,7,1,6,6,16,8,0,Matches,2020-2021,La-Liga
Thibaut Courtois,be BEL,GK,Real Madrid,28.0,1992.0,38.0,0,0,0,0,0,0,1,0.0,1,1,0,1,1,1,17,2,Matches,2020-2021,La-Liga
Philippe Coutinho,br BRA,"MF,FW",Barcelona,28.0,1992.0,7.3,8,6,2,5,1,3,9,33.3,6,7,0,7,2,10,1,0,Matches,2020-2021,La-Liga
Juan Cruz Armada,es ESP,DF,Osasuna,28.0,1992.0,21.8,36,22,17,16,3,19,35,54.3,16,19,5,14,15,51,50,0,Matches,2020-2021,La-Liga
Sergio Cubero Ezcurra,es ESP,MF,Eibar,20.0,1999.0,0.0,0,0,0,0,0,0,0,,0,0,0,0,0,0,0,0,Matches,2020-2021,La-Liga
Cucho,co COL,"FW,MF",Getafe,21.0,1999.0,16.3,19,10,1,14,4,2,23,8.7,21,18,1,17,6,25,8,0,Matches,2020-2021,La-Liga
Marc Cucurella,es ESP,MF,Getafe,22.0,1998.0,36.0,64,51,19,40,5,25,66,37.9,41,45,4,41,40,104,27,0,Matches,2020-2021,La-Liga
Patrick Cutrone,it ITA,FW,Valencia,22.0,1998.0,1.2,0,0,0,0,0,0,1,0.0,1,0,0,0,1,1,0,0,Matches,2020-2021,La-Liga
Moussa Dembélé,fr FRA,FW,Atlético Madrid,24.0,1996.0,1.1,0,0,0,0,0,0,1,0.0,1,0,0,0,1,1,0,0,Matches,2020-2021,La-Liga
Ousmane Dembélé,fr FRA,FW,Barcelona,23.0,1997.0,19.7,14,9,4,9,1,6,17,35.3,11,10,0,10,9,23,3,1,Matches,2020-2021,La-Liga
Sergiño Dest,us USA,"DF,FW",Barcelona,19.0,2000.0,21.2,31,16,23,6,2,18,32,56.3,14,25,4,21,10,41,24,1,Matches,2020-2021,La-Liga
Deyverson,br BRA,FW,Alavés,29.0,1991.0,9.7,6,4,3,1,2,2,13,15.4,11,9,0,9,9,15,13,0,Matches,2020-2021,La-Liga
Abdoulay Diaby,ml MLI,DF,Getafe,29.0,1991.0,0.2,2,0,0,2,0,0,0,,0,2,0,2,0,2,0,0,Matches,2020-2021,La-Liga
Mouctar Diakhaby,gn GUI,DF,Valencia,23.0,1996.0,23.1,16,8,10,6,0,8,12,66.7,4,28,21,7,27,43,102,1,Matches,2020-2021,La-Liga
Víctor Díaz,es ESP,DF,Granada,32.0,1988.0,9.2,21,10,13,6,2,10,19,52.6,9,14,8,6,16,37,39,0,Matches,2020-2021,La-Liga
Papakouli Diop,sn SEN,MF,Eibar,34.0,1986.0,25.8,43,29,15,22,6,12,41,29.3,29,23,5,18,39,82,34,1,Matches,2020-2021,La-Liga
Djené,tg TOG,DF,Getafe,28.0,1991.0,32.7,61,39,31,26,4,26,34,76.5,8,24,11,13,42,103,96,0,Matches,2020-2021,La-Liga
Marko Dmitrović,rs SRB,GK,Eibar,28.0,1992.0,34.7,4,3,4,0,0,2,4,50.0,2,0,0,0,0,4,16,2,Matches,2020-2021,La-Liga
Jaume Doménech,es ESP,GK,Valencia,29.0,1990.0,28.0,1,1,1,0,0,1,2,50.0,1,1,0,1,0,1,16,2,Matches,2020-2021,La-Liga
Carlos Dominguez,es ESP,DF,Celta Vigo,19.0,2001.0,4.0,5,4,4,1,0,3,6,50.0,3,5,3,2,6,11,24,0,Matches,2020-2021,La-Liga
John Donald,es ESP,"DF,MF",Elche,19.0,2000.0,0.6,0,0,0,0,0,0,0,,0,0,0,0,0,0,1,0,Matches,2020-2021,La-Liga
Cheick Doukouré,ci CIV,"MF,FW",Levante,27.0,1992.0,1.1,5,4,2,1,2,3,4,75.0,1,2,0,2,3,8,0,0,Matches,2020-2021,La-Liga
Idrissa Doumbia,ci CIV,MF,Huesca,22.0,1998.0,8.7,15,8,6,7,2,5,13,38.5,8,6,3,3,7,22,9,0,Matches,2020-2021,La-Liga
Domingos Duarte,pt POR,DF,Granada,25.0,1995.0,26.3,32,20,18,12,2,14,21,66.7,7,29,20,9,29,61,86,0,Matches,2020-2021,La-Liga
Óscar Duarte,cr CRC,DF,Levante,31.0,1989.0,22.9,22,13,17,5,0,10,18,55.6,8,23,15,8,36,58,97,1,Matches,2020-2021,La-Liga
Rubén Duarte,es ESP,DF,Alavés,24.0,1995.0,28.3,55,30,28,21,6,23,52,44.2,29,44,6,38,67,122,72,0,Matches,2020-2021,La-Liga
Unai Dufur,es ESP,DF,Eibar,21.0,1999.0,0.7,2,2,2,0,0,2,4,50.0,2,0,0,0,1,3,0,0,Matches,2020-2021,La-Liga
Hugo Duro,es ESP,FW,Real Madrid,20.0,1999.0,0.6,0,0,0,0,0,0,0,,0,1,0,1,0,0,0,0,Matches,2020-2021,La-Liga
Aritz Elustondo,es ESP,DF,Real Sociedad,26.0,1994.0,20.9,30,16,21,7,2,18,22,81.8,4,12,5,7,15,45,63,0,Matches,2020-2021,La-Liga
Rodrigo Ely,br BRA,DF,Alavés,26.0,1993.0,5.2,5,2,3,2,0,3,4,75.0,1,2,1,1,7,12,23,1,Matches,2020-2021,La-Liga
Emerson,br BRA,DF,Betis,21.0,1999.0,33.2,91,52,62,25,4,43,78,55.1,35,33,6,27,61,152,102,2,Matches,2020-2021,La-Liga
Youssef En-Nesyri,ma MAR,FW,Sevilla,23.0,1997.0,25.7,17,11,2,9,6,4,21,19.0,17,15,0,15,8,25,23,0,Matches,2020-2021,La-Liga
Sergi Enrich,es ESP,FW,Eibar,30.0,1990.0,15.6,21,15,6,7,8,9,22,40.9,13,11,0,11,6,27,5,0,Matches,2020-2021,La-Liga
Aarón Escandell,es ESP,GK,Granada,24.0,1995.0,5.0,1,1,1,0,0,1,1,100.0,0,0,0,0,0,1,6,0,Matches,2020-2021,La-Liga
Dani Escriche,es ESP,"FW,MF",Huesca,22.0,1998.0,9.5,9,7,5,2,2,3,10,30.0,7,11,0,11,8,17,5,0,Matches,2020-2021,La-Liga
Sergio Escudero,es ESP,DF,Sevilla,30.0,1989.0,6.3,12,8,6,5,1,6,12,50.0,6,5,2,3,9,21,7,0,Matches,2020-2021,La-Liga
Alfonso Espino,uy URU,DF,Cádiz,28.0,1992.0,28.9,92,48,63,28,1,43,85,50.6,42,30,5,25,41,133,74,0,Matches,2020-2021,La-Liga
Vicente Esquerdo,es ESP,MF,Valencia,21.0,1999.0,2.6,7,4,5,2,0,4,6,66.7,2,4,2,2,8,15,1,0,Matches,2020-2021,La-Liga
Pervis Estupiñán,ec ECU,DF,Villarreal,22.0,1998.0,13.0,37,17,23,12,2,14,23,60.9,9,10,2,8,35,72,14,2,Matches,2020-2021,La-Liga
Xabier Etxeita,es ESP,DF,Getafe,32.0,1987.0,9.8,8,4,5,3,0,7,14,50.0,7,6,3,3,13,21,38,0,Matches,2020-2021,La-Liga
Edu Expósito,es ESP,MF,Eibar,23.0,1996.0,27.3,51,30,16,31,4,20,66,30.3,46,25,4,21,22,73,17,0,Matches,2020-2021,La-Liga
Jokin Ezkieta,es ESP,GK,Athletic Club,23.0,1996.0,1.0,0,0,0,0,0,0,0,,0,0,0,0,0,0,0,0,Matches,2020-2021,La-Liga
Fali,es ESP,"DF,MF",Cádiz,26.0,1993.0,29.3,42,25,24,15,3,16,37,43.2,21,28,15,13,32,74,119,0,Matches,2020-2021,La-Liga
Ansu Fati,es ESP,FW,Barcelona,17.0,2002.0,4.8,9,4,2,4,3,2,10,20.0,8,4,0,4,3,12,1,0,Matches,2020-2021,La-Liga
Nabil Fekir,fr FRA,"MF,FW",Betis,27.0,1993.0,29.1,46,24,9,22,15,7,43,16.3,36,31,2,29,8,54,2,0,Matches,2020-2021,La-Liga
Felipe,br BRA,DF,Atlético Madrid,31.0,1989.0,22.9,29,17,19,10,0,18,23,78.3,5,30,15,15,36,65,128,2,Matches,2020-2021,La-Liga
João Félix,pt POR,"FW,MF",Atlético Madrid,20.0,1999.0,17.5,8,4,1,6,1,4,17,23.5,13,3,0,3,5,13,2,0,Matches,2020-2021,La-Liga
Aitor Fernández,es ESP,GK,Levante,29.0,1991.0,29.0,0,0,0,0,0,0,0,,0,0,0,0,2,2,16,1,Matches,2020-2021,La-Liga
Álex Fernández,es ESP,MF,Cádiz,27.0,1992.0,21.6,19,9,8,8,3,8,30,26.7,22,14,1,13,22,41,15,0,Matches,2020-2021,La-Liga
Álvaro Fernández,es ESP,GK,Huesca,22.0,1998.0,22.0,1,1,0,1,0,1,3,33.3,2,0,0,0,2,3,7,0,Matches,2020-2021,La-Liga
Andrés Fernández,es ESP,GK,Huesca,33.0,1986.0,16.0,0,0,0,0,0,0,0,,0,0,0,0,0,0,3,2,Matches,2020-2021,La-Liga
Augusto Fernández,ar ARG,MF,Cádiz,34.0,1986.0,4.1,11,3,5,6,0,2,13,15.4,11,5,1,4,9,20,5,0,Matches,2020-2021,La-Liga
Carlos Fernández,es ESP,FW,Sevilla,24.0,1996.0,1.6,1,0,1,0,0,0,2,0.0,2,3,1,2,1,2,0,0,Matches,2020-2021,La-Liga
Carlos Fernández,es ESP,"FW,MF",Real Sociedad,24.0,1996.0,4.3,3,2,0,2,1,1,8,12.5,7,6,1,5,0,3,6,0,Matches,2020-2021,La-Liga
Joaquín Fernández,es ESP,DF,Valladolid,24.0,1996.0,23.0,30,16,21,8,1,12,21,57.1,9,24,15,9,43,73,113,0,Matches,2020-2021,La-Liga
Fernando,br BRA,MF,Sevilla,33.0,1987.0,28.3,54,28,24,25,5,23,43,53.5,20,25,11,14,41,95,70,0,Matches,2020-2021,La-Liga
David Ferreiro,es ESP,"MF,FW",Huesca,32.0,1988.0,28.1,25,12,12,8,5,8,49,16.3,41,22,1,21,25,50,15,0,Matches,2020-2021,La-Liga
Facundo Ferreyra,ar ARG,FW,Celta Vigo,29.0,1991.0,3.3,4,3,1,2,1,0,2,0.0,2,5,0,5,2,6,2,0,Matches,2020-2021,La-Liga
Fidel,es ESP,"MF,DF",Elche,30.0,1989.0,26.6,46,30,28,15,3,25,64,39.1,39,22,2,20,16,62,14,0,Matches,2020-2021,La-Liga
Junior Firpo,do DOM,"DF,MF",Barcelona,23.0,1996.0,3.2,1,1,1,0,0,0,1,0.0,1,5,3,2,4,5,7,0,Matches,2020-2021,La-Liga
Kingsley Fobi,gh GHA,DF,Granada,21.0,1998.0,0.5,0,0,0,0,0,0,0,,0,0,0,0,1,1,1,0,Matches,2020-2021,La-Liga
Ramón Folch,es ESP,MF,Elche,30.0,1989.0,0.0,0,0,0,0,0,0,0,,0,0,0,0,0,0,0,0,Matches,2020-2021,La-Liga
José Fontán,es ESP,DF,Celta Vigo,20.0,2000.0,7.2,12,9,8,4,0,5,11,45.5,6,4,3,1,13,25,27,0,Matches,2020-2021,La-Liga
Dimitri Foulquier,fr FRA,DF,Granada,27.0,1993.0,29.6,35,21,20,12,3,15,26,57.7,11,24,7,17,26,61,60,0,Matches,2020-2021,La-Liga
Juan Foyth,ar ARG,"DF,MF",Villarreal,22.0,1998.0,13.0,40,22,22,14,4,12,29,41.4,17,21,6,15,19,59,24,1,Matches,2020-2021,La-Liga
Jorge de Frutos,es ESP,MF,Levante,23.0,1997.0,24.3,48,24,21,21,6,11,41,26.8,30,25,2,23,16,64,17,0,Matches,2020-2021,La-Liga
Ramiro Funes Mori,ar ARG,DF,Villarreal,29.0,1991.0,8.1,12,8,7,5,0,7,11,63.6,4,7,5,2,8,20,42,1,Matches,2020-2021,La-Liga
Javi Galán,es ESP,DF,Huesca,25.0,1994.0,34.1,88,54,47,35,6,46,72,63.9,26,30,4,26,39,127,61,0,Matches,2020-2021,La-Liga
Enric Gallego,es ESP,FW,Osasuna,33.0,1986.0,9.0,6,3,2,2,2,2,14,14.3,12,5,1,4,1,7,9,0,Matches,2020-2021,La-Liga
Kévin Gameiro,fr FRA,FW,Valencia,33.0,1987.0,12.0,7,4,3,2,2,3,11,27.3,8,10,0,10,0,7,3,0,Matches,2020-2021,La-Liga
Aleix García,es ESP,MF,Eibar,23.0,1997.0,4.9,5,4,2,2,1,1,10,10.0,9,5,0,5,8,13,2,0,Matches,2020-2021,La-Liga
Borja García,es ESP,"MF,FW",Huesca,29.0,1990.0,12.4,13,7,4,6,3,6,12,50.0,6,12,0,12,10,23,4,1,Matches,2020-2021,La-Liga
Dani García,es ESP,MF,Athletic Club,30.0,1990.0,21.3,39,19,10,23,6,15,46,32.6,31,20,7,13,33,72,34,0,Matches,2020-2021,La-Liga
David García,es ESP,DF,Osasuna,26.0,1994.0,35.0,26,17,13,13,0,13,24,54.2,11,36,19,17,59,85,171,0,Matches,2020-2021,La-Liga
Manu García,es ESP,MF,Alavés,34.0,1986.0,12.5,24,13,10,13,1,8,35,22.9,27,16,1,15,12,36,21,0,Matches,2020-2021,La-Liga
Raúl García,es ESP,"DF,MF",Valladolid,31.0,1989.0,5.6,10,8,5,5,0,6,20,30.0,14,5,1,4,9,19,10,0,Matches,2020-2021,La-Liga
Raúl García,es ESP,"FW,MF",Athletic Club,34.0,1986.0,19.4,34,19,9,19,6,7,22,31.8,15,30,1,29,15,49,20,0,Matches,2020-2021,La-Liga
Rubén García,es ESP,"MF,FW",Osasuna,27.0,1993.0,30.2,50,29,21,22,7,14,45,31.1,31,28,2,26,29,79,20,0,Matches,2020-2021,La-Liga
Sergi García,es ESP,MF,Alavés,21.0,1999.0,0.2,1,1,0,1,0,0,1,0.0,1,0,0,0,0,1,0,0,Matches,2020-2021,La-Liga
Unai García,es ESP,DF,Osasuna,28.0,1992.0,13.8,19,9,14,4,1,9,15,60.0,6,16,8,8,14,33,40,0,Matches,2020-2021,La-Liga
Mario Gaspar,es ESP,DF,Villarreal,29.0,1990.0,20.6,55,34,22,24,9,21,40,52.5,19,26,4,22,30,85,47,1,Matches,2020-2021,La-Liga
Paulo Gazzaniga,ar ARG,GK,Elche,28.0,1992.0,8.0,1,1,1,0,0,0,0,,0,0,0,0,1,2,4,0,Matches,2020-2021,La-Liga
Bryan Gil,es ESP,FW,Sevilla,19.0,2001.0,0.1,1,1,0,1,0,0,0,,0,0,0,0,0,1,0,0,Matches,2020-2021,La-Liga
Bryan Gil,es ESP,"MF,FW",Eibar,19.0,2001.0,25.2,28,18,12,11,5,6,23,26.1,17,20,0,20,17,45,6,0,Matches,2020-2021,La-Liga
David Gil,es ESP,GK,Cádiz,26.0,1994.0,4.0,0,0,0,0,0,0,1,0.0,1,0,0,0,0,0,2,0,Matches,2020-2021,La-Liga
Álvaro Giménez,es ESP,FW,Cádiz,29.0,1991.0,4.5,4,2,2,2,0,0,3,0.0,3,2,0,2,2,6,3,0,Matches,2020-2021,La-Liga
Dani Gómez,es ESP,FW,Levante,22.0,1998.0,18.5,4,3,2,1,1,0,11,0.0,11,3,0,3,2,6,4,0,Matches,2020-2021,La-Liga
Ibai Gómez,es ESP,MF,Athletic Club,30.0,1989.0,4.7,6,4,2,3,1,4,7,57.1,3,3,0,3,2,8,4,0,Matches,2020-2021,La-Liga
Maxi Gómez,uy URU,FW,Valencia,23.0,1996.0,29.9,11,9,3,7,1,3,14,21.4,11,13,3,10,2,13,34,0,Matches,2020-2021,La-Liga
Moi Gómez,es ESP,"MF,FW",Villarreal,26.0,1994.0,28.5,21,12,6,8,7,14,35,40.0,21,20,3,17,11,32,16,0,Matches,2020-2021,La-Liga
Papu Gómez,ar ARG,"MF,FW",Sevilla,32.0,1988.0,10.2,9,6,2,4,3,2,12,16.7,10,13,2,11,7,16,6,0,Matches,2020-2021,La-Liga
Sergi Gómez,es ESP,DF,Sevilla,28.0,1992.0,8.0,4,3,2,2,0,1,1,100.0,0,5,4,1,6,10,34,0,Matches,2020-2021,La-Liga
Sergio Gómez,es ESP,"MF,FW",Huesca,19.0,2000.0,8.8,29,10,17,9,3,11,22,50.0,11,15,0,15,14,43,9,0,Matches,2020-2021,La-Liga
Maxime Gonalons,fr FRA,MF,Granada,31.0,1989.0,16.4,53,37,18,33,2,15,37,40.5,22,17,0,17,25,78,21,1,Matches,2020-2021,La-Liga
Bruno González,es ESP,DF,Valladolid,30.0,1990.0,25.1,26,17,18,8,0,17,31,54.8,14,22,14,8,37,63,112,1,Matches,2020-2021,La-Liga
Diego González,es ESP,DF,Elche,25.0,1995.0,14.2,11,7,7,3,1,5,11,45.5,6,16,9,7,20,31,49,1,Matches,2020-2021,La-Liga
Sergio González,es ESP,"MF,DF",Cádiz,23.0,1997.0,1.0,1,0,0,1,0,1,2,50.0,1,0,0,0,2,3,0,0,Matches,2020-2021,La-Liga
Urko González,es ESP,MF,Real Sociedad,19.0,2001.0,0.5,0,0,0,0,0,0,1,0.0,1,1,1,0,0,0,1,0,Matches,2020-2021,La-Liga
Andoni Gorosabel,es ESP,DF,Real Sociedad,23.0,1996.0,26.5,76,43,45,20,11,27,64,42.2,37,25,4,21,23,99,42,0,Matches,2020-2021,La-Liga
Antoine Griezmann,fr FRA,"FW,MF",Barcelona,29.0,1991.0,28.9,37,22,10,18,9,12,40,30.0,28,20,1,19,12,49,11,0,Matches,2020-2021,La-Liga
Andrés Guardado,mx MEX,MF,Betis,33.0,1986.0,14.6,25,12,10,11,4,11,26,42.3,15,13,3,10,18,43,19,0,Matches,2020-2021,La-Liga
Sergi Guardiola,es ESP,FW,Valladolid,29.0,1991.0,19.9,11,5,1,5,5,2,27,7.4,25,12,1,11,7,18,16,3,Matches,2020-2021,La-Liga
Nemanja Gudelj,rs SRB,"MF,DF",Sevilla,28.0,1991.0,11.6,23,12,16,5,2,4,10,40.0,6,10,6,4,24,47,24,2,Matches,2020-2021,La-Liga
Gonçalo Guedes,pt POR,"MF,FW",Valencia,23.0,1996.0,25.4,18,12,8,7,3,10,45,22.2,35,24,1,23,8,26,7,0,Matches,2020-2021,La-Liga
Ander Guevara,es ESP,MF,Real Sociedad,23.0,1997.0,23.1,35,23,15,16,4,15,30,50.0,15,19,5,14,25,60,35,1,Matches,2020-2021,La-Liga
John Guidetti,se SWE,FW,Alavés,28.0,1992.0,2.3,2,2,0,2,0,0,2,0.0,2,0,0,0,1,3,2,0,Matches,2020-2021,La-Liga
Hugo Guillamón,es ESP,DF,Valencia,20.0,2000.0,22.1,23,13,17,6,0,8,20,40.0,12,19,14,5,27,50,102,3,Matches,2020-2021,La-Liga
Jon Guridi,es ESP,MF,Real Sociedad,25.0,1995.0,9.2,19,9,10,6,3,8,22,36.4,14,8,1,7,10,29,9,0,Matches,2020-2021,La-Liga
Raúl Guti,es ESP,MF,Elche,23.0,1996.0,31.8,48,28,21,22,5,16,52,30.8,36,25,3,22,49,97,25,0,Matches,2020-2021,La-Liga
Marcos Mauro López Gutiérrez,ar ARG,DF,Cádiz,29.0,1991.0,20.3,23,15,15,8,0,15,24,62.5,9,18,12,6,22,45,78,0,Matches,2020-2021,La-Liga
Miguel Gutiérrez,es ESP,DF,Real Madrid,19.0,2001.0,3.5,4,0,0,3,1,1,7,14.3,6,3,0,3,5,9,5,0,Matches,2020-2021,La-Liga
Munir El Haddadi,ma MAR,FW,Sevilla,24.0,1995.0,9.4,12,8,5,5,2,2,12,16.7,10,6,0,6,5,17,6,0,Matches,2020-2021,La-Liga
Eden Hazard,be BEL,"FW,MF",Real Madrid,29.0,1991.0,5.9,3,2,1,2,0,0,3,0.0,3,3,0,3,3,6,0,0,Matches,2020-2021,La-Liga
Mario Hermoso,es ESP,DF,Atlético Madrid,25.0,1995.0,28.6,55,31,40,11,4,37,61,60.7,24,23,10,13,36,91,73,0,Matches,2020-2021,La-Liga
Aridane Hernández,es ESP,DF,Osasuna,31.0,1989.0,22.5,20,11,13,6,1,7,12,58.3,5,22,19,3,34,54,127,1,Matches,2020-2021,La-Liga
Héctor Herrera,mx MEX,MF,Atlético Madrid,30.0,1990.0,7.6,12,7,5,6,1,7,13,53.8,6,7,2,5,14,26,8,0,Matches,2020-2021,La-Liga
Sergio Herrera,es ESP,GK,Osasuna,27.0,1993.0,32.9,0,0,0,0,0,0,2,0.0,2,0,0,0,3,3,29,3,Matches,2020-2021,La-Liga
Yangel Herrera,ve VEN,MF,Granada,22.0,1998.0,25.7,59,26,19,32,8,11,41,26.8,30,53,17,36,26,85,32,1,Matches,2020-2021,La-Liga
Pablo Hervías,es ESP,"DF,MF",Valladolid,27.0,1993.0,13.4,19,12,7,9,3,9,26,34.6,17,6,0,6,11,30,8,0,Matches,2020-2021,La-Liga
Jordan Holsgrove,sct SCO,MF,Celta Vigo,20.0,1999.0,1.6,6,4,4,1,1,5,8,62.5,3,2,0,2,2,8,1,0,Matches,2020-2021,La-Liga
Vicente Iborra,es ESP,MF,Villarreal,32.0,1988.0,10.3,18,8,8,7,3,8,24,33.3,16,14,7,7,14,32,25,1,Matches,2020-2021,La-Liga
Oussama Idrissi,ma MAR,"FW,MF",Sevilla,24.0,1996.0,0.3,1,1,0,1,0,1,2,50.0,1,2,0,2,1,2,0,0,Matches,2020-2021,La-Liga
Iglesias,es ESP,"DF,MF",Getafe,22.0,1998.0,6.7,27,15,14,10,3,11,19,57.9,8,11,1,10,17,44,19,0,Matches,2020-2021,La-Liga
Borja Iglesias,es ESP,FW,Betis,27.0,1993.0,15.7,1,1,0,0,1,1,8,12.5,7,7,2,5,3,4,9,0,Matches,2020-2021,La-Liga
Asier Illarramendi,es ESP,MF,Real Sociedad,30.0,1990.0,3.7,5,2,1,4,0,1,5,20.0,4,2,0,2,5,10,7,0,Matches,2020-2021,La-Liga
Pablo Insua,es ESP,DF,Huesca,26.0,1993.0,17.6,37,18,26,9,2,14,31,45.2,17,14,8,6,24,61,68,0,Matches,2020-2021,La-Liga
Takashi Inui,jp JPN,"MF,FW",Eibar,32.0,1988.0,20.2,13,8,6,3,4,3,12,25.0,9,19,0,19,12,25,7,0,Matches,2020-2021,La-Liga
Alexander Isak,se SWE,FW,Real Sociedad,20.0,1999.0,26.0,9,5,0,3,6,3,8,37.5,5,17,1,16,3,12,7,0,Matches,2020-2021,La-Liga
Isco,es ESP,MF,Real Madrid,28.0,1992.0,10.1,13,9,5,5,3,2,14,14.3,12,7,1,6,2,15,2,0,Matches,2020-2021,La-Liga
Jairo Izquierdo,es ESP,"MF,DF",Cádiz,26.0,1993.0,14.2,21,13,13,8,0,12,31,38.7,19,7,1,6,14,35,12,0,Matches,2020-2021,La-Liga
Saidy Janko,gm GAM,DF,Valladolid,24.0,1995.0,13.6,19,10,12,5,2,8,14,57.1,6,9,1,8,18,37,47,0,Matches,2020-2021,La-Liga
Adnan Januzaj,be BEL,"FW,MF",Real Sociedad,25.0,1995.0,11.3,9,8,0,6,3,3,8,37.5,5,7,2,5,3,12,4,0,Matches,2020-2021,La-Liga
Jason,es ESP,"MF,DF",Valencia,26.0,1994.0,4.9,9,3,5,2,2,4,16,25.0,12,6,1,5,10,19,4,0,Matches,2020-2021,La-Liga
Luis Javier Suárez,co COL,"FW,MF",Granada,22.0,1997.0,18.5,19,11,5,7,7,6,17,35.3,11,10,1,9,8,27,11,0,Matches,2020-2021,La-Liga
Joaquín,es ESP,"FW,MF",Betis,39.0,1981.0,14.3,9,3,1,5,3,4,12,33.3,8,8,0,8,17,26,11,0,Matches,2020-2021,La-Liga
John Joe,ie IRL,"MF,FW",Getafe,16.0,2003.0,0.7,2,0,0,2,0,0,0,,0,0,0,0,0,2,0,0,Matches,2020-2021,La-Liga
Frenkie de Jong,nl NED,"MF,DF",Barcelona,23.0,1997.0,35.0,44,27,21,19,4,15,35,42.9,20,20,4,16,38,82,29,2,Matches,2020-2021,La-Liga
Luuk de Jong,nl NED,FW,Sevilla,29.0,1990.0,14.1,9,5,3,2,4,1,7,14.3,6,11,3,8,5,14,15,0,Matches,2020-2021,La-Liga
Jony,es ESP,"MF,FW",Osasuna,29.0,1991.0,9.7,7,3,1,2,4,5,20,25.0,15,5,0,5,14,21,3,0,Matches,2020-2021,La-Liga
Joan Jordán,es ESP,MF,Sevilla,26.0,1994.0,26.7,52,28,17,29,6,17,76,22.4,59,22,3,19,27,79,25,0,Matches,2020-2021,La-Liga
Josan,es ESP,"MF,DF",Elche,30.0,1989.0,21.4,34,18,23,11,0,13,39,33.3,26,24,1,23,21,55,26,1,Matches,2020-2021,La-Liga
Willian José,br BRA,FW,Real Sociedad,28.0,1991.0,7.7,3,1,0,3,0,1,3,33.3,2,3,1,2,0,3,8,0,Matches,2020-2021,La-Liga
Joselu,es ESP,FW,Alavés,30.0,1990.0,33.6,27,14,6,15,6,8,28,28.6,20,26,3,23,15,42,58,1,Matches,2020-2021,La-Liga
Josema,es ESP,DF,Elche,24.0,1996.0,21.8,43,28,33,10,0,10,18,55.6,8,17,7,10,37,80,92,1,Matches,2020-2021,La-Liga
Jota,pt POR,"MF,FW",Valladolid,21.0,1999.0,7.4,7,3,1,4,2,5,10,50.0,5,4,0,4,6,13,5,1,Matches,2020-2021,La-Liga
Jota,es ESP,MF,Alavés,29.0,1991.0,15.5,19,14,6,7,6,3,29,10.3,26,12,0,12,9,28,9,0,Matches,2020-2021,La-Liga
Luka Jović,rs SRB,FW,Real Madrid,22.0,1997.0,1.7,0,0,0,0,0,0,0,,0,0,0,0,0,0,0,0,Matches,2020-2021,La-Liga
Juanmi,es ESP,"FW,MF",Betis,27.0,1993.0,6.7,13,9,3,5,5,4,18,22.2,14,4,0,4,2,15,4,0,Matches,2020-2021,La-Liga
Vinicius Júnior,br BRA,FW,Real Madrid,20.0,2000.0,21.9,32,22,14,10,8,11,43,25.6,32,28,0,28,7,39,4,0,Matches,2020-2021,La-Liga
Jens Jønsson,dk DEN,MF,Cádiz,27.0,1993.0,29.1,55,29,25,25,5,22,52,42.3,30,39,7,32,51,106,45,0,Matches,2020-2021,La-Liga
Damian Kądzior,pl POL,"FW,MF",Eibar,28.0,1992.0,2.2,1,0,0,1,0,1,5,20.0,4,1,0,1,0,1,0,0,Matches,2020-2021,La-Liga
Lee Kang-in,kr KOR,"FW,MF",Valencia,19.0,2001.0,14.0,15,11,8,4,3,3,31,9.7,28,12,0,12,2,17,0,0,Matches,2020-2021,La-Liga
Stephane Keller,cm CMR,DF,Alavés,18.0,2001.0,0.2,1,0,1,0,0,1,1,100.0,0,0,0,0,0,1,0,0,Matches,2020-2021,La-Liga
Kenedy,br BRA,"FW,MF",Granada,24.0,1996.0,16.3,22,12,10,7,5,5,25,20.0,20,21,4,17,26,48,15,1,Matches,2020-2021,La-Liga
Kiké,es ESP,FW,Eibar,30.0,1989.0,34.3,24,18,5,7,12,6,22,27.3,16,24,1,23,7,31,29,0,Matches,2020-2021,La-Liga
Giorgi Kochorashvili,ge GEO,MF,Levante,21.0,1999.0,0.3,1,0,1,0,0,0,0,,0,0,0,0,0,1,0,0,Matches,2020-2021,La-Liga
Kenan Kodro,ba BIH,"FW,MF",Valladolid,26.0,1993.0,5.1,0,0,0,0,0,0,2,0.0,2,2,1,1,2,2,6,0,Matches,2020-2021,La-Liga
Kenan Kodro,ba BIH,"FW,MF",Athletic Club,26.0,1993.0,0.5,0,0,0,0,0,0,1,0.0,1,0,0,0,0,0,0,0,Matches,2020-2021,La-Liga
Koba Koindredi,fr FRA,MF,Valencia,18.0,2001.0,0.2,1,1,1,0,0,0,1,0.0,1,0,0,0,0,1,0,0,Matches,2020-2021,La-Liga
Koke,es ESP,MF,Atlético Madrid,28.0,1992.0,33.6,64,42,22,31,11,28,98,28.6,70,35,6,29,36,100,40,0,Matches,2020-2021,La-Liga
Geoffrey Kondogbia,cf CTA,MF,Valencia,27.0,1993.0,4.9,16,9,9,4,3,7,19,36.8,12,6,1,5,8,24,8,0,Matches,2020-2021,La-Liga
Geoffrey Kondogbia,cf CTA,MF,Atlético Madrid,27.0,1993.0,6.8,30,20,12,16,2,11,20,55.0,9,11,5,6,11,41,8,1,Matches,2020-2021,La-Liga
Youssouf Koné,ml MLI,"DF,MF",Elche,25.0,1995.0,0.8,2,0,1,0,1,0,1,0.0,1,0,0,0,0,2,0,0,Matches,2020-2021,La-Liga
Jules Koundé,fr FRA,DF,Sevilla,21.0,1998.0,33.1,27,15,14,11,2,10,24,41.7,14,24,16,8,40,67,104,0,Matches,2020-2021,La-Liga
Toni Kroos,de GER,MF,Real Madrid,30.0,1990.0,23.5,42,22,15,15,12,11,44,25.0,33,26,6,20,15,57,10,3,Matches,2020-2021,La-Liga
Takefusa Kubo,jp JPN,"MF,FW",Villarreal,19.0,2001.0,3.3,1,1,0,0,1,1,5,20.0,4,2,0,2,1,2,2,0,Matches,2020-2021,La-Liga
Takefusa Kubo,jp JPN,"MF,FW",Getafe,19.0,2001.0,8.9,7,4,2,3,2,1,14,7.1,13,14,0,14,14,21,4,0,Matches,2020-2021,La-Liga
Kuki,es ESP,MF,Valladolid,22.0,1998.0,0.3,1,1,0,0,1,0,1,0.0,1,0,0,0,0,1,0,0,Matches,2020-2021,La-Liga
Víctor Laguardia,es ESP,DF,Alavés,30.0,1989.0,29.2,20,12,13,6,1,14,31,45.2,17,25,13,12,37,57,104,0,Matches,2020-2021,La-Liga
Diego Lainez,mx MEX,"FW,MF",Betis,20.0,2000.0,9.6,9,4,3,5,1,6,16,37.5,10,15,0,15,11,20,6,0,Matches,2020-2021,La-Liga
Toni Lato,es ESP,DF,Valencia,22.0,1997.0,8.1,13,6,7,3,3,6,13,46.2,7,12,1,11,10,23,21,0,Matches,2020-2021,La-Liga
Lauti,uy URU,MF,Celta Vigo,19.0,2001.0,0.2,0,0,0,0,0,0,0,,0,0,0,0,0,0,1,0,Matches,2020-2021,La-Liga
Robin Le Normand,es ESP,DF,Real Sociedad,23.0,1996.0,30.5,34,20,25,8,1,9,19,47.4,10,35,24,11,36,70,87,1,Matches,2020-2021,La-Liga
Jeremías Ledesma,ar ARG,GK,Cádiz,27.0,1993.0,32.0,1,0,1,0,0,1,1,100.0,0,1,0,1,0,1,22,6,Matches,2020-2021,La-Liga
Florian Lejeune,fr FRA,DF,Alavés,29.0,1991.0,33.5,43,32,36,7,0,21,35,60.0,14,38,24,14,51,94,149,1,Matches,2020-2021,La-Liga
Iñigo Lekue,es ESP,DF,Athletic Club,27.0,1993.0,7.2,9,7,6,3,0,3,8,37.5,5,8,1,7,4,13,24,0,Matches,2020-2021,La-Liga
Thomas Lemar,fr FRA,MF,Atlético Madrid,24.0,1995.0,15.2,30,17,9,17,4,11,24,45.8,13,22,1,21,11,41,10,0,Matches,2020-2021,La-Liga
Clément Lenglet,fr FRA,DF,Barcelona,25.0,1995.0,27.5,36,21,23,10,3,19,28,67.9,9,26,12,14,33,69,71,1,Matches,2020-2021,La-Liga
Pedro León,es ESP,"MF,FW",Eibar,33.0,1986.0,10.4,9,8,3,3,3,3,17,17.6,14,11,0,11,7,16,2,0,Matches,2020-2021,La-Liga
Sergio León,es ESP,FW,Levante,31.0,1989.0,8.3,6,2,0,4,2,2,8,25.0,6,4,0,4,3,9,3,0,Matches,2020-2021,La-Liga
Diego Llorente,es ESP,DF,Real Sociedad,26.0,1993.0,1.0,1,0,1,0,0,1,2,50.0,1,1,1,0,2,3,5,0,Matches,2020-2021,La-Liga
Marcos Llorente,es ESP,"MF,FW",Atlético Madrid,25.0,1995.0,32.8,71,42,21,40,10,26,62,41.9,36,40,3,37,29,100,28,0,Matches,2020-2021,La-Liga
Renan Lodi,br BRA,"DF,FW",Atlético Madrid,22.0,1998.0,12.5,30,17,13,12,5,17,26,65.4,9,15,0,15,16,46,18,0,Matches,2020-2021,La-Liga
Adrián López,es ESP,"FW,MF",Osasuna,32.0,1988.0,5.3,3,3,0,1,2,1,5,20.0,4,3,0,3,0,3,3,0,Matches,2020-2021,La-Liga
Javi López,es ESP,"DF,MF",Alavés,18.0,2002.0,2.8,5,5,3,2,0,2,3,66.7,1,2,0,2,3,8,3,1,Matches,2020-2021,La-Liga
Pedro López Muñoz,es ESP,DF,Huesca,36.0,1983.0,11.9,23,15,10,8,5,15,22,68.2,7,10,4,6,16,39,23,1,Matches,2020-2021,La-Liga
Roberto López,es ESP,"MF,FW",Real Sociedad,20.0,2000.0,5.6,5,1,1,2,2,2,5,40.0,3,2,0,2,4,9,6,0,Matches,2020-2021,La-Liga
Unai López,es ESP,MF,Athletic Club,24.0,1995.0,15.8,27,17,13,13,1,10,29,34.5,19,20,5,15,18,45,9,1,Matches,2020-2021,La-Liga
Anthony Lozano,hn HON,FW,Cádiz,27.0,1993.0,16.9,12,4,1,5,6,2,13,15.4,11,3,1,2,3,15,8,0,Matches,2020-2021,La-Liga
Jeison Lucumí,co COL,MF,Elche,25.0,1995.0,0.5,1,1,0,1,0,0,0,,0,1,0,1,0,1,0,0,Matches,2020-2021,La-Liga
José Luis Gayà,es ESP,DF,Valencia,25.0,1995.0,31.6,59,33,40,13,6,33,68,48.5,35,22,3,19,38,97,62,1,Matches,2020-2021,La-Liga
José Luis Morales,es ESP,"MF,FW",Levante,33.0,1987.0,27.1,18,10,7,9,2,8,37,21.6,29,17,0,17,11,29,11,0,Matches,2020-2021,La-Liga
Luisinho,pt POR,DF,Huesca,35.0,1985.0,2.0,3,3,2,1,0,1,3,33.3,2,3,0,3,4,7,7,0,Matches,2020-2021,La-Liga
Luismi,es ESP,"MF,DF",Elche,28.0,1992.0,1.9,4,2,1,3,0,1,2,50.0,1,2,0,2,4,8,0,0,Matches,2020-2021,La-Liga
Darwin Machís,ve VEN,"FW,MF",Granada,27.0,1993.0,22.5,30,17,12,10,8,6,19,31.6,13,21,2,19,22,52,13,0,Matches,2020-2021,La-Liga
Pablo Maffeo,es ESP,DF,Huesca,23.0,1997.0,21.8,26,17,21,4,1,12,26,46.2,14,18,6,12,35,61,27,0,Matches,2020-2021,La-Liga
Abdallahi Mahmoud,mr MTN,MF,Alavés,20.0,2000.0,0.7,2,2,1,1,0,0,1,0.0,1,0,0,0,1,3,0,0,Matches,2020-2021,La-Liga
Nemanja Maksimović,rs SRB,MF,Getafe,25.0,1995.0,30.3,50,28,22,24,4,19,46,41.3,27,40,9,31,57,107,46,1,Matches,2020-2021,La-Liga
Filip Malbašić,rs SRB,"FW,MF",Cádiz,27.0,1992.0,9.6,12,7,4,5,3,6,18,33.3,12,10,0,10,4,16,2,0,Matches,2020-2021,La-Liga
Hugo Mallo,es ESP,DF,Celta Vigo,29.0,1991.0,28.9,58,40,34,23,1,24,52,46.2,28,42,11,31,37,95,77,0,Matches,2020-2021,La-Liga
Mickael Malsa,mq MTQ,MF,Levante,24.0,1995.0,26.0,55,26,28,24,3,23,51,45.1,28,38,9,29,43,98,36,2,Matches,2020-2021,La-Liga
Aïssa Mandi,dz ALG,DF,Betis,28.0,1991.0,26.6,30,17,20,10,0,10,16,62.5,6,21,13,8,38,68,90,0,Matches,2020-2021,La-Liga
Eliaquim Mangala,fr FRA,DF,Valencia,29.0,1991.0,3.6,0,0,0,0,0,0,1,0.0,1,8,6,2,6,6,12,0,Matches,2020-2021,La-Liga
Marcelo,br BRA,"DF,MF",Real Madrid,32.0,1988.0,11.7,25,21,11,6,8,11,24,45.8,13,13,1,12,10,35,15,0,Matches,2020-2021,La-Liga
Iván Marcone,ar ARG,MF,Elche,30.0,1990.0,29.4,64,40,42,17,5,35,84,41.7,49,27,8,19,36,100,33,3,Matches,2020-2021,La-Liga
Óscar de Marcos,es ESP,"DF,MF",Athletic Club,31.0,1989.0,16.9,28,17,12,10,6,10,25,40.0,15,12,1,11,12,40,38,0,Matches,2020-2021,La-Liga
José Mari,es ESP,MF,Cádiz,32.0,1987.0,16.1,32,17,13,18,1,14,31,45.2,17,16,7,9,27,59,33,1,Matches,2020-2021,La-Liga
José María Giménez,uy URU,DF,Atlético Madrid,25.0,1995.0,19.6,20,7,14,5,1,12,17,70.6,5,17,11,6,21,41,65,0,Matches,2020-2021,La-Liga
Mariano,do DOM,FW,Real Madrid,26.0,1993.0,5.7,4,2,2,1,1,0,9,0.0,9,3,1,2,0,4,3,0,Matches,2020-2021,La-Liga
Adrián Marín,es ESP,"DF,MF",Alavés,23.0,1997.0,1.0,1,1,0,1,0,0,2,0.0,2,1,0,1,2,3,2,0,Matches,2020-2021,La-Liga
Adrián Marín,es ESP,"DF,MF",Granada,23.0,1997.0,3.0,5,2,1,3,1,2,3,66.7,1,5,2,3,4,9,9,0,Matches,2020-2021,La-Liga
Roger Martí,es ESP,FW,Levante,29.0,1991.0,24.4,11,7,5,4,2,6,23,26.1,17,10,3,7,4,15,6,0,Matches,2020-2021,La-Liga
Aarón Martín,es ESP,DF,Celta Vigo,23.0,1997.0,17.1,34,20,15,16,3,10,33,30.3,23,15,4,11,13,47,37,0,Matches,2020-2021,La-Liga
Álex Martín,es ESP,DF,Cádiz,22.0,1998.0,1.1,2,0,1,1,0,2,4,50.0,2,1,1,0,0,2,6,0,Matches,2020-2021,La-Liga
Iñigo Martínez,es ESP,DF,Athletic Club,29.0,1991.0,28.0,22,15,16,6,0,9,27,33.3,18,17,7,10,28,50,96,0,Matches,2020-2021,La-Liga
Javi Martínez,es ESP,"MF,FW",Osasuna,20.0,1999.0,5.1,9,4,1,6,2,5,12,41.7,7,9,0,9,5,14,4,0,Matches,2020-2021,La-Liga
Marvin,es ESP,"DF,MF",Real Madrid,20.0,2000.0,1.5,3,2,0,3,0,1,2,50.0,1,1,0,1,2,5,3,0,Matches,2020-2021,La-Liga
Jordi Masip,es ESP,GK,Valladolid,31.0,1989.0,25.0,0,0,0,0,0,0,2,0.0,2,2,0,2,2,2,8,1,Matches,2020-2021,La-Liga
Jaime Mata,es ESP,FW,Getafe,31.0,1988.0,22.6,12,7,1,3,8,3,18,16.7,15,13,2,11,6,18,16,0,Matches,2020-2021,La-Liga
Borja Mayoral,es ESP,FW,Real Madrid,23.0,1997.0,0.3,0,0,0,0,0,0,1,0.0,1,0,0,0,0,0,0,0,Matches,2020-2021,La-Liga
Gonzalo Melero,es ESP,"MF,FW",Levante,26.0,1994.0,20.6,24,15,11,6,7,10,39,25.6,29,14,5,9,18,42,22,1,Matches,2020-2021,La-Liga
Brais Méndez,es ESP,"MF,FW",Celta Vigo,23.0,1997.0,29.7,59,31,23,27,9,16,65,24.6,49,27,2,25,32,91,34,0,Matches,2020-2021,La-Liga
Édgar Méndez,es ESP,"MF,FW",Alavés,30.0,1990.0,23.2,39,29,18,13,8,15,48,31.3,33,20,3,17,19,58,15,0,Matches,2020-2021,La-Liga
Eñaut Mendía,es ESP,FW,Eibar,21.0,1999.0,0.7,2,1,2,0,0,1,2,50.0,1,1,1,0,0,2,0,0,Matches,2020-2021,La-Liga
Ferland Mendy,fr FRA,DF,Real Madrid,25.0,1995.0,24.5,26,16,17,6,3,12,24,50.0,12,16,4,12,26,52,32,1,Matches,2020-2021,La-Liga
Mikel Merino,es ESP,MF,Real Sociedad,24.0,1996.0,23.9,61,36,14,36,11,18,45,40.0,27,36,8,28,32,93,26,0,Matches,2020-2021,La-Liga
Martín Merquelanz,es ESP,"MF,FW",Real Sociedad,25.0,1995.0,6.1,9,3,3,2,4,2,7,28.6,5,7,1,6,3,12,4,0,Matches,2020-2021,La-Liga
Roque Mesa,es ESP,MF,Valladolid,31.0,1989.0,19.6,46,29,18,24,4,20,47,42.6,27,11,2,9,14,60,23,1,Matches,2020-2021,La-Liga
Lionel Messi,ar ARG,"FW,MF",Barcelona,33.0,1987.0,33.6,18,10,3,9,6,6,17,35.3,11,12,0,12,6,24,0,2,Matches,2020-2021,La-Liga
Omenuke Mfulu,cd COD,MF,Elche,26.0,1994.0,8.8,18,12,10,8,0,5,15,33.3,10,7,1,6,11,29,18,0,Matches,2020-2021,La-Liga
Míchel,es ESP,MF,Valladolid,32.0,1988.0,10.5,18,11,10,3,5,5,22,22.7,17,10,1,9,9,27,12,1,Matches,2020-2021,La-Liga
Éder Militão,br BRA,DF,Real Madrid,22.0,1998.0,12.6,20,8,13,6,1,8,14,57.1,6,19,6,13,19,39,42,0,Matches,2020-2021,La-Liga
Luis Milla,es ESP,MF,Granada,25.0,1994.0,13.9,22,11,11,10,1,6,28,21.4,22,10,0,10,24,46,16,1,Matches,2020-2021,La-Liga
Pere Milla,es ESP,"FW,MF",Elche,27.0,1992.0,22.0,24,17,12,10,2,8,37,21.6,29,17,5,12,13,37,17,1,Matches,2020-2021,La-Liga
Álex Millán,es ESP,FW,Villarreal,20.0,1999.0,0.0,0,0,0,0,0,0,0,,0,0,0,0,0,0,0,0,Matches,2020-2021,La-Liga
Santi Mina,es ESP,FW,Celta Vigo,24.0,1995.0,26.8,31,13,9,12,10,6,37,16.2,31,15,3,12,6,37,17,0,Matches,2020-2021,La-Liga
Óscar Mingueza,es ESP,DF,Barcelona,21.0,1999.0,21.1,52,33,28,17,7,30,53,56.6,23,19,6,13,20,72,48,2,Matches,2020-2021,La-Liga
Rafa Mir,es ESP,FW,Huesca,23.0,1997.0,32.0,15,9,4,4,7,7,22,31.8,15,13,2,11,15,30,25,0,Matches,2020-2021,La-Liga
Jorge Miramón,es ESP,DF,Levante,31.0,1989.0,19.2,32,22,26,6,0,21,35,60.0,14,22,2,20,26,58,54,0,Matches,2020-2021,La-Liga
Juan Miranda,es ESP,DF,Betis,20.0,2000.0,18.4,27,11,16,9,2,16,32,50.0,16,18,2,16,29,56,58,1,Matches,2020-2021,La-Liga
Luka Modrić,hr CRO,MF,Real Madrid,34.0,1985.0,30.4,37,23,18,16,3,13,36,36.1,23,14,2,12,48,85,14,1,Matches,2020-2021,La-Liga
Johan Mojica,co COL,DF,Elche,27.0,1992.0,13.4,21,10,15,5,1,8,18,44.4,10,15,4,11,15,36,27,0,Matches,2020-2021,La-Liga
Guillem Molina,es ESP,DF,Valencia,20.0,2000.0,1.7,1,0,1,0,0,0,5,0.0,5,1,1,0,4,5,5,0,Matches,2020-2021,La-Liga
Jorge Molina,es ESP,FW,Granada,38.0,1982.0,17.9,11,4,3,5,3,8,22,36.4,14,5,1,4,3,14,19,0,Matches,2020-2021,La-Liga
Victor Mollejo,es ESP,"MF,DF",Getafe,19.0,2001.0,0.8,2,1,1,0,1,0,1,0.0,1,0,0,0,0,2,0,0,Matches,2020-2021,La-Liga
Jon Moncayola,es ESP,MF,Osasuna,22.0,1998.0,29.6,61,36,27,23,11,24,67,35.8,43,27,9,18,23,84,38,0,Matches,2020-2021,La-Liga
Nacho Monreal,es ESP,DF,Real Sociedad,34.0,1986.0,23.1,31,19,17,11,3,7,20,35.0,13,14,3,11,31,62,43,0,Matches,2020-2021,La-Liga
Ángel Montoro,es ESP,MF,Granada,32.0,1988.0,15.1,15,9,7,7,1,4,16,25.0,12,13,3,10,22,37,21,0,Matches,2020-2021,La-Liga
Martín Montoya,es ESP,DF,Betis,29.0,1991.0,2.7,6,3,2,2,2,1,3,33.3,2,1,1,0,2,8,6,0,Matches,2020-2021,La-Liga
Emre Mor,tr TUR,"FW,MF",Celta Vigo,23.0,1997.0,5.6,8,4,1,3,4,0,3,0.0,3,5,0,5,5,13,0,0,Matches,2020-2021,La-Liga
Jon Morcillo,es ESP,"MF,FW",Athletic Club,21.0,1998.0,15.1,16,9,3,6,7,7,30,23.3,23,9,0,9,15,31,11,0,Matches,2020-2021,La-Liga
Alberto Moreno,es ESP,DF,Villarreal,28.0,1992.0,2.1,7,4,7,0,0,2,5,40.0,3,2,1,1,3,10,2,0,Matches,2020-2021,La-Liga
Álex Moreno,es ESP,DF,Betis,27.0,1993.0,19.8,42,26,25,12,5,20,43,46.5,23,18,4,14,35,77,48,0,Matches,2020-2021,La-Liga
Gerard Moreno,es ESP,FW,Villarreal,28.0,1992.0,29.7,24,15,8,10,6,7,34,20.6,27,17,4,13,15,39,26,0,Matches,2020-2021,La-Liga
Tete Morente,es ESP,"MF,FW",Elche,23.0,1996.0,22.4,31,17,17,9,5,9,39,23.1,30,20,0,20,13,44,28,0,Matches,2020-2021,La-Liga
Ilaix Moriba,gn GUI,MF,Barcelona,17.0,2003.0,6.0,14,6,5,7,2,5,10,50.0,5,16,1,15,5,19,4,1,Matches,2020-2021,La-Liga
Loren Morón,es ESP,FW,Betis,26.0,1993.0,11.0,11,7,2,6,3,1,16,6.3,15,11,0,11,3,14,14,0,Matches,2020-2021,La-Liga
Pedro Mosquera,es ESP,MF,Huesca,32.0,1988.0,22.8,38,18,19,18,1,13,53,24.5,40,23,6,17,31,69,38,1,Matches,2020-2021,La-Liga
Javi Moyano,es ESP,DF,Valladolid,34.0,1986.0,1.1,0,0,0,0,0,0,0,,0,2,0,2,0,0,2,0,Matches,2020-2021,La-Liga
Iker Muniain,es ESP,"MF,FW",Athletic Club,27.0,1992.0,21.6,20,7,4,10,6,6,24,25.0,18,15,0,15,11,31,4,0,Matches,2020-2021,La-Liga
Aihen Muñoz,es ESP,DF,Real Sociedad,22.0,1997.0,13.4,23,16,15,5,3,11,19,57.9,8,12,2,10,10,33,31,0,Matches,2020-2021,La-Liga
Joaquín Muñoz,es ESP,FW,Huesca,21.0,1999.0,0.5,0,0,0,0,0,0,2,0.0,2,0,0,0,1,1,0,0,Matches,2020-2021,La-Liga
Jeison Murillo,co COL,DF,Celta Vigo,28.0,1992.0,30.0,45,21,35,9,1,24,44,54.5,20,29,17,12,36,81,100,2,Matches,2020-2021,La-Liga
Yunus Musah,us USA,MF,Valencia,17.0,2002.0,17.0,21,18,12,3,6,8,24,33.3,16,20,0,20,15,36,12,1,Matches,2020-2021,La-Liga
Yoshinori Mutō,jp JPN,"FW,MF",Eibar,28.0,1992.0,12.5,12,7,1,4,7,3,8,37.5,5,5,0,5,3,15,2,0,Matches,2020-2021,La-Liga
Nacho,es ESP,DF,Valladolid,31.0,1989.0,20.1,43,21,29,10,4,24,52,46.2,28,21,1,20,29,72,47,0,Matches,2020-2021,La-Liga
Nacho,es ESP,DF,Real Madrid,30.0,1990.0,22.2,27,14,13,11,3,12,35,34.3,23,19,9,10,40,67,58,0,Matches,2020-2021,La-Liga
Nano,es ESP,FW,Cádiz,25.0,1995.0,0.1,0,0,0,0,0,0,0,,0,0,0,0,0,0,0,0,Matches,2020-2021,La-Liga
Roberto Navarro,es ESP,MF,Real Sociedad,18.0,2002.0,0.4,1,1,1,0,0,0,2,0.0,2,0,0,0,1,2,0,0,Matches,2020-2021,La-Liga
Ximo Navarro,es ESP,DF,Alavés,30.0,1990.0,26.4,54,30,36,17,1,14,30,46.7,16,14,4,10,47,101,75,3,Matches,2020-2021,La-Liga
Jesús Navas,es ESP,DF,Sevilla,34.0,1985.0,31.4,27,21,15,11,1,15,22,68.2,7,10,3,7,37,64,62,1,Matches,2020-2021,La-Liga
Raúl Navas,es ESP,DF,Osasuna,32.0,1988.0,1.9,6,3,5,1,0,4,6,66.7,2,0,0,0,3,9,13,0,Matches,2020-2021,La-Liga
Álvaro Negredo,es ESP,FW,Cádiz,34.0,1985.0,24.4,11,5,3,4,4,5,11,45.5,6,7,2,5,3,14,19,0,Matches,2020-2021,La-Liga
Neto,br BRA,GK,Barcelona,31.0,1989.0,7.0,0,0,0,0,0,0,1,0.0,1,0,0,0,0,0,3,1,Matches,2020-2021,La-Liga
Carlos Neva,es ESP,DF,Granada,24.0,1996.0,20.0,12,6,6,6,0,6,11,54.5,5,16,4,12,27,39,58,0,Matches,2020-2021,La-Liga
Mamor Niang,es ESP,"MF,FW",Getafe,18.0,2002.0,0.2,1,1,0,1,0,0,0,,0,1,0,1,0,1,0,0,Matches,2020-2021,La-Liga
Nieto,es ESP,"FW,DF",Cádiz,22.0,1998.0,0.2,1,1,0,1,0,0,0,,0,0,0,0,0,1,1,0,Matches,2020-2021,La-Liga
Saúl Ñíguez,es ESP,"MF,DF",Atlético Madrid,25.0,1994.0,22.6,57,34,27,23,7,30,59,50.8,29,35,2,33,19,76,43,0,Matches,2020-2021,La-Liga
Nino,es ESP,"FW,MF",Elche,40.0,1980.0,3.2,0,0,0,0,0,0,1,0.0,1,1,0,1,0,0,0,0,Matches,2020-2021,La-Liga
Fernando Niño,es ESP,FW,Villarreal,19.0,2000.0,6.6,8,3,0,4,4,2,9,22.2,7,1,0,1,2,10,2,0,Matches,2020-2021,La-Liga
Nolito,es ESP,"MF,FW",Celta Vigo,33.0,1986.0,28.9,70,36,30,30,10,32,92,34.8,60,46,2,44,22,92,19,0,Matches,2020-2021,La-Liga
Unai Núñez,es ESP,DF,Athletic Club,23.0,1997.0,23.4,23,12,16,7,0,10,15,66.7,5,19,14,5,32,55,110,0,Matches,2020-2021,La-Liga
Kelechi Nwakali,ng NGA,"MF,FW",Huesca,22.0,1998.0,1.6,4,3,1,2,1,0,4,0.0,4,1,0,1,1,5,1,0,Matches,2020-2021,La-Liga
Allan Nyom,cm CMR,"MF,DF",Getafe,32.0,1988.0,25.8,38,23,14,19,5,15,30,50.0,15,16,2,14,22,60,42,0,Matches,2020-2021,La-Liga
Jan Oblak,si SVN,GK,Atlético Madrid,27.0,1993.0,38.0,0,0,0,0,0,0,0,,0,0,0,0,0,0,6,2,Matches,2020-2021,La-Liga
Lucas Ocampos,ar ARG,FW,Sevilla,26.0,1994.0,29.2,36,24,12,16,8,13,37,35.1,24,33,1,32,19,55,30,1,Matches,2020-2021,La-Liga
Álvaro Odriozola,es ESP,DF,Real Madrid,24.0,1995.0,9.2,14,7,5,8,1,3,5,60.0,2,6,3,3,6,20,12,1,Matches,2020-2021,La-Liga
Shinji Okazaki,jp JPN,"FW,MF",Huesca,34.0,1986.0,12.5,7,5,5,0,2,0,5,0.0,5,5,0,5,4,11,6,0,Matches,2020-2021,La-Liga
Lucas Olaza,uy URU,DF,Valladolid,26.0,1994.0,14.0,20,9,11,7,2,9,17,52.9,8,15,7,8,15,35,38,0,Matches,2020-2021,La-Liga
Lucas Olaza,uy URU,DF,Celta Vigo,26.0,1994.0,17.9,25,16,12,12,1,10,18,55.6,8,15,1,14,24,49,34,0,Matches,2020-2021,La-Liga
Christian Oliva,uy URU,MF,Valencia,24.0,1996.0,2.2,2,0,1,1,0,1,6,16.7,5,1,0,1,6,8,0,0,Matches,2020-2021,La-Liga
Kiko Olivas,es ESP,DF,Valladolid,31.0,1988.0,2.0,3,2,2,1,0,3,5,60.0,2,2,2,0,7,10,3,0,Matches,2020-2021,La-Liga
Paulo Oliveira,pt POR,DF,Eibar,28.0,1992.0,29.3,42,21,32,8,2,19,36,52.8,17,39,14,25,59,101,112,0,Matches,2020-2021,La-Liga
Mathías Olivera,uy URU,DF,Getafe,22.0,1997.0,29.0,61,33,31,21,9,32,56,57.1,24,33,3,30,31,92,55,0,Matches,2020-2021,La-Liga
Javier Ontiveros,es ESP,"FW,MF",Huesca,22.0,1997.0,10.2,21,14,10,10,1,9,26,34.6,17,12,0,12,9,30,6,0,Matches,2020-2021,La-Liga
Fabián Orellana,cl CHI,"MF,FW",Valladolid,34.0,1986.0,23.8,33,19,12,14,7,12,55,21.8,43,18,0,18,15,48,9,0,Matches,2020-2021,La-Liga
Mikel Oyarzabal,es ESP,"FW,MF",Real Sociedad,23.0,1997.0,26.8,30,17,14,12,4,10,31,32.3,21,30,5,25,15,45,17,0,Matches,2020-2021,La-Liga
Fernando Pacheco,es ESP,GK,Alavés,28.0,1992.0,37.2,2,0,2,0,0,2,4,50.0,2,0,0,0,2,4,19,0,Matches,2020-2021,La-Liga
Jon Pacheco,es ESP,DF,Real Sociedad,19.0,2001.0,0.4,0,0,0,0,0,0,0,,0,0,0,0,1,1,0,0,Matches,2020-2021,La-Liga
Helibelton Palacios,co COL,DF,Elche,27.0,1993.0,8.3,20,10,16,3,1,8,14,57.1,6,9,1,8,5,25,21,0,Matches,2020-2021,La-Liga
Ante Palaversa,hr CRO,MF,Getafe,20.0,2000.0,0.1,0,0,0,0,0,0,1,0.0,1,0,0,0,0,0,0,0,Matches,2020-2021,La-Liga
Daniel Parejo,es ESP,MF,Villarreal,31.0,1989.0,34.6,65,40,32,23,10,33,81,40.7,48,35,8,27,45,110,21,3,Matches,2020-2021,La-Liga
Thomas Partey,gh GHA,MF,Atlético Madrid,27.0,1993.0,2.2,7,4,4,3,0,5,8,62.5,3,4,1,3,2,9,1,0,Matches,2020-2021,La-Liga
Gabriel Paulista,br BRA,DF,Valencia,29.0,1990.0,30.2,17,11,9,5,3,6,17,35.3,11,32,27,5,59,76,132,3,Matches,2020-2021,La-Liga
Alfonso Pedraza,es ESP,DF,Villarreal,24.0,1996.0,23.3,35,19,16,11,8,11,31,35.5,20,21,5,16,34,69,47,1,Matches,2020-2021,La-Liga
Pedri,es ESP,MF,Barcelona,17.0,2002.0,26.8,44,27,16,16,12,17,71,23.9,54,46,1,45,33,77,7,0,Matches,2020-2021,La-Liga
Facundo Pellistri,uy URU,"MF,FW",Alavés,18.0,2001.0,6.0,8,5,2,4,2,3,13,23.1,10,0,0,0,4,12,3,0,Matches,2020-2021,La-Liga
Rubén Peña,es ESP,DF,Villarreal,29.0,1991.0,12.4,25,14,8,15,2,19,33,57.6,14,20,1,19,13,38,19,0,Matches,2020-2021,La-Liga
Alberto Perea,es ESP,MF,Cádiz,29.0,1990.0,17.2,28,17,12,10,6,9,35,25.7,26,26,1,25,21,49,9,0,Matches,2020-2021,La-Liga
Iñigo Pérez,es ESP,"MF,DF",Osasuna,32.0,1988.0,15.0,20,10,9,6,5,10,16,62.5,6,12,0,12,15,35,8,1,Matches,2020-2021,La-Liga
Juan Pérez,es ESP,GK,Osasuna,24.0,1996.0,3.0,0,0,0,0,0,0,0,,0,0,0,0,0,0,1,0,Matches,2020-2021,La-Liga
Kike Pérez,es ESP,MF,Valladolid,23.0,1997.0,12.9,26,19,8,14,4,7,33,21.2,26,10,1,9,17,43,18,0,Matches,2020-2021,La-Liga
Lucas Pérez,es ESP,FW,Alavés,31.0,1988.0,19.5,6,2,3,3,0,2,10,20.0,8,6,1,5,2,8,5,0,Matches,2020-2021,La-Liga
Luis Pérez,es ESP,DF,Valladolid,25.0,1995.0,14.4,33,17,16,17,0,18,30,60.0,12,26,8,18,14,47,54,1,Matches,2020-2021,La-Liga
Nehuén Pérez,ar ARG,DF,Granada,20.0,2000.0,8.2,6,3,6,0,0,4,6,66.7,2,5,4,1,12,18,33,0,Matches,2020-2021,La-Liga
Pablo Piatti,ar ARG,"MF,FW",Elche,31.0,1989.0,4.0,8,6,3,3,2,3,12,25.0,9,5,0,5,2,10,1,0,Matches,2020-2021,La-Liga
Cristiano Piccini,it ITA,DF,Valencia,27.0,1992.0,0.7,1,1,1,0,0,1,2,50.0,1,0,0,0,0,1,3,0,Matches,2020-2021,La-Liga
Tomás Pina Isla,es ESP,MF,Alavés,32.0,1987.0,28.6,39,18,18,16,5,16,42,38.1,26,28,8,20,37,76,42,0,Matches,2020-2021,La-Liga
Yeremi Pino,es ESP,"FW,MF",Villarreal,17.0,2002.0,8.9,19,11,10,7,2,8,28,28.6,20,20,1,19,9,28,8,0,Matches,2020-2021,La-Liga
Gerard Piqué,es ESP,DF,Barcelona,33.0,1987.0,16.5,16,11,11,5,0,9,12,75.0,3,9,4,5,26,42,46,0,Matches,2020-2021,La-Liga
Miralem Pjanić,ba BIH,MF,Barcelona,30.0,1990.0,7.0,13,8,7,4,2,7,13,53.8,6,5,1,4,11,24,5,0,Matches,2020-2021,La-Liga
Óscar Plano,es ESP,"MF,FW",Valladolid,29.0,1991.0,28.0,42,24,24,12,6,14,46,30.4,32,35,6,29,34,76,43,0,Matches,2020-2021,La-Liga
Dani Plomer,es ESP,FW,Granada,21.0,1998.0,0.5,0,0,0,0,0,0,1,0.0,1,0,0,0,0,0,1,0,Matches,2020-2021,La-Liga
Jorge Pombo,es ESP,"FW,MF",Cádiz,26.0,1994.0,5.8,7,3,3,2,2,1,8,12.5,7,2,0,2,2,9,3,0,Matches,2020-2021,La-Liga
Pere Pons,es ESP,MF,Alavés,27.0,1993.0,13.2,20,10,8,8,4,5,16,31.3,11,15,2,13,7,27,10,0,Matches,2020-2021,La-Liga
Francisco Portillo,es ESP,"MF,FW",Getafe,30.0,1990.0,4.6,5,3,1,4,0,2,14,14.3,12,3,0,3,5,10,1,0,Matches,2020-2021,La-Liga
Portu,es ESP,"FW,MF",Real Sociedad,28.0,1992.0,24.3,18,8,4,10,4,7,36,19.4,29,24,2,22,8,26,5,0,Matches,2020-2021,La-Liga
Sergio Postigo,es ESP,DF,Levante,31.0,1988.0,18.0,16,12,12,3,1,7,18,38.9,11,21,10,11,33,49,84,1,Matches,2020-2021,La-Liga
Darío Poveda,es ESP,FW,Getafe,23.0,1997.0,0.1,0,0,0,0,0,0,0,,0,1,0,1,0,0,0,0,Matches,2020-2021,La-Liga
Alejandro Pozo Pozo,es ESP,"DF,MF",Eibar,21.0,1999.0,24.3,38,22,17,15,6,17,38,44.7,21,35,2,33,27,65,40,1,Matches,2020-2021,La-Liga
Antonio Puertas,es ESP,"FW,MF",Granada,28.0,1992.0,24.1,27,13,9,12,6,10,32,31.3,22,24,5,19,12,39,25,0,Matches,2020-2021,La-Liga
Riqui Puig,es ESP,"MF,FW",Barcelona,20.0,1999.0,3.2,5,3,1,3,1,4,8,50.0,4,0,0,0,1,6,0,0,Matches,2020-2021,La-Liga
Jorge Pulido,es ESP,DF,Huesca,29.0,1991.0,32.1,39,24,31,8,0,17,29,58.6,12,32,18,14,52,91,98,0,Matches,2020-2021,La-Liga
Domingos Quina,pt POR,MF,Granada,20.0,1999.0,3.8,5,5,1,3,1,3,6,50.0,3,8,0,8,2,7,0,0,Matches,2020-2021,La-Liga
Quini,es ESP,DF,Granada,30.0,1989.0,13.2,33,22,23,7,3,19,36,52.8,17,15,6,9,15,48,39,0,Matches,2020-2021,La-Liga
Quique,es ESP,"FW,MF",Eibar,30.0,1990.0,1.9,0,0,0,0,0,0,1,0.0,1,2,0,2,0,0,0,0,Matches,2020-2021,La-Liga
Dani Raba,es ESP,"MF,FW",Villarreal,24.0,1995.0,1.7,2,1,0,1,1,2,8,25.0,6,1,0,1,0,2,0,0,Matches,2020-2021,La-Liga
Uroš Račić,rs SRB,MF,Valencia,22.0,1998.0,24.3,38,22,16,16,6,16,54,29.6,38,33,11,22,26,64,54,0,Matches,2020-2021,La-Liga
Nemanja Radoja,rs SRB,MF,Levante,27.0,1993.0,12.5,23,15,12,10,1,5,19,26.3,14,9,3,6,19,42,12,1,Matches,2020-2021,La-Liga
Ivan Rakitić,hr CRO,MF,Sevilla,32.0,1988.0,24.8,32,18,18,10,4,12,41,29.3,29,19,4,15,26,58,29,1,Matches,2020-2021,La-Liga
Jonás Ramalho,es ESP,DF,Osasuna,27.0,1993.0,3.4,5,4,4,0,1,1,3,33.3,2,3,0,3,2,7,7,0,Matches,2020-2021,La-Liga
Sandro Ramírez,es ESP,FW,Huesca,25.0,1995.0,14.3,13,9,3,8,2,4,11,36.4,7,11,1,10,10,23,2,0,Matches,2020-2021,La-Liga
Sergio Ramos,es ESP,DF,Real Madrid,34.0,1986.0,14.2,15,12,8,6,1,6,10,60.0,4,9,5,4,19,34,39,1,Matches,2020-2021,La-Liga
Recio,es ESP,MF,Eibar,29.0,1991.0,8.2,17,5,4,8,5,8,18,44.4,10,6,0,6,4,21,1,0,Matches,2020-2021,La-Liga
Francisco Reis Ferreira,pt POR,DF,Valencia,23.0,1997.0,2.0,1,1,1,0,0,0,3,0.0,3,0,0,0,0,1,6,0,Matches,2020-2021,La-Liga
Karim Rekik,nl NED,DF,Sevilla,25.0,1994.0,7.3,7,5,2,5,0,1,4,25.0,3,8,3,5,6,13,17,0,Matches,2020-2021,La-Liga
Álex Remiro,es ESP,GK,Real Sociedad,25.0,1995.0,38.0,0,0,0,0,0,0,1,0.0,1,0,0,0,3,3,14,0,Matches,2020-2021,La-Liga
Oriol Rey,es ESP,MF,Valladolid,22.0,1998.0,0.2,0,0,0,0,0,0,0,,0,0,0,0,1,1,0,0,Matches,2020-2021,La-Liga
Mikel Rico,es ESP,MF,Huesca,35.0,1984.0,24.3,24,12,14,8,2,11,34,32.4,23,20,3,17,23,47,22,0,Matches,2020-2021,La-Liga
Emiliano Rigoni,ar ARG,MF,Elche,27.0,1993.0,12.7,12,7,3,8,1,3,15,20.0,12,16,1,15,6,18,9,0,Matches,2020-2021,La-Liga
Luis Rioja,es ESP,"MF,FW",Alavés,26.0,1993.0,23.2,21,14,11,7,3,7,39,17.9,32,23,1,22,20,41,29,0,Matches,2020-2021,La-Liga
Rober,es ESP,"DF,MF",Levante,25.0,1995.0,15.8,15,8,8,4,3,8,18,44.4,10,24,16,8,34,49,52,1,Matches,2020-2021,La-Liga
Roberto,es ESP,GK,Valladolid,34.0,1986.0,13.0,0,0,0,0,0,0,1,0.0,1,0,0,0,0,0,7,0,Matches,2020-2021,La-Liga
Sergi Roberto,es ESP,"DF,FW",Barcelona,28.0,1992.0,10.5,9,6,5,2,2,7,13,53.8,6,12,6,6,10,19,20,0,Matches,2020-2021,La-Liga
Joel Robles,es ESP,GK,Betis,30.0,1990.0,18.0,0,0,0,0,0,0,1,0.0,1,1,0,1,0,0,11,2,Matches,2020-2021,La-Liga
Rubén Rochina,es ESP,MF,Levante,29.0,1991.0,15.6,38,28,12,23,3,12,35,34.3,23,22,2,20,22,60,7,0,Matches,2020-2021,La-Liga
Rodri,es ESP,"FW,MF",Betis,20.0,2000.0,6.0,3,3,1,2,0,1,6,16.7,5,7,0,7,2,5,0,0,Matches,2020-2021,La-Liga
Kévin Rodrigues,pt POR,"DF,MF",Eibar,26.0,1994.0,12.2,16,8,8,5,3,7,23,30.4,16,10,1,9,20,36,15,1,Matches,2020-2021,La-Liga
Ángel Rodríguez,es ESP,"FW,MF",Getafe,33.0,1987.0,15.3,7,4,1,4,2,1,16,6.3,15,7,0,7,2,9,8,0,Matches,2020-2021,La-Liga
Óscar Rodríguez Arnaiz,es ESP,"MF,FW",Sevilla,22.0,1998.0,5.7,15,9,3,8,4,6,13,46.2,7,2,0,2,10,25,1,0,Matches,2020-2021,La-Liga
Guido Rodríguez,ar ARG,MF,Betis,26.0,1994.0,31.8,97,55,52,39,6,39,84,46.4,45,52,14,38,68,165,58,2,Matches,2020-2021,La-Liga
Miguel Rodríguez,es ESP,"FW,DF",Celta Vigo,17.0,2003.0,0.3,1,1,0,1,0,0,0,,0,0,0,0,0,1,0,0,Matches,2020-2021,La-Liga
Víctor Rodríguez,es ESP,MF,Elche,31.0,1989.0,4.7,4,3,3,1,0,0,9,0.0,9,5,1,4,5,9,4,0,Matches,2020-2021,La-Liga
Rodrygo,br BRA,FW,Real Madrid,19.0,2001.0,10.9,15,6,10,4,1,2,17,11.8,15,15,0,15,7,22,4,0,Matches,2020-2021,La-Liga
Facundo Roncaglia,ar ARG,DF,Osasuna,33.0,1987.0,13.7,25,14,14,11,0,11,20,55.0,9,11,6,5,25,50,26,0,Matches,2020-2021,La-Liga
Rubén,es ESP,GK,Osasuna,36.0,1984.0,2.1,0,0,0,0,0,0,0,,0,0,0,0,0,0,1,0,Matches,2020-2021,La-Liga
Waldo Rubio,es ESP,"FW,MF",Valladolid,24.0,1995.0,4.2,6,4,2,2,2,1,14,7.1,13,6,0,6,3,9,3,0,Matches,2020-2021,La-Liga
Aitor Ruibal,es ESP,"FW,MF",Betis,24.0,1996.0,17.7,32,18,14,14,4,10,35,28.6,25,26,0,26,11,43,8,0,Matches,2020-2021,La-Liga
Isma Ruiz,es ESP,MF,Granada,19.0,2001.0,0.7,1,0,0,1,0,0,1,0.0,1,0,0,0,0,1,3,0,Matches,2020-2021,La-Liga
Víctor Ruiz,es ESP,DF,Betis,31.0,1989.0,24.0,11,7,7,4,0,4,13,30.8,9,16,13,3,44,55,85,0,Matches,2020-2021,La-Liga
Gerónimo Rulli,ar ARG,GK,Villarreal,28.0,1992.0,2.0,0,0,0,0,0,0,0,,0,0,0,0,0,0,0,1,Matches,2020-2021,La-Liga
Modibo Sagnan,ml MLI,DF,Real Sociedad,21.0,1999.0,6.9,12,7,6,6,0,4,6,66.7,2,7,2,5,6,18,25,1,Matches,2020-2021,La-Liga
Borja Sainz,es ESP,"MF,FW",Alavés,19.0,2001.0,5.0,7,3,3,2,2,4,16,25.0,12,4,0,4,6,13,1,0,Matches,2020-2021,La-Liga
Salvi,es ESP,"MF,FW",Cádiz,29.0,1991.0,21.5,18,10,14,3,1,8,26,30.8,18,14,1,13,20,38,24,0,Matches,2020-2021,La-Liga
Fede San Emeterio,es ESP,MF,Valladolid,23.0,1997.0,16.2,25,14,15,7,3,11,31,35.5,20,23,8,15,28,53,33,0,Matches,2020-2021,La-Liga
Antonio Sanabria,py PAR,FW,Betis,24.0,1996.0,10.4,5,5,0,4,1,0,2,0.0,2,8,1,7,3,8,9,0,Matches,2020-2021,La-Liga
Oihan Sancet,es ESP,"FW,MF",Athletic Club,20.0,2000.0,11.5,8,2,3,4,1,2,7,28.6,5,4,0,4,5,13,7,0,Matches,2020-2021,La-Liga
Ricard Sánchez,es ESP,DF,Atlético Madrid,20.0,2000.0,0.3,1,1,0,0,1,0,0,,0,1,0,1,0,1,1,0,Matches,2020-2021,La-Liga
Germán Sánchez,es ESP,DF,Granada,33.0,1986.0,29.3,24,11,13,9,2,11,23,47.8,12,28,26,2,38,62,130,1,Matches,2020-2021,La-Liga
Javi Sánchez,es ESP,DF,Valladolid,23.0,1997.0,10.2,15,10,10,4,1,9,10,90.0,1,15,7,8,15,30,37,0,Matches,2020-2021,La-Liga
Manu Sánchez,es ESP,DF,Osasuna,19.0,2000.0,10.8,27,15,10,10,7,11,25,44.0,14,8,0,8,8,35,14,0,Matches,2020-2021,La-Liga
Manu Sánchez,es ESP,DF,Atlético Madrid,19.0,2000.0,0.5,0,0,0,0,0,0,1,0.0,1,1,0,1,0,0,1,0,Matches,2020-2021,La-Liga
Juan Sánchez Miño,ar ARG,"DF,MF",Elche,30.0,1990.0,5.5,8,5,5,3,0,6,14,42.9,8,4,0,4,4,12,7,0,Matches,2020-2021,La-Liga
Pepe Sánchez,es ESP,DF,Granada,20.0,2000.0,2.8,4,2,2,2,0,3,4,75.0,1,5,2,3,4,8,9,0,Matches,2020-2021,La-Liga
Oier Sanjurjo,es ESP,MF,Osasuna,34.0,1986.0,23.2,39,16,8,27,4,17,60,28.3,43,24,6,18,29,68,41,0,Matches,2020-2021,La-Liga
Ivan Šaponjić,rs SRB,FW,Cádiz,22.0,1997.0,4.3,1,0,0,1,0,0,2,0.0,2,2,0,2,1,2,4,0,Matches,2020-2021,La-Liga
Stefan Savić,me MNE,DF,Atlético Madrid,29.0,1991.0,32.8,40,25,32,7,1,21,34,61.8,13,33,19,14,42,82,110,0,Matches,2020-2021,La-Liga
Jaime Seoane,es ESP,MF,Huesca,23.0,1997.0,22.9,50,31,20,23,7,24,65,36.9,41,27,6,21,17,67,14,0,Matches,2020-2021,La-Liga
Edgar Sevikyan,am ARM,MF,Levante,18.0,2001.0,0.1,0,0,0,0,0,0,0,,0,0,0,0,0,0,0,0,Matches,2020-2021,La-Liga
Sidnei,br BRA,DF,Betis,30.0,1989.0,7.7,9,3,6,3,0,4,9,44.4,5,6,4,2,16,25,28,0,Matches,2020-2021,La-Liga
David Silva,es ESP,MF,Real Sociedad,34.0,1986.0,15.5,19,12,2,14,3,8,21,38.1,13,14,1,13,13,32,8,2,Matches,2020-2021,La-Liga
Gastón Silva,uy URU,DF,Huesca,26.0,1994.0,6.7,16,12,11,5,0,8,14,57.1,6,10,4,6,11,27,16,0,Matches,2020-2021,La-Liga
Rui Silva,pt POR,GK,Granada,26.0,1994.0,32.0,1,0,1,0,0,1,3,33.3,2,0,0,0,2,3,14,0,Matches,2020-2021,La-Liga
Unai Simón,es ESP,GK,Athletic Club,23.0,1997.0,37.0,1,0,1,0,0,1,2,50.0,1,0,0,0,0,1,7,7,Matches,2020-2021,La-Liga
Dimitris Siovas,gr GRE,DF,Huesca,31.0,1988.0,34.1,46,24,34,10,2,20,30,66.7,10,38,17,21,62,108,125,2,Matches,2020-2021,La-Liga
Antonio Sivera,es ESP,GK,Alavés,23.0,1996.0,0.8,0,0,0,0,0,0,0,,0,0,0,0,0,0,0,0,Matches,2020-2021,La-Liga
Rafa Soares,pt POR,DF,Eibar,25.0,1995.0,12.6,28,17,16,8,4,15,21,71.4,6,14,4,10,20,48,32,0,Matches,2020-2021,La-Liga
Rubén Sobrino,es ESP,"MF,FW",Valencia,28.0,1992.0,0.5,1,1,1,0,0,0,1,0.0,1,0,0,0,0,1,1,0,Matches,2020-2021,La-Liga
Rubén Sobrino,es ESP,"FW,MF",Cádiz,28.0,1992.0,12.4,29,13,8,16,5,8,18,44.4,10,19,0,19,15,44,11,0,Matches,2020-2021,La-Liga
Augusto Solari,ar ARG,MF,Celta Vigo,28.0,1992.0,5.4,18,13,9,8,1,6,26,23.1,20,13,1,12,6,24,5,0,Matches,2020-2021,La-Liga
Roberto Soldado,es ESP,FW,Granada,35.0,1985.0,16.0,7,4,1,4,2,2,11,18.2,9,8,0,8,4,11,13,1,Matches,2020-2021,La-Liga
Carlos Soler,es ESP,MF,Valencia,23.0,1997.0,30.4,41,24,14,24,3,19,52,36.5,33,35,11,24,23,64,41,0,Matches,2020-2021,La-Liga
Son,es ESP,"DF,MF",Levante,26.0,1994.0,12.3,18,10,11,6,1,9,19,47.4,10,11,2,9,12,30,20,0,Matches,2020-2021,La-Liga
David Soria,es ESP,GK,Getafe,27.0,1993.0,28.0,2,2,2,0,0,1,3,33.3,2,0,0,0,1,3,12,0,Matches,2020-2021,La-Liga
Alberto Soro,es ESP,"FW,MF",Granada,21.0,1999.0,4.4,7,2,2,4,1,4,10,40.0,6,7,0,7,1,8,2,0,Matches,2020-2021,La-Liga
Hugo Sotelo,es ESP,MF,Celta Vigo,16.0,2003.0,0.0,0,0,0,0,0,0,0,,0,0,0,0,0,0,0,0,Matches,2020-2021,La-Liga
Damián Suárez,uy URU,DF,Getafe,32.0,1988.0,27.0,59,39,29,23,7,30,81,37.0,51,43,2,41,31,90,42,0,Matches,2020-2021,La-Liga
Denis Suárez,es ESP,MF,Celta Vigo,26.0,1994.0,31.7,64,32,22,30,12,21,94,22.3,73,30,2,28,22,86,15,2,Matches,2020-2021,La-Liga
Luis Suárez,uy URU,FW,Atlético Madrid,33.0,1987.0,27.9,11,7,0,4,7,3,12,25.0,9,7,0,7,5,16,13,0,Matches,2020-2021,La-Liga
Suso,es ESP,FW,Sevilla,26.0,1993.0,24.6,20,10,8,6,6,10,41,24.4,31,12,0,12,8,28,8,0,Matches,2020-2021,La-Liga
Tachi,es ESP,DF,Alavés,22.0,1997.0,9.4,11,9,9,2,0,6,14,42.9,8,9,6,3,11,22,32,0,Matches,2020-2021,La-Liga
Renato Tapia,pe PER,MF,Celta Vigo,25.0,1995.0,30.0,93,44,50,34,9,32,83,38.6,51,56,13,43,53,146,75,2,Matches,2020-2021,La-Liga
Tomás Tavares,pt POR,"MF,DF",Alavés,19.0,2001.0,0.7,2,1,2,0,0,2,2,100.0,0,1,0,1,0,2,1,0,Matches,2020-2021,La-Liga
Álvaro Tejero,es ESP,DF,Eibar,24.0,1996.0,1.2,1,1,0,0,1,1,3,33.3,2,1,0,1,3,4,6,0,Matches,2020-2021,La-Liga
Cristian Tello,es ESP,"FW,MF",Betis,28.0,1991.0,14.3,16,10,5,9,2,4,22,18.2,18,14,0,14,11,27,8,0,Matches,2020-2021,La-Liga
Marc-André ter Stegen,de GER,GK,Barcelona,28.0,1992.0,31.0,0,0,0,0,0,0,2,0.0,2,0,0,0,0,0,12,2,Matches,2020-2021,La-Liga
David Timor,es ESP,"MF,DF",Getafe,30.0,1989.0,15.5,13,9,5,6,2,9,21,42.9,12,5,1,4,19,32,32,1,Matches,2020-2021,La-Liga
Toño,es ESP,"DF,FW",Levante,30.0,1989.0,8.1,4,0,4,0,0,0,2,0.0,2,10,1,9,7,11,12,0,Matches,2020-2021,La-Liga
Lucas Torreira,uy URU,MF,Atlético Madrid,24.0,1996.0,5.8,8,4,2,3,3,0,3,0.0,3,5,3,2,12,20,8,0,Matches,2020-2021,La-Liga
Óliver Torres,es ESP,"MF,FW",Sevilla,25.0,1994.0,15.6,34,22,13,15,6,19,53,35.8,34,15,0,15,15,49,9,0,Matches,2020-2021,La-Liga
Pau Torres,es ESP,DF,Villarreal,23.0,1997.0,33.0,17,11,10,5,2,11,18,61.1,7,33,25,8,23,40,111,1,Matches,2020-2021,La-Liga
Roberto Torres,es ESP,"MF,FW",Osasuna,31.0,1989.0,21.0,15,8,6,5,4,8,29,27.6,21,12,0,12,16,31,13,0,Matches,2020-2021,La-Liga
Lucas Torró,es ESP,MF,Osasuna,26.0,1994.0,17.2,32,15,11,19,2,21,34,61.8,13,16,7,9,27,59,43,0,Matches,2020-2021,La-Liga
Manu Trigueros,es ESP,MF,Villarreal,28.0,1991.0,28.1,51,30,25,21,5,21,77,27.3,56,32,2,30,17,68,19,0,Matches,2020-2021,La-Liga
Francisco Trincão,pt POR,"FW,MF",Barcelona,20.0,1999.0,7.8,4,2,0,3,1,2,5,40.0,3,4,0,4,1,5,2,0,Matches,2020-2021,La-Liga
Kieran Trippier,eng ENG,DF,Atlético Madrid,29.0,1990.0,27.5,61,39,30,25,6,26,52,50.0,26,22,4,18,40,101,58,1,Matches,2020-2021,La-Liga
Samuel Umtiti,fr FRA,DF,Barcelona,26.0,1993.0,7.2,5,1,3,2,0,1,2,50.0,1,11,6,5,9,14,15,0,Matches,2020-2021,La-Liga
Enes Ünal,tr TUR,FW,Getafe,23.0,1997.0,14.6,11,3,0,8,3,4,15,26.7,11,11,0,11,2,13,14,0,Matches,2020-2021,La-Liga
Tomáš Vaclík,cz CZE,GK,Sevilla,31.0,1989.0,5.0,0,0,0,0,0,0,1,0.0,1,0,0,0,0,0,0,1,Matches,2020-2021,La-Liga
Eugeni Valderrama,es ESP,"MF,FW",Huesca,26.0,1994.0,1.3,2,2,1,0,1,0,1,0.0,1,0,0,0,5,7,3,0,Matches,2020-2021,La-Liga
Jesús Vallejo,es ESP,DF,Granada,23.0,1997.0,15.0,11,6,7,3,1,7,18,38.9,11,21,11,10,13,24,55,0,Matches,2020-2021,La-Liga
Manu Vallejo,es ESP,"FW,MF",Valencia,23.0,1997.0,10.6,18,8,5,8,5,5,26,19.2,21,8,0,8,3,21,3,0,Matches,2020-2021,La-Liga
Federico Valverde,uy URU,MF,Real Madrid,22.0,1998.0,14.8,25,16,9,8,8,10,26,38.5,16,16,2,14,22,47,4,0,Matches,2020-2021,La-Liga
Raphaël Varane,fr FRA,DF,Real Madrid,27.0,1993.0,30.2,22,14,16,5,1,10,19,52.6,9,26,18,8,36,58,114,2,Matches,2020-2021,La-Liga
Denis Vavro,sk SVK,DF,Huesca,24.0,1996.0,6.8,7,4,2,4,1,2,5,40.0,3,2,0,2,11,18,21,0,Matches,2020-2021,La-Liga
Franco Vázquez,ar ARG,"FW,MF",Sevilla,31.0,1989.0,1.8,5,1,0,3,2,1,5,20.0,4,2,1,1,1,6,1,0,Matches,2020-2021,La-Liga
Kevin Vázquez,es ESP,DF,Celta Vigo,27.0,1993.0,6.2,11,5,9,2,0,3,9,33.3,6,8,0,8,9,20,18,0,Matches,2020-2021,La-Liga
Lucas Vázquez,es ESP,"DF,FW",Real Madrid,29.0,1991.0,20.5,61,37,30,22,9,22,52,42.3,30,14,1,13,19,80,31,1,Matches,2020-2021,La-Liga
Koke Vegas,es ESP,GK,Levante,24.0,1995.0,1.0,0,0,0,0,0,0,0,,0,0,0,0,0,0,1,1,Matches,2020-2021,La-Liga
Gabriel Veiga,es ESP,"MF,DF",Celta Vigo,18.0,2002.0,1.3,3,0,3,0,0,1,4,25.0,3,3,0,3,3,6,0,0,Matches,2020-2021,La-Liga
Unai Vencedor Paris,es ESP,MF,Athletic Club,19.0,2000.0,18.9,31,21,10,15,6,11,42,26.2,31,17,6,11,18,49,14,0,Matches,2020-2021,La-Liga
Gonzalo Verdú,es ESP,DF,Elche,31.0,1988.0,32.7,34,19,26,8,0,16,28,57.1,12,40,30,10,52,86,113,0,Matches,2020-2021,La-Liga
Mikel Vesga,es ESP,MF,Athletic Club,27.0,1993.0,19.1,27,14,8,16,3,11,49,22.4,38,28,8,20,27,54,35,1,Matches,2020-2021,La-Liga
Rúben Vezo,pt POR,DF,Levante,26.0,1994.0,25.7,34,19,26,7,1,12,28,42.9,16,23,12,11,45,79,106,3,Matches,2020-2021,La-Liga
Iñigo Vicente,es ESP,"FW,MF",Athletic Club,22.0,1998.0,0.6,1,1,1,0,0,1,1,100.0,0,0,0,0,0,1,0,0,Matches,2020-2021,La-Liga
Fede Vico,es ESP,"MF,FW",Granada,26.0,1994.0,8.5,10,6,5,5,0,3,10,30.0,7,15,1,14,12,22,5,0,Matches,2020-2021,La-Liga
Aleix Vidal,es ESP,DF,Sevilla,30.0,1989.0,6.6,9,5,5,3,1,5,12,41.7,7,10,1,9,12,21,9,0,Matches,2020-2021,La-Liga
Nacho Vidal,es ESP,DF,Osasuna,25.0,1995.0,26.1,56,28,27,22,7,22,31,71.0,9,39,10,29,43,99,68,0,Matches,2020-2021,La-Liga
Toni Villa,es ESP,"MF,FW",Valladolid,25.0,1995.0,10.8,31,16,11,14,6,15,42,35.7,27,15,1,14,5,36,3,0,Matches,2020-2021,La-Liga
Asier Villalibre,es ESP,FW,Athletic Club,22.0,1997.0,17.7,3,2,0,2,1,2,8,25.0,6,4,0,4,2,5,16,0,Matches,2020-2021,La-Liga
Iván Villar,es ESP,GK,Celta Vigo,23.0,1997.0,19.8,0,0,0,0,0,0,1,0.0,1,0,0,0,0,0,18,0,Matches,2020-2021,La-Liga
Vitolo,es ESP,"MF,FW",Atlético Madrid,30.0,1989.0,3.3,4,1,2,0,2,1,6,16.7,5,3,0,3,3,7,2,0,Matches,2020-2021,La-Liga
Šime Vrsaljko,hr CRO,"FW,DF",Atlético Madrid,28.0,1992.0,5.8,18,12,13,5,0,8,12,66.7,4,5,0,5,8,26,14,0,Matches,2020-2021,La-Liga
Nikola Vukčević,me MNE,MF,Levante,28.0,1991.0,9.0,14,7,5,8,1,9,18,50.0,9,8,5,3,8,22,12,1,Matches,2020-2021,La-Liga
Daniel Wass,dk DEN,"MF,DF",Valencia,31.0,1989.0,33.1,52,31,21,29,2,22,55,40.0,33,33,13,20,47,99,69,0,Matches,2020-2021,La-Liga
Shon Weissman,il ISR,FW,Valladolid,24.0,1996.0,23.7,12,9,4,5,3,2,23,8.7,21,17,3,14,8,20,7,0,Matches,2020-2021,La-Liga
Iñaki Williams,gh GHA,FW,Athletic Club,26.0,1994.0,26.5,11,7,0,4,7,2,14,14.3,12,13,1,12,5,16,22,0,Matches,2020-2021,La-Liga
Nico Williams,es ESP,MF,Athletic Club,18.0,2002.0,0.6,1,0,1,0,0,0,2,0.0,2,0,0,0,1,2,0,0,Matches,2020-2021,La-Liga
Jawad El Yamiq,ma MAR,DF,Valladolid,28.0,1992.0,15.3,21,14,14,7,0,8,11,72.7,3,15,10,5,46,67,100,0,Matches,2020-2021,La-Liga
Rubén Yáñez,es ESP,GK,Getafe,26.0,1993.0,10.0,0,0,0,0,0,0,1,0.0,1,0,0,0,2,2,2,0,Matches,2020-2021,La-Liga
Yoel,es ESP,GK,Eibar,31.0,1988.0,3.3,0,0,0,0,0,0,0,,0,0,0,0,0,0,2,0,Matches,2020-2021,La-Liga
Okay Yokuşlu,tr TUR,MF,Celta Vigo,26.0,1994.0,5.1,14,8,8,4,2,5,9,55.6,4,5,2,3,10,24,9,0,Matches,2020-2021,La-Liga
Joseba Zaldúa,es ESP,DF,Real Sociedad,28.0,1992.0,7.1,15,12,7,5,3,6,18,33.3,12,6,2,4,6,21,13,0,Matches,2020-2021,La-Liga
Oier Zarraga,es ESP,MF,Athletic Club,21.0,1999.0,1.1,1,1,0,1,0,1,2,50.0,1,1,0,1,0,1,0,0,Matches,2020-2021,La-Liga
Igor Zubeldia,es ESP,DF,Real Sociedad,23.0,1997.0,21.8,23,16,15,8,0,8,14,57.1,6,20,13,7,12,35,46,0,Matches,2020-2021,La-Liga
Martín Zubimendi,es ESP,MF,Real Sociedad,21.0,1999.0,20.9,41,22,18,20,3,20,34,58.8,14,22,10,12,40,81,39,0,Matches,2020-2021,La-Liga
Martin Ødegaard,no NOR,MF,Real Madrid,21.0,1998.0,2.6,1,0,0,1,0,1,2,50.0,1,1,0,1,1,2,0,0,Matches,2020-2021,La-Liga
Luis Abram,pe PER,DF,Granada,25.0,1996.0,6.2,6,3,3,3,0,2,4,50.0,2,6,5,1,5,11,37,1,Matches,2021-2022,La-Liga
Marcos Acuña,ar ARG,DF,Sevilla,29.0,1991.0,25.1,50,29,27,14,9,30,46,65.2,16,22,5,17,14,64,25,1,Matches,2021-2022,La-Liga
Martin Agirregabiria,es ESP,DF,Alavés,25.0,1996.0,18.0,34,22,17,11,6,18,37,48.6,19,20,3,17,25,59,38,0,Matches,2021-2022,La-Liga
Julen Agirrezabala,es ESP,GK,Athletic Club,20.0,2000.0,4.0,0,0,0,0,0,0,0,,0,0,0,0,0,0,2,0,Matches,2021-2022,La-Liga
Sergio Agüero,ar ARG,FW,Barcelona,33.0,1988.0,1.7,1,1,0,0,1,0,2,0.0,2,0,0,0,0,1,0,0,Matches,2021-2022,La-Liga
Álvaro Aguirre,es ESP,FW,Rayo Vallecano,21.0,2000.0,0.1,0,0,0,0,0,0,0,,0,0,0,0,0,0,0,0,Matches,2021-2022,La-Liga
Joseph Aidoo,gh GHA,DF,Celta Vigo,25.0,1995.0,29.3,39,26,28,10,1,17,31,54.8,14,23,13,10,38,77,96,3,Matches,2021-2022,La-Liga
Carlos Akapo,gq EQG,DF,Cádiz,28.0,1993.0,20.5,43,31,26,15,2,21,37,56.8,16,26,7,19,51,94,61,0,Matches,2021-2022,La-Liga
Ilias Akhomach,ma MAR,FW,Barcelona,17.0,2004.0,1.4,2,0,0,1,1,0,0,,0,0,0,0,0,2,0,0,Matches,2021-2022,La-Liga
Paul Akouokou,ci CIV,MF,Betis,23.0,1997.0,5.7,14,9,5,7,2,8,12,66.7,4,6,0,6,11,25,6,0,Matches,2021-2022,La-Liga
David Alaba,at AUT,DF,Real Madrid,29.0,1992.0,29.4,23,13,15,6,2,9,19,47.4,10,26,15,11,22,45,70,1,Matches,2021-2022,La-Liga
Tomás Alarcón,cl CHI,MF,Cádiz,22.0,1999.0,15.8,31,20,17,10,4,10,31,32.3,21,19,7,12,30,61,31,0,Matches,2021-2022,La-Liga
Jordi Alba,es ESP,DF,Barcelona,32.0,1989.0,29.4,47,34,12,26,9,27,47,57.4,20,26,6,20,33,80,41,1,Matches,2021-2022,La-Liga
Raúl Albiol,es ESP,DF,Villarreal,35.0,1985.0,27.4,26,15,20,5,1,14,18,77.8,4,24,15,9,21,47,126,1,Matches,2021-2022,La-Liga
Paco Alcácer,es ESP,FW,Villarreal,27.0,1993.0,8.7,9,3,2,4,3,1,5,20.0,4,7,0,7,6,15,1,0,Matches,2021-2022,La-Liga
Rubén Alcaraz,es ESP,MF,Cádiz,30.0,1991.0,12.3,41,20,14,24,3,22,45,48.9,23,10,2,8,13,54,14,0,Matches,2021-2022,La-Liga
Omar Alderete,py PAR,DF,Valencia,24.0,1996.0,26.7,53,34,34,17,2,34,53,64.2,19,30,18,12,35,88,153,0,Matches,2021-2022,La-Liga
Iván Alejo,es ESP,"MF,FW",Cádiz,26.0,1995.0,11.8,33,15,21,10,2,15,44,34.1,29,12,0,12,8,41,17,0,Matches,2021-2022,La-Liga
Carles Aleñá,es ESP,MF,Getafe,23.0,1998.0,25.8,27,19,11,13,3,9,48,18.8,39,21,2,19,15,42,16,0,Matches,2021-2022,La-Liga
Hugo Álvarez,es ESP,FW,Celta Vigo,18.0,2003.0,0.1,1,0,1,0,0,0,0,,0,0,0,0,0,1,1,0,Matches,2021-2022,La-Liga
Yeray Álvarez,es ESP,DF,Athletic Club,26.0,1995.0,20.7,24,14,15,8,1,10,18,55.6,8,21,16,5,45,69,97,0,Matches,2021-2022,La-Liga
Dani Alves,br BRA,DF,Barcelona,38.0,1983.0,12.2,30,19,13,13,4,14,26,53.8,12,10,3,7,11,41,10,2,Matches,2021-2022,La-Liga
Emmanuel Amankwaa Akurugu,gh GHA,DF,Getafe,19.0,2001.0,0.9,0,0,0,0,0,0,2,0.0,2,1,0,1,0,0,0,0,Matches,2021-2022,La-Liga
Amath,sn SEN,"FW,MF",Mallorca,25.0,1996.0,9.8,21,11,11,6,4,7,17,41.2,10,12,0,12,7,28,7,0,Matches,2021-2022,La-Liga
Florin Andone,ro ROU,FW,Cádiz,28.0,1993.0,2.0,1,1,1,0,0,0,1,0.0,1,2,0,2,0,1,1,0,Matches,2021-2022,La-Liga
Marcos André,br BRA,"FW,MF",Valencia,24.0,1996.0,10.8,15,11,4,6,5,5,16,31.3,11,15,0,15,7,22,13,0,Matches,2021-2022,La-Liga
José Ángel,es ESP,DF,Osasuna,31.0,1989.0,12.0,20,13,9,9,2,9,14,64.3,5,6,1,5,10,30,21,0,Matches,2021-2022,La-Liga
Josep Antoni Gayá,es ESP,DF,Mallorca,21.0,2000.0,0.6,0,0,0,0,0,0,0,,0,1,0,1,1,1,3,1,Matches,2021-2022,La-Liga
Mauro Arambarri,uy URU,MF,Getafe,25.0,1995.0,29.6,62,37,19,32,11,20,68,29.4,48,35,5,30,32,94,18,0,Matches,2021-2022,La-Liga
Néstor Araujo,mx MEX,DF,Celta Vigo,29.0,1991.0,29.1,22,14,17,5,0,9,21,42.9,12,17,10,7,27,49,105,2,Matches,2021-2022,La-Liga
Ronald Araújo,uy URU,DF,Barcelona,22.0,1999.0,25.2,41,23,29,12,0,21,25,84.0,4,37,20,17,23,64,66,1,Matches,2021-2022,La-Liga
Jesús Areso,es ESP,DF,Osasuna,22.0,1999.0,2.1,3,3,2,1,0,0,2,0.0,2,0,0,0,0,3,2,1,Matches,2021-2022,La-Liga
Matias Arezo,uy URU,"FW,MF",Granada,18.0,2002.0,1.8,5,3,2,1,2,4,9,44.4,5,1,0,1,1,6,1,0,Matches,2021-2022,La-Liga
Santiago Arias,co COL,DF,Granada,29.0,1992.0,4.9,12,5,8,3,1,4,9,44.4,5,8,4,4,5,17,10,0,Matches,2021-2022,La-Liga
Santiago Arzamendia,py PAR,MF,Cádiz,23.0,1998.0,5.2,14,6,6,5,3,6,13,46.2,7,6,0,6,4,18,7,0,Matches,2021-2022,La-Liga
Sergio Asenjo,es ESP,GK,Villarreal,32.0,1989.0,6.0,0,0,0,0,0,0,1,0.0,1,0,0,0,1,1,6,0,Matches,2021-2022,La-Liga
Alejandro Asensio,es ESP,FW,Rayo Vallecano,20.0,2000.0,0.1,0,0,0,0,0,0,0,,0,0,0,0,0,0,0,0,Matches,2021-2022,La-Liga
Marco Asensio,es ESP,"FW,MF",Real Madrid,25.0,1996.0,19.2,12,8,6,4,2,4,18,22.2,14,8,1,7,12,24,6,1,Matches,2021-2022,La-Liga
Iago Aspas,es ESP,FW,Celta Vigo,33.0,1987.0,34.3,14,7,1,5,8,4,24,16.7,20,23,2,21,11,25,19,0,Matches,2021-2022,La-Liga
Pierre-Emerick Aubameyang,ga GAB,FW,Barcelona,32.0,1989.0,12.0,2,2,0,1,1,0,5,0.0,5,9,1,8,2,4,4,0,Matches,2021-2022,La-Liga
Ludwig Augustinsson,se SWE,"DF,FW",Sevilla,27.0,1994.0,8.8,18,14,11,3,4,8,13,61.5,5,10,3,7,5,23,21,0,Matches,2021-2022,La-Liga
Serge Aurier,ci CIV,DF,Villarreal,28.0,1992.0,11.2,14,9,11,2,1,4,7,57.1,3,14,7,7,11,25,25,0,Matches,2021-2022,La-Liga
Ezequiel Ávila,ar ARG,"FW,MF",Osasuna,27.0,1994.0,20.8,17,7,6,7,4,7,21,33.3,14,14,2,12,13,30,15,1,Matches,2021-2022,La-Liga
Iddrisu Baba,gh GHA,MF,Mallorca,25.0,1996.0,21.5,57,30,31,23,3,25,43,58.1,18,19,5,14,24,81,34,1,Matches,2021-2022,La-Liga
Carlos Bacca,co COL,FW,Granada,34.0,1986.0,5.7,4,4,2,0,2,0,3,0.0,3,5,0,5,1,5,5,0,Matches,2021-2022,La-Liga
Édgar Badía,es ESP,GK,Elche,29.0,1992.0,24.0,0,0,0,0,0,0,0,,0,0,0,0,0,0,16,2,Matches,2021-2022,La-Liga
Miguel Baeza,es ESP,DF,Celta Vigo,21.0,2000.0,0.0,0,0,0,0,0,0,0,,0,0,0,0,0,0,0,0,Matches,2021-2022,La-Liga
Alejandro Balde,es ESP,"DF,FW",Barcelona,17.0,2003.0,2.1,2,1,1,0,1,0,0,,0,2,2,0,1,3,1,0,Matches,2021-2022,La-Liga
Gareth Bale,wls WAL,FW,Real Madrid,32.0,1989.0,3.1,2,1,1,0,1,1,4,25.0,3,2,0,2,2,4,1,0,Matches,2021-2022,La-Liga
Mikel Balenziaga,es ESP,DF,Athletic Club,33.0,1988.0,22.5,33,24,15,15,3,25,43,58.1,18,27,4,23,21,54,79,0,Matches,2021-2022,La-Liga
Iván Balliu,al ALB,DF,Rayo Vallecano,29.0,1992.0,35.0,45,22,25,11,9,19,31,61.3,12,24,5,19,39,84,64,0,Matches,2021-2022,La-Liga
Barbero,es ESP,"FW,MF",Osasuna,22.0,1998.0,0.2,0,0,0,0,0,0,0,,0,0,0,0,0,0,1,0,Matches,2021-2022,La-Liga
Barcia,es ESP,DF,Granada,20.0,2000.0,0.8,0,0,0,0,0,0,0,,0,1,1,0,1,1,0,1,Matches,2021-2022,La-Liga
Enis Bardhi,mk MKD,"MF,FW",Levante,26.0,1995.0,18.9,29,12,12,14,3,12,35,34.3,23,13,2,11,10,39,7,0,Matches,2021-2022,La-Liga
Keidi Bare,al ALB,MF,Espanyol,23.0,1997.0,16.5,27,17,14,12,1,11,31,35.5,20,20,10,10,15,42,26,1,Matches,2021-2022,La-Liga
Kike Barja,es ESP,"MF,FW",Osasuna,24.0,1997.0,9.6,15,11,4,7,4,8,22,36.4,14,10,1,9,9,24,4,0,Matches,2021-2022,La-Liga
Antonio Barragán,es ESP,DF,Elche,34.0,1987.0,11.3,21,14,13,7,1,11,17,64.7,6,5,3,2,17,38,34,0,Matches,2021-2022,La-Liga
Ander Barrenetxea,es ESP,"FW,MF",Real Sociedad,19.0,2001.0,6.1,15,10,9,6,0,8,18,44.4,10,7,0,7,2,17,2,0,Matches,2021-2022,La-Liga
Marc Bartra,es ESP,DF,Betis,30.0,1991.0,22.1,39,14,18,17,4,19,35,54.3,16,39,22,17,33,72,105,1,Matches,2021-2022,La-Liga
Álvaro Bastida,es ESP,MF,Cádiz,17.0,2004.0,2.2,7,4,2,4,1,4,5,80.0,1,1,0,1,3,10,1,0,Matches,2021-2022,La-Liga
Rodrigo Battaglia,ar ARG,MF,Mallorca,30.0,1991.0,13.1,32,16,13,19,0,15,30,50.0,15,21,10,11,10,42,36,0,Matches,2021-2022,La-Liga
Jon Bautista,es ESP,MF,Real Sociedad,26.0,1995.0,0.5,3,0,0,3,0,0,1,0.0,1,1,0,1,1,4,1,0,Matches,2021-2022,La-Liga
Bebé,cv CPV,FW,Rayo Vallecano,31.0,1990.0,9.6,6,5,1,3,2,4,16,25.0,12,18,0,18,3,9,6,0,Matches,2021-2022,La-Liga
Héctor Bellerín,es ESP,DF,Betis,26.0,1995.0,22.0,52,32,29,20,3,31,44,70.5,13,11,2,9,23,75,57,1,Matches,2021-2022,La-Liga
Fran Beltrán,es ESP,MF,Celta Vigo,22.0,1999.0,28.9,56,41,27,23,6,28,68,41.2,40,29,5,24,32,88,39,0,Matches,2021-2022,La-Liga
Darío Benedetto,ar ARG,"FW,MF",Elche,31.0,1990.0,6.6,5,1,2,2,1,3,6,50.0,3,4,0,4,1,6,1,0,Matches,2021-2022,La-Liga
Iker Benito,es ESP,"FW,MF",Osasuna,18.0,2002.0,1.3,2,1,1,0,1,0,1,0.0,1,2,0,2,0,2,2,0,Matches,2021-2022,La-Liga
Pedro Benito,es ESP,FW,Cádiz,21.0,2000.0,0.3,0,0,0,0,0,0,1,0.0,1,0,0,0,0,0,0,0,Matches,2021-2022,La-Liga
Karim Benzema,fr FRA,FW,Real Madrid,33.0,1987.0,28.8,11,9,5,3,3,2,9,22.2,7,10,0,10,4,15,13,0,Matches,2021-2022,La-Liga
Yuri Berchiche,es ESP,DF,Athletic Club,31.0,1990.0,11.3,25,11,10,11,4,7,14,50.0,7,19,6,13,13,38,25,0,Matches,2021-2022,La-Liga
Álex Berenguer,es ESP,MF,Athletic Club,26.0,1995.0,24.1,45,26,23,14,8,11,51,21.6,40,40,2,38,16,61,20,0,Matches,2021-2022,La-Liga
Pedro Bigas,es ESP,DF,Elche,30.0,1990.0,17.2,24,10,16,8,0,9,20,45.0,11,21,16,5,18,42,77,1,Matches,2021-2022,La-Liga
Antonio Blanco,es ESP,MF,Real Madrid,21.0,2000.0,0.3,2,0,1,1,0,0,0,,0,1,1,0,1,3,0,0,Matches,2021-2022,La-Liga
Yassine Bounou,ma MAR,GK,Sevilla,30.0,1991.0,31.0,0,0,0,0,0,0,0,,0,0,0,0,0,0,11,1,Matches,2021-2022,La-Liga
Lucas Boyé,ar ARG,FW,Elche,25.0,1996.0,19.0,27,13,5,15,7,9,24,37.5,15,24,1,23,2,29,23,0,Matches,2021-2022,La-Liga
Martin Braithwaite,dk DEN,FW,Barcelona,30.0,1991.0,2.6,1,1,0,0,1,0,0,,0,2,0,2,1,2,1,0,Matches,2021-2022,La-Liga
Darko Brašanac,rs SRB,MF,Osasuna,29.0,1992.0,26.7,35,22,19,14,2,14,40,35.0,26,25,8,17,25,60,15,0,Matches,2021-2022,La-Liga
Claudio Bravo,cl CHI,GK,Betis,38.0,1983.0,16.2,0,0,0,0,0,0,0,,0,0,0,0,0,0,6,2,Matches,2021-2022,La-Liga
Yan Brice Eteki,cm CMR,MF,Granada,23.0,1997.0,3.8,6,3,3,2,1,3,7,42.9,4,7,3,4,4,10,6,1,Matches,2021-2022,La-Liga
Ante Budimir,hr CRO,FW,Osasuna,30.0,1991.0,19.3,24,10,3,15,6,6,19,31.6,13,22,4,18,3,27,16,0,Matches,2021-2022,La-Liga
Sergio Busquets,es ESP,MF,Barcelona,33.0,1988.0,35.5,93,49,31,48,14,46,83,55.4,37,44,8,36,45,138,31,0,Matches,2021-2022,La-Liga
Adrián Butzke,es ESP,FW,Granada,22.0,1999.0,0.0,0,0,0,0,0,0,0,,0,0,0,0,0,0,0,0,Matches,2021-2022,La-Liga
Erick Cabaco,uy URU,DF,Getafe,26.0,1995.0,4.5,2,1,1,1,0,2,5,40.0,3,5,2,3,4,6,10,0,Matches,2021-2022,La-Liga
Leandro Cabrera,uy URU,DF,Espanyol,30.0,1991.0,37.0,37,24,27,10,0,21,34,61.8,13,32,23,9,44,81,222,2,Matches,2021-2022,La-Liga
Martín Cáceres,uy URU,DF,Levante,34.0,1987.0,7.4,2,2,2,0,0,1,5,20.0,4,2,2,0,11,13,16,1,Matches,2021-2022,La-Liga
Cala,es ESP,DF,Cádiz,31.0,1989.0,10.5,9,4,9,0,0,8,17,47.1,9,12,6,6,12,21,56,0,Matches,2021-2022,La-Liga
Calderón,es ESP,DF,Betis,21.0,2000.0,0.7,2,0,1,0,1,1,3,33.3,2,0,0,0,0,2,2,0,Matches,2021-2022,La-Liga
Fernando Calero,es ESP,DF,Espanyol,25.0,1995.0,12.1,17,10,12,5,0,8,13,61.5,5,7,2,5,16,33,63,1,Matches,2021-2022,La-Liga
Víctor Camarasa,es ESP,"MF,FW",Betis,27.0,1994.0,1.2,2,1,1,1,0,0,1,0.0,1,2,1,1,2,4,2,0,Matches,2021-2022,La-Liga
Eduardo Camavinga,fr FRA,MF,Real Madrid,18.0,2002.0,13.7,52,35,22,20,10,20,38,52.6,18,20,2,18,17,69,14,1,Matches,2021-2022,La-Liga
José Campaña,es ESP,MF,Levante,28.0,1993.0,15.8,27,16,13,10,4,12,32,37.5,20,13,2,11,21,48,19,1,Matches,2021-2022,La-Liga
Sergio Canales,es ESP,"FW,MF",Betis,30.0,1991.0,31.0,24,14,8,12,4,10,35,28.6,25,16,1,15,10,34,12,0,Matches,2021-2022,La-Liga
Álex Cantero,es ESP,"FW,MF",Levante,21.0,2000.0,6.8,6,4,2,3,1,1,8,12.5,7,2,0,2,1,7,0,0,Matches,2021-2022,La-Liga
Ander Capa,es ESP,DF,Athletic Club,29.0,1992.0,0.0,0,0,0,0,0,0,0,,0,0,0,0,0,0,0,0,Matches,2021-2022,La-Liga
Étienne Capoue,fr FRA,MF,Villarreal,33.0,1988.0,25.4,44,26,18,23,3,15,28,53.6,13,17,5,12,35,79,51,0,Matches,2021-2022,La-Liga
Isaac Carcelen,es ESP,"DF,MF",Cádiz,28.0,1993.0,17.2,43,29,29,12,2,28,56,50.0,28,25,6,19,34,77,42,0,Matches,2021-2022,La-Liga
Cárdenas,es ESP,GK,Levante,24.0,1997.0,24.0,1,1,1,0,0,0,3,0.0,3,0,0,0,1,2,19,0,Matches,2021-2022,La-Liga
Carlo,es ESP,MF,Villarreal,20.0,2001.0,0.1,0,0,0,0,0,0,0,,0,0,0,0,0,0,0,0,Matches,2021-2022,La-Liga
Diego Carlos,br BRA,DF,Sevilla,28.0,1993.0,32.9,35,24,20,13,2,16,24,66.7,8,48,33,15,24,59,120,5,Matches,2021-2022,La-Liga
Carmona,es ESP,DF,Sevilla,19.0,2002.0,0.3,0,0,0,0,0,0,0,,0,0,0,0,1,1,0,0,Matches,2021-2022,La-Liga
Yannick Carrasco,be BEL,"FW,MF",Atlético Madrid,27.0,1993.0,28.7,34,19,16,12,6,19,44,43.2,25,26,5,21,19,53,12,2,Matches,2021-2022,La-Liga
Guido Carrillo,ar ARG,FW,Elche,30.0,1991.0,13.0,7,4,2,4,1,3,13,23.1,10,9,2,7,1,8,27,0,Matches,2021-2022,La-Liga
Dani Carvajal,es ESP,DF,Real Madrid,29.0,1992.0,17.2,43,28,21,15,7,15,26,57.7,11,22,8,14,20,63,38,2,Matches,2021-2022,La-Liga
William Carvalho,pt POR,MF,Betis,29.0,1992.0,20.1,49,33,20,25,4,15,40,37.5,25,18,7,11,16,65,20,0,Matches,2021-2022,La-Liga
Casemiro,br BRA,MF,Real Madrid,29.0,1992.0,28.5,79,51,45,30,4,30,67,44.8,37,65,19,46,38,117,65,3,Matches,2021-2022,La-Liga
Kiko Casilla,es ESP,GK,Elche,34.0,1986.0,14.0,0,0,0,0,0,0,1,0.0,1,0,0,0,1,1,2,2,Matches,2021-2022,La-Liga
Catena,es ESP,DF,Rayo Vallecano,26.0,1994.0,36.0,39,23,24,15,0,25,42,59.5,17,26,19,7,30,69,168,3,Matches,2021-2022,La-Liga
Dani Ceballos,es ESP,MF,Real Madrid,24.0,1996.0,3.1,7,5,4,3,0,1,5,20.0,4,8,2,6,4,11,2,0,Matches,2021-2022,La-Liga
Franco Cervi,ar ARG,MF,Celta Vigo,27.0,1994.0,20.0,73,41,35,22,16,33,77,42.9,44,38,2,36,21,94,19,0,Matches,2021-2022,La-Liga
Chapela,es ESP,"MF,FW",Cádiz,22.0,1999.0,4.4,4,2,1,0,3,2,4,50.0,2,6,1,5,4,8,5,0,Matches,2021-2022,La-Liga
Chema,es ESP,MF,Getafe,29.0,1992.0,0.5,0,0,0,0,0,0,1,0.0,1,0,0,0,0,0,0,0,Matches,2021-2022,La-Liga
Denis Cheryshev,ru RUS,"MF,FW",Valencia,30.0,1990.0,6.3,14,5,6,1,7,6,15,40.0,9,9,1,8,9,23,9,0,Matches,2021-2022,La-Liga
Samuel Chukwueze,ng NGA,"MF,FW",Villarreal,22.0,1999.0,14.8,13,9,6,5,2,3,6,50.0,3,7,0,7,5,18,4,0,Matches,2021-2022,La-Liga
Víctor Chust,es ESP,DF,Cádiz,21.0,2000.0,20.3,19,10,14,4,1,11,17,64.7,6,20,8,12,16,35,87,0,Matches,2021-2022,La-Liga
Jasper Cillessen,nl NED,GK,Valencia,32.0,1989.0,16.2,0,0,0,0,0,0,1,0.0,1,0,0,0,1,1,6,0,Matches,2021-2022,La-Liga
Pathé Ciss,sn SEN,MF,Rayo Vallecano,27.0,1994.0,12.2,31,15,20,8,3,12,26,46.2,14,16,6,10,30,61,27,0,Matches,2021-2022,La-Liga
Carlos Clerc,es ESP,DF,Levante,29.0,1992.0,16.8,35,17,21,10,4,7,19,36.8,12,8,3,5,26,61,32,1,Matches,2021-2022,La-Liga
Coke,es ESP,DF,Levante,34.0,1987.0,1.3,3,2,1,1,1,3,4,75.0,1,1,0,1,2,5,7,0,Matches,2021-2022,La-Liga
Álex Collado,es ESP,"MF,FW",Granada,22.0,1999.0,11.3,27,12,6,16,5,12,31,38.7,19,28,2,26,6,33,11,0,Matches,2021-2022,La-Liga
Eray Cömert,ch SUI,DF,Valencia,23.0,1998.0,4.5,5,3,4,1,0,3,6,50.0,3,3,2,1,2,7,6,0,Matches,2021-2022,La-Liga
Santi Comesaña,es ESP,MF,Rayo Vallecano,24.0,1996.0,29.8,87,56,45,33,9,40,104,38.5,64,46,6,40,33,120,30,0,Matches,2021-2022,La-Liga
Diego Conde,es ESP,GK,Getafe,22.0,1998.0,0.1,0,0,0,0,0,0,0,,0,0,0,0,0,0,0,0,Matches,2021-2022,La-Liga
Francis Coquelin,fr FRA,MF,Villarreal,30.0,1991.0,9.2,26,17,9,11,6,11,20,55.0,9,15,5,10,19,45,11,0,Matches,2021-2022,La-Liga
Jesús Corona,mx MEX,"FW,DF",Sevilla,28.0,1993.0,12.9,12,7,7,5,0,3,6,50.0,3,4,0,4,8,20,6,0,Matches,2021-2022,La-Liga
Ángel Correa,ar ARG,"FW,MF",Atlético Madrid,26.0,1995.0,20.6,16,8,5,10,1,7,29,24.1,22,25,2,23,10,26,4,0,Matches,2021-2022,La-Liga
Thierry Correia,pt POR,DF,Valencia,22.0,1999.0,15.7,35,23,26,6,3,14,29,48.3,15,20,5,15,19,54,27,0,Matches,2021-2022,La-Liga
Hélder Costa,ao ANG,"MF,FW",Valencia,27.0,1994.0,12.4,27,16,11,9,7,14,41,34.1,27,12,1,11,3,30,9,0,Matches,2021-2022,La-Liga
Jaume Costa,es ESP,DF,Mallorca,33.0,1988.0,20.3,35,26,23,7,5,23,31,74.2,8,22,7,15,23,58,55,0,Matches,2021-2022,La-Liga
Thibaut Courtois,be BEL,GK,Real Madrid,29.0,1992.0,36.0,1,0,1,0,0,1,2,50.0,1,0,0,0,0,1,9,1,Matches,2021-2022,La-Liga
Philippe Coutinho,br BRA,"MF,FW",Barcelona,29.0,1992.0,5.6,6,3,3,3,0,3,11,27.3,8,3,0,3,4,10,3,0,Matches,2021-2022,La-Liga
Cristo,es ESP,DF,Real Sociedad,21.0,2000.0,0.2,0,0,0,0,0,0,0,,0,0,0,0,0,0,0,0,Matches,2021-2022,La-Liga
Juan Cruz Armada,es ESP,DF,Osasuna,29.0,1992.0,21.5,28,21,15,12,1,8,16,50.0,8,15,12,3,16,44,58,1,Matches,2021-2022,La-Liga
Marc Cucurella,es ESP,"MF,DF",Getafe,23.0,1998.0,0.3,0,0,0,0,0,0,0,,0,0,0,0,0,0,0,0,Matches,2021-2022,La-Liga
Jorge Cuenca,es ESP,DF,Getafe,21.0,1999.0,29.8,46,32,30,15,1,21,28,75.0,7,29,14,15,39,85,155,0,Matches,2021-2022,La-Liga
Matheus Cunha,br BRA,FW,Atlético Madrid,22.0,1999.0,11.8,19,12,3,11,5,5,20,25.0,15,18,2,16,6,25,9,0,Matches,2021-2022,La-Liga
Arnaut Danjuma,nl NED,FW,Villarreal,24.0,1997.0,16.4,7,6,3,0,4,2,4,50.0,2,5,0,5,2,9,3,0,Matches,2021-2022,La-Liga
Sergi Darder,es ESP,MF,Espanyol,27.0,1993.0,34.7,45,22,16,19,10,18,54,33.3,36,16,1,15,26,71,32,1,Matches,2021-2022,La-Liga
Rodrigo De Paul,ar ARG,MF,Atlético Madrid,27.0,1994.0,23.9,55,30,22,25,8,30,60,50.0,30,24,3,21,21,76,17,2,Matches,2021-2022,La-Liga
Thomas Delaney,dk DEN,MF,Sevilla,29.0,1991.0,17.2,41,24,17,21,3,16,30,53.3,14,19,10,9,13,54,35,0,Matches,2021-2022,La-Liga
Ousmane Dembélé,fr FRA,FW,Barcelona,24.0,1997.0,15.7,24,16,6,10,8,7,23,30.4,16,8,0,8,8,32,3,0,Matches,2021-2022,La-Liga
Yusuf Demir,at AUT,FW,Barcelona,18.0,2003.0,2.1,3,1,1,1,1,2,5,40.0,3,1,0,1,2,5,1,0,Matches,2021-2022,La-Liga
Sergiño Dest,us USA,"DF,FW",Barcelona,20.0,2000.0,16.8,32,15,21,10,1,13,18,72.2,5,22,4,18,2,34,18,0,Matches,2021-2022,La-Liga
Boulaye Dia,sn SEN,FW,Villarreal,24.0,1996.0,14.1,8,6,3,4,1,2,5,40.0,3,6,1,5,5,13,4,0,Matches,2021-2022,La-Liga
Mouctar Diakhaby,gn GUI,DF,Valencia,24.0,1996.0,21.6,35,24,18,15,2,13,23,56.5,10,29,17,12,30,65,87,3,Matches,2021-2022,La-Liga
Javier Díaz,es ESP,GK,Sevilla,24.0,1997.0,1.0,0,0,0,0,0,0,0,,0,0,0,0,0,0,0,0,Matches,2021-2022,La-Liga
Víctor Díaz,es ESP,DF,Granada,33.0,1988.0,16.7,23,15,14,9,0,12,25,48.0,13,19,11,8,17,40,71,1,Matches,2021-2022,La-Liga
Landry Dimata,be BEL,"FW,MF",Espanyol,23.0,1997.0,6.0,2,2,1,1,0,1,4,25.0,3,0,0,0,1,3,7,0,Matches,2021-2022,La-Liga
Stole Dimitrievski,mk MKD,GK,Rayo Vallecano,27.0,1993.0,30.8,0,0,0,0,0,0,0,,0,0,0,0,1,1,14,3,Matches,2021-2022,La-Liga
Matías Dituro,ar ARG,GK,Celta Vigo,34.0,1987.0,38.0,0,0,0,0,0,0,0,,0,0,0,0,0,0,10,5,Matches,2021-2022,La-Liga
Djené,tg TOG,DF,Getafe,29.0,1991.0,34.6,44,26,24,16,4,23,34,67.6,11,24,5,19,59,103,109,2,Matches,2021-2022,La-Liga
Naïs Djouahra,fr FRA,"FW,MF",Real Sociedad,21.0,1999.0,2.4,7,3,2,2,3,4,8,50.0,4,3,0,3,2,9,2,0,Matches,2021-2022,La-Liga
Marko Dmitrović,rs SRB,GK,Sevilla,29.0,1992.0,6.0,0,0,0,0,0,0,0,,0,0,0,0,0,0,3,1,Matches,2021-2022,La-Liga
Jaume Doménech,es ESP,GK,Valencia,30.0,1990.0,3.8,0,0,0,0,0,0,0,,0,0,0,0,0,0,3,1,Matches,2021-2022,La-Liga
Carlos Dominguez,es ESP,DF,Celta Vigo,20.0,2001.0,3.8,4,1,4,0,0,4,6,66.7,2,2,1,1,4,8,21,0,Matches,2021-2022,La-Liga
Mario Dominguez,es ESP,FW,Valencia,17.0,2004.0,0.3,0,0,0,0,0,0,0,,0,0,0,0,0,0,1,0,Matches,2021-2022,La-Liga
John Donald,es ESP,DF,Elche,20.0,2000.0,2.0,7,4,4,2,1,5,8,62.5,3,5,3,2,3,10,3,0,Matches,2021-2022,La-Liga
Domingos Duarte,pt POR,DF,Granada,26.0,1995.0,18.7,18,14,9,9,0,6,11,54.5,5,27,20,7,22,40,82,0,Matches,2021-2022,La-Liga
Óscar Duarte,cr CRC,DF,Levante,32.0,1989.0,19.7,18,8,12,6,0,8,23,34.8,15,18,9,9,24,42,102,0,Matches,2021-2022,La-Liga
Rubén Duarte,es ESP,DF,Alavés,25.0,1995.0,29.1,76,47,43,27,6,43,85,50.6,42,40,6,34,57,133,82,0,Matches,2021-2022,La-Liga
Unai Dufur,es ESP,DF,Osasuna,22.0,1999.0,1.0,0,0,0,0,0,0,0,,0,1,0,1,4,4,4,0,Matches,2021-2022,La-Liga
Hugo Duro,es ESP,"DF,MF",Getafe,21.0,1999.0,0.1,0,0,0,0,0,0,0,,0,0,0,0,0,0,0,0,Matches,2021-2022,La-Liga
Hugo Duro,es ESP,"FW,MF",Valencia,21.0,1999.0,20.4,25,19,11,13,1,15,38,39.5,23,24,2,22,4,29,20,1,Matches,2021-2022,La-Liga
Aritz Elustondo,es ESP,DF,Real Sociedad,27.0,1994.0,23.4,21,14,16,5,0,10,20,50.0,10,19,13,6,29,50,86,0,Matches,2021-2022,La-Liga
Adri Embarba,es ESP,"FW,MF",Espanyol,29.0,1992.0,22.1,44,29,22,15,7,26,69,37.7,43,35,3,32,19,63,30,0,Matches,2021-2022,La-Liga
Emerson,br BRA,DF,Barcelona,22.0,1999.0,1.0,3,3,2,1,0,1,2,50.0,1,1,0,1,2,5,1,0,Matches,2021-2022,La-Liga
Youssef En-Nesyri,ma MAR,FW,Sevilla,24.0,1997.0,14.2,10,5,5,2,3,4,11,36.4,7,9,1,8,4,14,18,0,Matches,2021-2022,La-Liga
Gonzalo Escalante,ar ARG,MF,Alavés,28.0,1993.0,14.4,30,14,9,20,1,13,34,38.2,21,27,2,25,21,51,28,0,Matches,2021-2022,La-Liga
Aarón Escandell,es ESP,GK,Granada,25.0,1995.0,3.2,0,0,0,0,0,0,1,0.0,1,0,0,0,0,0,4,0,Matches,2021-2022,La-Liga
Sergio Escudero,es ESP,"DF,MF",Granada,31.0,1989.0,15.9,46,24,25,17,4,26,54,48.1,28,18,3,15,26,72,35,0,Matches,2021-2022,La-Liga
Alfonso Espino,uy URU,DF,Cádiz,29.0,1992.0,37.0,107,63,58,39,10,44,112,39.3,68,45,10,35,54,161,87,1,Matches,2021-2022,La-Liga
Estanis,es ESP,FW,Barcelona,17.0,2003.0,0.1,1,1,0,1,0,1,1,100.0,0,0,0,0,0,1,0,0,Matches,2021-2022,La-Liga
Pervis Estupiñán,ec ECU,DF,Villarreal,23.0,1998.0,17.5,36,22,20,11,5,17,24,70.8,7,13,5,8,25,61,29,2,Matches,2021-2022,La-Liga
Abde Ezzalzouli,ma MAR,FW,Barcelona,19.0,2001.0,6.4,17,9,9,5,3,5,8,62.5,3,3,0,3,9,26,0,0,Matches,2021-2022,La-Liga
Radamel Falcao,co COL,FW,Rayo Vallecano,35.0,1986.0,9.3,2,1,0,1,1,1,4,25.0,3,4,1,3,2,4,11,0,Matches,2021-2022,La-Liga
Fali,es ESP,"DF,MF",Cádiz,27.0,1993.0,20.0,32,19,24,8,0,17,32,53.1,15,26,16,10,24,56,82,0,Matches,2021-2022,La-Liga
Omar Faraj,ps PLE,FW,Levante,19.0,2002.0,0.0,1,0,1,0,0,1,1,100.0,0,0,0,0,0,1,0,0,Matches,2021-2022,La-Liga
Ansu Fati,es ESP,FW,Barcelona,18.0,2002.0,3.7,3,2,0,2,1,1,1,100.0,0,4,0,4,1,4,0,0,Matches,2021-2022,La-Liga
Aleix Febas,es ESP,MF,Mallorca,25.0,1996.0,1.3,4,1,0,4,0,2,4,50.0,2,0,0,0,0,4,0,0,Matches,2021-2022,La-Liga
Nabil Fekir,fr FRA,MF,Betis,28.0,1993.0,31.0,43,29,5,25,13,7,36,19.4,29,14,0,14,7,50,7,0,Matches,2021-2022,La-Liga
Felipe,br BRA,DF,Atlético Madrid,32.0,1989.0,16.7,20,15,11,8,1,8,18,44.4,10,17,11,6,28,48,77,0,Matches,2021-2022,La-Liga
João Félix,pt POR,"FW,MF",Atlético Madrid,21.0,1999.0,14.0,5,2,1,4,0,1,5,20.0,4,4,1,3,7,12,8,0,Matches,2021-2022,La-Liga
Aitor Fernández,es ESP,GK,Levante,30.0,1991.0,13.0,2,1,2,0,0,2,2,100.0,0,0,0,0,0,2,7,0,Matches,2021-2022,La-Liga
Álex Fernández,es ESP,MF,Cádiz,28.0,1992.0,22.8,47,31,22,17,8,21,61,34.4,40,30,7,23,30,77,31,0,Matches,2021-2022,La-Liga
Fernando,br BRA,"MF,DF",Sevilla,34.0,1987.0,20.6,24,17,14,9,1,12,33,36.4,21,21,13,8,29,53,32,2,Matches,2021-2022,La-Liga
Fidel,es ESP,MF,Elche,31.0,1989.0,25.1,44,23,18,17,9,14,57,24.6,43,9,1,8,7,51,20,0,Matches,2021-2022,La-Liga
José Fontán,es ESP,DF,Celta Vigo,21.0,2000.0,3.1,5,3,3,2,0,1,5,20.0,4,3,1,2,10,15,10,0,Matches,2021-2022,La-Liga
Dimitri Foulquier,fr FRA,DF,Granada,28.0,1993.0,2.0,0,0,0,0,0,0,1,0.0,1,2,1,1,1,1,2,0,Matches,2021-2022,La-Liga
Dimitri Foulquier,fr FRA,DF,Valencia,28.0,1993.0,26.0,36,17,17,15,4,21,34,61.8,13,19,3,16,29,65,49,0,Matches,2021-2022,La-Liga
Juan Foyth,ar ARG,DF,Villarreal,23.0,1998.0,21.4,69,49,35,28,6,35,47,74.5,12,29,7,22,20,89,50,0,Matches,2021-2022,La-Liga
Enric Franquesa,es ESP,"DF,FW",Levante,24.0,1997.0,6.9,5,3,4,0,1,0,1,0.0,1,4,0,4,7,12,11,0,Matches,2021-2022,La-Liga
Jorge de Frutos,es ESP,"MF,FW",Levante,24.0,1997.0,19.6,33,15,14,11,8,10,51,19.6,41,11,1,10,12,45,13,0,Matches,2021-2022,La-Liga
Javi Galán,es ESP,DF,Celta Vigo,26.0,1994.0,36.6,108,66,60,37,11,42,99,42.4,57,48,8,40,45,153,52,0,Matches,2021-2022,La-Liga
Iñigo Ruiz de Galarreta,es ESP,MF,Mallorca,27.0,1993.0,15.3,40,21,14,21,5,14,30,46.7,16,16,2,14,20,60,21,0,Matches,2021-2022,La-Liga
Thiago Galhardo,br BRA,"FW,MF",Celta Vigo,32.0,1989.0,12.8,12,6,3,3,6,2,12,16.7,10,15,2,13,6,18,9,0,Matches,2021-2022,La-Liga
Álvaro García,es ESP,"FW,MF",Rayo Vallecano,28.0,1992.0,33.3,42,23,15,18,9,8,35,22.9,27,27,3,24,42,84,24,0,Matches,2021-2022,La-Liga
Dani García,es ESP,MF,Athletic Club,31.0,1990.0,24.2,36,22,15,17,4,14,47,29.8,33,27,10,17,24,60,41,1,Matches,2021-2022,La-Liga
David García,es ESP,DF,Osasuna,27.0,1994.0,34.5,28,14,15,11,2,12,22,54.5,10,27,21,6,52,80,168,0,Matches,2021-2022,La-Liga
Eric García,es ESP,DF,Barcelona,20.0,2001.0,22.7,27,18,13,13,1,11,26,42.3,15,22,12,10,44,71,53,3,Matches,2021-2022,La-Liga
Fran Garcia,es ESP,DF,Rayo Vallecano,21.0,1999.0,33.6,60,35,44,12,4,39,73,53.4,34,34,8,26,45,105,53,0,Matches,2021-2022,La-Liga
Joan García,es ESP,GK,Espanyol,20.0,2001.0,1.2,0,0,0,0,0,0,0,,0,0,0,0,1,1,1,2,Matches,2021-2022,La-Liga
Manu García,es ESP,MF,Alavés,23.0,1998.0,12.0,18,9,6,9,3,9,27,33.3,18,8,2,6,13,31,4,0,Matches,2021-2022,La-Liga
Raúl García,es ESP,FW,Athletic Club,35.0,1986.0,20.0,27,17,6,11,10,8,36,22.2,28,30,4,26,9,36,21,0,Matches,2021-2022,La-Liga
Rubén García,es ESP,"MF,FW",Osasuna,28.0,1993.0,26.4,43,26,12,23,8,16,49,32.7,33,31,4,27,24,67,16,0,Matches,2021-2022,La-Liga
Saúl García,es ESP,MF,Alavés,26.0,1994.0,0.0,1,1,1,0,0,0,0,,0,0,0,0,0,1,0,0,Matches,2021-2022,La-Liga
Unai García,es ESP,DF,Osasuna,29.0,1992.0,15.6,21,12,14,6,1,14,17,82.4,3,19,11,8,22,43,78,0,Matches,2021-2022,La-Liga
Mario Gaspar,es ESP,DF,Villarreal,30.0,1990.0,6.9,10,4,2,5,3,6,10,60.0,4,6,3,3,6,16,15,0,Matches,2021-2022,La-Liga
Gavi,es ESP,"MF,FW",Barcelona,16.0,2004.0,25.7,38,18,13,18,7,9,33,27.3,24,36,0,36,25,63,13,0,Matches,2021-2022,La-Liga
Bryan Gil,es ESP,"MF,FW",Valencia,20.0,2001.0,8.4,13,8,6,3,4,2,13,15.4,11,13,0,13,1,14,4,0,Matches,2021-2022,La-Liga
Óscar Gil,es ESP,DF,Espanyol,24.0,1997.0,18.8,52,35,27,20,5,25,46,54.3,21,33,9,24,19,71,33,2,Matches,2021-2022,La-Liga
Mario Gila,es ESP,DF,Real Madrid,20.0,2000.0,0.3,1,0,1,0,0,0,1,0.0,1,0,0,0,1,2,1,0,Matches,2021-2022,La-Liga
Dani Gómez,es ESP,FW,Levante,23.0,1998.0,11.8,7,4,3,2,2,4,12,33.3,8,3,0,3,3,10,5,0,Matches,2021-2022,La-Liga
Maxi Gómez,uy URU,FW,Valencia,24.0,1996.0,21.7,5,3,1,2,2,5,8,62.5,3,5,1,4,3,8,22,0,Matches,2021-2022,La-Liga
Moi Gómez,es ESP,"MF,FW",Villarreal,27.0,1994.0,14.3,15,7,8,3,4,5,17,29.4,12,5,0,5,6,21,6,0,Matches,2021-2022,La-Liga
Papu Gómez,ar ARG,"FW,MF",Sevilla,33.0,1988.0,19.8,19,11,9,5,5,9,35,25.7,26,15,2,13,7,26,12,2,Matches,2021-2022,La-Liga
Sergi Gómez,es ESP,DF,Espanyol,29.0,1992.0,30.2,33,24,29,3,1,18,27,66.7,9,33,23,10,40,73,125,2,Matches,2021-2022,La-Liga
Victor Gomez,es ESP,DF,Espanyol,21.0,2000.0,0.0,0,0,0,0,0,0,0,,0,0,0,0,0,0,0,0,Matches,2021-2022,La-Liga
Maxime Gonalons,fr FRA,MF,Granada,32.0,1989.0,17.2,43,28,17,22,4,14,39,35.9,25,33,10,23,18,61,29,0,Matches,2021-2022,La-Liga
Diego González,es ESP,DF,Elche,26.0,1995.0,19.9,25,16,18,7,0,9,16,56.3,7,21,13,8,19,44,87,0,Matches,2021-2022,La-Liga
Édgar González,es ESP,DF,Betis,24.0,1997.0,16.3,25,19,15,8,2,17,24,70.8,7,17,11,6,23,48,82,0,Matches,2021-2022,La-Liga
Giovanni González,uy URU,DF,Mallorca,26.0,1994.0,4.1,9,3,4,4,1,3,5,60.0,2,7,2,5,4,13,14,0,Matches,2021-2022,La-Liga
Nicolás González,es ESP,MF,Barcelona,19.0,2002.0,12.4,31,20,5,23,3,11,27,40.7,16,12,0,12,6,37,12,0,Matches,2021-2022,La-Liga
Peter González,do DOM,"MF,DF",Real Madrid,19.0,2002.0,0.3,0,0,0,0,0,0,0,,0,0,0,0,1,1,0,0,Matches,2021-2022,La-Liga
Roberto González,es ESP,"FW,MF",Betis,20.0,2001.0,1.5,5,4,3,2,0,4,6,66.7,2,5,0,5,1,6,1,0,Matches,2021-2022,La-Liga
Gori,es ESP,MF,Espanyol,19.0,2002.0,0.1,0,0,0,0,0,0,0,,0,2,0,2,0,0,0,0,Matches,2021-2022,La-Liga
Andoni Gorosabel,es ESP,DF,Real Sociedad,24.0,1996.0,25.4,47,31,32,9,6,25,47,53.2,22,16,3,13,18,65,49,0,Matches,2021-2022,La-Liga
Jaume Grau,es ESP,MF,Osasuna,24.0,1997.0,0.0,1,1,1,0,0,0,1,0.0,1,0,0,0,0,1,0,0,Matches,2021-2022,La-Liga
Dominik Greif,sk SVK,GK,Mallorca,24.0,1997.0,1.0,0,0,0,0,0,0,0,,0,0,0,0,0,0,0,0,Matches,2021-2022,La-Liga
Clément Grenier,fr FRA,MF,Mallorca,30.0,1991.0,0.7,0,0,0,0,0,0,0,,0,1,1,0,0,0,1,0,Matches,2021-2022,La-Liga
Antoine Griezmann,fr FRA,FW,Barcelona,30.0,1991.0,2.9,13,5,3,10,0,2,6,33.3,4,4,0,4,3,16,5,0,Matches,2021-2022,La-Liga
Antoine Griezmann,fr FRA,"FW,MF",Atlético Madrid,30.0,1991.0,18.8,30,14,11,15,4,12,32,37.5,20,18,1,17,7,37,18,0,Matches,2021-2022,La-Liga
Andrés Guardado,mx MEX,MF,Betis,34.0,1986.0,15.5,30,13,12,17,1,13,34,38.2,21,18,4,14,21,51,29,1,Matches,2021-2022,La-Liga
Sergi Guardiola,es ESP,FW,Rayo Vallecano,30.0,1991.0,19.0,10,9,3,5,2,1,21,4.8,20,14,2,12,4,14,17,0,Matches,2021-2022,La-Liga
Nemanja Gudelj,rs SRB,"DF,MF",Sevilla,29.0,1991.0,11.6,16,7,10,4,2,5,8,62.5,3,14,9,5,22,38,37,0,Matches,2021-2022,La-Liga
Gonçalo Guedes,pt POR,"FW,MF",Valencia,24.0,1996.0,29.0,21,14,6,7,8,2,22,9.1,20,14,0,14,9,30,1,0,Matches,2021-2022,La-Liga
Ander Guevara,es ESP,MF,Real Sociedad,24.0,1997.0,9.6,18,13,6,10,2,10,17,58.8,7,12,6,6,12,30,8,0,Matches,2021-2022,La-Liga
John Guidetti,se SWE,"FW,MF",Alavés,29.0,1992.0,3.1,2,1,0,0,2,0,1,0.0,1,1,0,1,0,2,0,0,Matches,2021-2022,La-Liga
Hugo Guillamón,es ESP,"MF,DF",Valencia,21.0,2000.0,26.2,43,27,20,16,7,18,44,40.9,26,26,10,16,30,73,53,1,Matches,2021-2022,La-Liga
Gerard Gumbau,es ESP,MF,Elche,26.0,1994.0,21.0,46,19,22,19,5,22,51,43.1,29,18,4,14,23,69,25,0,Matches,2021-2022,La-Liga
Jon Guridi,es ESP,MF,Real Sociedad,26.0,1995.0,2.3,5,3,2,3,0,1,4,25.0,3,3,1,2,3,8,4,0,Matches,2021-2022,La-Liga
Raúl Guti,es ESP,MF,Elche,24.0,1996.0,18.1,25,15,7,14,4,10,30,33.3,20,9,3,6,25,50,7,0,Matches,2021-2022,La-Liga
Marcos Mauro López Gutiérrez,ar ARG,DF,Cádiz,30.0,1991.0,1.5,1,0,0,1,0,0,2,0.0,2,2,1,1,1,2,9,0,Matches,2021-2022,La-Liga
Miguel Gutiérrez,es ESP,DF,Real Madrid,20.0,2001.0,2.9,7,5,5,0,2,3,5,60.0,2,0,0,0,2,9,2,0,Matches,2021-2022,La-Liga
Munir El Haddadi,ma MAR,"FW,MF",Sevilla,25.0,1995.0,5.3,8,4,1,6,1,2,8,25.0,6,7,1,6,5,13,2,0,Matches,2021-2022,La-Liga
Varazdat Haroyan,am ARM,DF,Cádiz,28.0,1992.0,16.0,31,21,20,10,1,19,29,65.5,10,22,12,10,15,46,62,0,Matches,2021-2022,La-Liga
Eden Hazard,be BEL,"FW,MF",Real Madrid,30.0,1991.0,8.0,6,3,3,2,1,3,7,42.9,4,3,0,3,2,8,0,0,Matches,2021-2022,La-Liga
Kike Hermoso,es ESP,DF,Betis,21.0,1999.0,1.0,2,1,2,0,0,2,2,100.0,0,2,1,1,0,2,5,1,Matches,2021-2022,La-Liga
Mario Hermoso,es ESP,DF,Atlético Madrid,26.0,1995.0,20.7,30,15,23,4,3,20,38,52.6,18,18,3,15,29,59,49,2,Matches,2021-2022,La-Liga
Aridane Hernández,es ESP,DF,Osasuna,32.0,1989.0,12.9,12,9,10,2,0,3,13,23.1,10,11,9,2,20,32,71,0,Matches,2021-2022,La-Liga
Luis Hernández,es ESP,DF,Cádiz,32.0,1989.0,15.2,9,5,9,0,0,5,8,62.5,3,5,3,2,16,25,34,0,Matches,2021-2022,La-Liga
Mario Hernández,es ESP,"DF,FW",Rayo Vallecano,22.0,1999.0,4.4,10,4,7,3,0,5,9,55.6,4,1,0,1,4,14,7,0,Matches,2021-2022,La-Liga
Héctor Herrera,mx MEX,MF,Atlético Madrid,31.0,1990.0,9.5,16,8,11,4,1,7,20,35.0,13,13,2,11,12,28,16,0,Matches,2021-2022,La-Liga
Sergio Herrera,es ESP,GK,Osasuna,28.0,1993.0,36.0,3,2,3,0,0,3,6,50.0,3,1,0,1,1,4,18,0,Matches,2021-2022,La-Liga
Yangel Herrera,ve VEN,MF,Espanyol,23.0,1998.0,18.3,41,31,19,19,3,18,39,46.2,21,27,5,22,19,60,33,1,Matches,2021-2022,La-Liga
Matthew Hoppe,us USA,"FW,MF",Mallorca,20.0,2001.0,1.5,1,0,0,0,1,0,3,0.0,3,0,0,0,0,1,0,0,Matches,2021-2022,La-Liga
Robert Ibáñez,es ESP,"MF,FW",Osasuna,28.0,1993.0,1.0,3,3,2,0,1,1,2,50.0,1,1,0,1,1,4,1,0,Matches,2021-2022,La-Liga
Vicente Iborra,es ESP,MF,Villarreal,33.0,1988.0,11.5,19,10,9,7,3,12,24,50.0,12,11,5,6,11,30,27,1,Matches,2021-2022,La-Liga
Oussama Idrissi,ma MAR,"MF,FW",Sevilla,25.0,1996.0,1.4,1,0,0,1,0,0,1,0.0,1,1,0,1,1,2,1,0,Matches,2021-2022,La-Liga
Oussama Idrissi,ma MAR,MF,Cádiz,25.0,1996.0,10.0,8,4,3,4,1,4,15,26.7,11,8,0,8,3,11,5,0,Matches,2021-2022,La-Liga
Iglesias,es ESP,DF,Getafe,23.0,1998.0,8.0,19,10,11,8,0,7,17,41.2,10,8,2,6,10,29,28,0,Matches,2021-2022,La-Liga
Borja Iglesias,es ESP,FW,Betis,28.0,1993.0,17.5,6,4,1,2,3,0,8,0.0,8,11,1,10,4,10,7,0,Matches,2021-2022,La-Liga
Asier Illarramendi,es ESP,MF,Real Sociedad,31.0,1990.0,4.2,9,5,5,3,1,1,10,10.0,9,5,1,4,4,13,12,0,Matches,2021-2022,La-Liga
Nikita Iosifov,ru RUS,MF,Villarreal,20.0,2001.0,0.0,0,0,0,0,0,0,0,,0,0,0,0,0,0,0,0,Matches,2021-2022,La-Liga
Alexander Isak,se SWE,FW,Real Sociedad,21.0,1999.0,23.8,7,4,1,3,3,2,12,16.7,10,14,2,12,3,10,10,0,Matches,2021-2022,La-Liga
Isco,es ESP,"MF,FW",Real Madrid,29.0,1992.0,3.7,9,5,4,4,1,5,12,41.7,7,1,0,1,2,11,1,0,Matches,2021-2022,La-Liga
Nicolas Jackson,sn SEN,"FW,MF",Villarreal,20.0,2001.0,1.8,2,0,1,0,1,0,0,,0,0,0,0,1,3,1,0,Matches,2021-2022,La-Liga
Jakub Jankto,cz CZE,"DF,MF",Getafe,25.0,1996.0,6.5,11,7,5,5,1,10,17,58.8,7,4,0,4,4,15,7,0,Matches,2021-2022,La-Liga
Adnan Januzaj,be BEL,"FW,MF",Real Sociedad,26.0,1995.0,18.1,17,11,5,8,4,9,24,37.5,15,15,3,12,12,29,15,0,Matches,2021-2022,La-Liga
Jason,es ESP,"MF,FW",Alavés,27.0,1994.0,7.5,11,7,6,4,1,7,20,35.0,13,7,0,7,7,18,5,0,Matches,2021-2022,La-Liga
Jason,es ESP,"MF,DF",Valencia,27.0,1994.0,0.8,4,1,2,1,1,0,1,0.0,1,2,0,2,1,5,1,0,Matches,2021-2022,La-Liga
Luis Javier Suárez,co COL,FW,Granada,23.0,1997.0,31.6,26,14,9,9,8,8,27,29.6,19,25,3,22,6,32,23,0,Matches,2021-2022,La-Liga
Álvaro Jiménez,es ESP,"MF,FW",Cádiz,26.0,1995.0,2.6,6,3,3,2,1,4,7,57.1,3,3,0,3,3,9,0,0,Matches,2021-2022,La-Liga
Joaquín,es ESP,"FW,MF",Betis,40.0,1981.0,5.2,6,2,4,2,0,3,8,37.5,5,5,2,3,3,9,10,0,Matches,2021-2022,La-Liga
Jofre,es ESP,"MF,DF",Espanyol,20.0,2001.0,0.2,1,1,0,0,1,1,1,100.0,0,0,0,0,0,1,0,0,Matches,2021-2022,La-Liga
Frenkie de Jong,nl NED,MF,Barcelona,24.0,1997.0,27.5,35,19,12,18,5,12,23,52.2,11,19,5,14,20,55,16,0,Matches,2021-2022,La-Liga
Luuk de Jong,nl NED,FW,Barcelona,30.0,1990.0,7.3,9,7,1,5,3,1,2,50.0,1,4,0,4,0,9,12,0,Matches,2021-2022,La-Liga
Joan Jordán,es ESP,MF,Sevilla,27.0,1994.0,27.9,61,30,22,31,8,28,65,43.1,37,27,6,21,30,91,18,1,Matches,2021-2022,La-Liga
Josan,es ESP,"DF,MF",Elche,31.0,1989.0,13.5,36,22,23,9,4,26,44,59.1,18,11,4,7,10,46,21,0,Matches,2021-2022,La-Liga
Willian José,br BRA,FW,Betis,29.0,1991.0,17.8,15,13,2,10,3,2,8,25.0,6,10,2,8,3,18,16,0,Matches,2021-2022,La-Liga
Joselu,es ESP,FW,Alavés,31.0,1990.0,34.7,16,11,1,9,6,7,25,28.0,18,21,4,17,7,23,45,0,Matches,2021-2022,La-Liga
Josema,es ESP,DF,Elche,25.0,1996.0,2.0,3,2,1,1,1,0,2,0.0,2,1,1,0,0,3,11,0,Matches,2021-2022,La-Liga
Luka Jović,rs SRB,FW,Real Madrid,23.0,1997.0,4.1,1,1,0,1,0,0,1,0.0,1,3,0,3,1,2,4,0,Matches,2021-2022,La-Liga
Miguel Juan Llambrich,es ESP,DF,Espanyol,25.0,1996.0,0.8,2,2,1,1,0,0,0,,0,1,0,1,0,2,5,0,Matches,2021-2022,La-Liga
José Juan Macías,mx MEX,"FW,MF",Getafe,21.0,1999.0,2.2,1,0,0,0,1,0,1,0.0,1,1,0,1,1,2,0,0,Matches,2021-2022,La-Liga
Juanmi,es ESP,FW,Betis,28.0,1993.0,23.7,39,25,11,19,9,19,49,38.8,30,24,1,23,9,48,10,1,Matches,2021-2022,La-Liga
Lago Junior,ci CIV,"FW,MF",Mallorca,30.0,1990.0,2.0,3,2,3,0,0,3,5,60.0,2,0,0,0,2,5,2,0,Matches,2021-2022,La-Liga
Vinicius Júnior,br BRA,FW,Real Madrid,21.0,2000.0,29.9,46,24,23,19,4,15,50,30.0,35,25,0,25,6,52,6,0,Matches,2021-2022,La-Liga
Ferran Jutglà,es ESP,FW,Barcelona,22.0,1999.0,3.3,2,1,0,1,1,0,1,0.0,1,2,0,2,1,3,1,0,Matches,2021-2022,La-Liga
Jens Jønsson,dk DEN,MF,Cádiz,28.0,1993.0,14.5,40,29,22,17,1,17,35,48.6,18,17,7,10,34,74,32,0,Matches,2021-2022,La-Liga
Lee Kang-in,kr KOR,"MF,FW",Mallorca,20.0,2001.0,15.7,13,6,2,9,2,5,29,17.2,24,11,1,10,5,18,7,0,Matches,2021-2022,La-Liga
Kiké,es ESP,FW,Osasuna,31.0,1989.0,20.7,11,7,3,4,4,3,23,13.0,20,10,1,9,3,14,12,0,Matches,2021-2022,La-Liga
Koba Koindredi,fr FRA,MF,Valencia,19.0,2001.0,2.0,4,3,2,1,1,2,6,33.3,4,3,0,3,4,8,5,0,Matches,2021-2022,La-Liga
Koke,es ESP,MF,Atlético Madrid,29.0,1992.0,27.9,55,30,19,29,7,26,63,41.3,37,21,5,16,24,79,31,1,Matches,2021-2022,La-Liga
Luca Koleosho,it ITA,FW,Espanyol,16.0,2004.0,0.0,0,0,0,0,0,0,0,,0,0,0,0,0,0,0,0,Matches,2021-2022,La-Liga
Geoffrey Kondogbia,cf CTA,"MF,DF",Atlético Madrid,28.0,1993.0,20.9,74,44,25,40,9,21,49,42.9,28,16,5,11,44,118,24,0,Matches,2021-2022,La-Liga
Jules Koundé,fr FRA,DF,Sevilla,22.0,1998.0,30.4,40,17,27,10,3,18,28,64.3,10,33,18,15,21,61,101,2,Matches,2021-2022,La-Liga
Toni Kroos,de GER,MF,Real Madrid,31.0,1990.0,23.4,34,26,13,17,4,14,36,38.9,22,16,3,13,12,46,13,1,Matches,2021-2022,La-Liga
Takefusa Kubo,jp JPN,"FW,MF",Mallorca,20.0,2001.0,17.8,31,19,12,14,5,10,24,41.7,14,24,3,21,8,39,4,0,Matches,2021-2022,La-Liga
Víctor Laguardia,es ESP,DF,Alavés,31.0,1989.0,33.8,29,16,21,8,0,19,30,63.3,11,36,24,12,27,56,151,1,Matches,2021-2022,La-Liga
Diego Lainez,mx MEX,FW,Betis,21.0,2000.0,1.6,1,1,0,1,0,0,3,0.0,3,3,0,3,1,2,0,0,Matches,2021-2022,La-Liga
Érik Lamela,ar ARG,"FW,MF",Sevilla,29.0,1992.0,11.3,31,18,12,14,5,10,29,34.5,19,11,0,11,5,36,3,0,Matches,2021-2022,La-Liga
Juanmi Latasa,es ESP,FW,Real Madrid,20.0,2001.0,0.1,0,0,0,0,0,0,0,,0,0,0,0,0,0,0,0,Matches,2021-2022,La-Liga
Toni Lato,es ESP,DF,Valencia,23.0,1997.0,6.6,17,12,12,3,2,9,16,56.3,7,6,0,6,8,25,14,0,Matches,2021-2022,La-Liga
Robin Le Normand,es ESP,DF,Real Sociedad,24.0,1996.0,37.0,49,32,36,8,5,28,36,77.8,8,34,22,12,48,97,125,0,Matches,2021-2022,La-Liga
Jeremías Ledesma,ar ARG,GK,Cádiz,28.0,1993.0,38.0,3,1,3,0,0,3,4,75.0,1,0,0,0,1,4,21,4,Matches,2021-2022,La-Liga
Wu Lei,cn CHN,"FW,MF",Espanyol,29.0,1991.0,5.3,3,2,1,2,0,3,8,37.5,5,4,0,4,4,7,3,0,Matches,2021-2022,La-Liga
Florian Lejeune,fr FRA,DF,Alavés,30.0,1991.0,30.0,33,24,22,10,1,12,20,60.0,8,30,19,11,31,64,158,0,Matches,2021-2022,La-Liga
Iñigo Lekue,es ESP,DF,Athletic Club,28.0,1993.0,21.4,32,23,16,12,4,22,44,50.0,22,37,12,25,23,55,63,0,Matches,2021-2022,La-Liga
Thomas Lemar,fr FRA,MF,Atlético Madrid,25.0,1995.0,16.0,24,14,9,12,3,8,23,34.8,15,18,0,18,8,32,11,0,Matches,2021-2022,La-Liga
Ruben Lendinez,es ESP,DF,Valencia,18.0,2003.0,1.5,3,3,1,2,0,3,8,37.5,5,4,0,4,2,5,6,0,Matches,2021-2022,La-Liga
Clément Lenglet,fr FRA,DF,Barcelona,26.0,1995.0,9.2,20,11,11,7,2,8,13,61.5,5,7,3,4,13,33,21,0,Matches,2021-2022,La-Liga
Javier Llabrés,es ESP,"FW,MF",Mallorca,18.0,2002.0,1.5,2,1,0,1,1,1,2,50.0,1,1,0,1,0,2,0,0,Matches,2021-2022,La-Liga
Marcos Llorente,es ESP,"MF,DF",Atlético Madrid,26.0,1995.0,27.2,51,23,25,22,4,28,43,65.1,15,33,10,23,27,78,44,0,Matches,2021-2022,La-Liga
Giovani Lo Celso,ar ARG,"FW,MF",Villarreal,25.0,1996.0,11.0,22,12,8,10,4,9,22,40.9,13,4,0,4,5,27,3,0,Matches,2021-2022,La-Liga
Julen Lobete,es ESP,"FW,MF",Real Sociedad,20.0,2000.0,3.2,4,3,3,0,1,1,2,50.0,1,6,1,5,1,5,1,0,Matches,2021-2022,La-Liga
Renan Lodi,br BRA,DF,Atlético Madrid,23.0,1998.0,13.1,31,18,14,13,4,11,27,40.7,16,22,4,18,13,44,19,1,Matches,2021-2022,La-Liga
David López,es ESP,"MF,DF",Espanyol,31.0,1989.0,8.3,18,13,9,8,1,9,16,56.3,7,10,8,2,10,28,25,2,Matches,2021-2022,La-Liga
Diego López,es ESP,GK,Espanyol,39.0,1981.0,35.3,0,0,0,0,0,0,2,0.0,2,0,0,0,1,1,21,1,Matches,2021-2022,La-Liga
Javi López,es ESP,DF,Alavés,19.0,2002.0,5.1,8,6,6,2,0,4,6,66.7,2,7,1,6,4,12,15,0,Matches,2021-2022,La-Liga
Unai López,es ESP,MF,Rayo Vallecano,25.0,1995.0,12.9,19,9,6,10,3,10,33,30.3,23,7,0,7,10,29,8,1,Matches,2021-2022,La-Liga
Mamadou Loum,sn SEN,MF,Alavés,24.0,1996.0,25.7,49,22,26,22,1,17,45,37.8,28,30,11,19,37,86,68,1,Matches,2021-2022,La-Liga
Anthony Lozano,hn HON,"FW,MF",Cádiz,28.0,1993.0,18.6,8,4,2,3,3,5,18,27.8,13,16,2,14,2,10,7,0,Matches,2021-2022,La-Liga
Florentino Luís,pt POR,MF,Getafe,21.0,1999.0,11.0,42,25,22,17,3,17,35,48.6,18,21,2,19,21,63,11,1,Matches,2021-2022,La-Liga
José Luis Gayà,es ESP,DF,Valencia,26.0,1995.0,20.8,35,21,24,10,1,16,34,47.1,18,17,3,14,19,54,37,0,Matches,2021-2022,La-Liga
José Luis Morales,es ESP,"FW,MF",Levante,34.0,1987.0,30.2,27,17,6,9,12,12,42,28.6,30,29,0,29,4,31,7,0,Matches,2021-2022,La-Liga
Luismi,es ESP,"FW,MF",Sevilla,20.0,2001.0,0.1,0,0,0,0,0,0,0,,0,0,0,0,0,0,0,0,Matches,2021-2022,La-Liga
Andriy Lunin,ua UKR,GK,Real Madrid,22.0,1999.0,2.0,0,0,0,0,0,0,0,,0,0,0,0,0,0,2,0,Matches,2021-2022,La-Liga
Darwin Machís,ve VEN,"MF,FW",Granada,28.0,1993.0,15.3,23,13,11,8,4,9,23,39.1,14,10,0,10,15,38,17,0,Matches,2021-2022,La-Liga
Pablo Maffeo,es ESP,DF,Mallorca,24.0,1997.0,32.7,84,47,48,28,8,38,69,55.1,31,30,13,17,46,130,74,0,Matches,2021-2022,La-Liga
Nemanja Maksimović,rs SRB,MF,Getafe,26.0,1995.0,32.6,56,32,24,26,6,18,49,36.7,31,42,13,29,71,127,41,0,Matches,2021-2022,La-Liga
Hugo Mallo,es ESP,DF,Celta Vigo,30.0,1991.0,20.3,45,25,24,19,2,16,31,51.6,15,23,9,14,20,65,53,0,Matches,2021-2022,La-Liga
Mickael Malsa,mq MTQ,MF,Levante,25.0,1995.0,12.7,37,17,16,18,3,15,42,35.7,27,20,8,12,18,55,15,0,Matches,2021-2022,La-Liga
Giorgi Mamardashvili,ge GEO,GK,Valencia,20.0,2000.0,18.0,0,0,0,0,0,0,0,,0,0,0,0,0,0,6,1,Matches,2021-2022,La-Liga
Reinildo Mandava,mz MOZ,DF,Atlético Madrid,27.0,1994.0,14.4,45,25,30,14,1,22,30,73.3,8,18,9,9,21,66,38,0,Matches,2021-2022,La-Liga
Aïssa Mandi,dz ALG,DF,Villarreal,29.0,1991.0,15.3,11,5,2,8,1,3,6,50.0,3,17,14,3,13,24,49,3,Matches,2021-2022,La-Liga
Nikola Maraš,rs SRB,DF,Rayo Vallecano,25.0,1995.0,11.6,13,9,12,1,0,9,15,60.0,6,17,13,4,15,28,51,0,Matches,2021-2022,La-Liga
Marcelo,br BRA,DF,Real Madrid,33.0,1988.0,5.8,8,4,2,3,3,5,10,50.0,5,7,2,5,1,9,11,0,Matches,2021-2022,La-Liga
Iván Marcone,ar ARG,MF,Elche,31.0,1990.0,9.0,24,14,17,6,1,12,24,50.0,12,8,3,5,12,36,13,0,Matches,2021-2022,La-Liga
Óscar de Marcos,es ESP,DF,Athletic Club,32.0,1989.0,18.7,50,37,24,19,7,28,43,65.1,15,20,3,17,19,69,27,0,Matches,2021-2022,La-Liga
José Mari,es ESP,MF,Cádiz,33.0,1987.0,4.3,14,7,3,10,1,7,8,87.5,1,4,1,3,7,21,2,0,Matches,2021-2022,La-Liga
José María Giménez,uy URU,DF,Atlético Madrid,26.0,1995.0,22.7,18,12,12,6,0,8,16,50.0,8,25,19,6,25,43,96,1,Matches,2021-2022,La-Liga
Mariano,do DOM,FW,Real Madrid,27.0,1993.0,3.8,2,0,2,0,0,0,0,,0,2,0,2,1,3,3,0,Matches,2021-2022,La-Liga
Mika Mármol,es ESP,DF,Barcelona,20.0,2001.0,0.0,0,0,0,0,0,0,0,,0,0,0,0,0,0,0,0,Matches,2021-2022,La-Liga
Roger Martí,es ESP,FW,Levante,30.0,1991.0,23.5,23,14,3,13,7,8,30,26.7,22,14,0,14,2,25,8,0,Matches,2021-2022,La-Liga
Anthony Martial,fr FRA,"FW,MF",Sevilla,25.0,1995.0,5.4,2,1,0,0,2,2,6,33.3,4,4,0,4,0,2,3,0,Matches,2021-2022,La-Liga
Martín,es ESP,MF,Cádiz,22.0,1999.0,1.3,2,2,0,2,0,0,0,,0,1,0,1,1,3,3,0,Matches,2021-2022,La-Liga
Ander Martin,es ESP,"FW,MF",Real Sociedad,20.0,2000.0,1.0,1,0,0,1,0,1,1,100.0,0,0,0,0,3,4,1,0,Matches,2021-2022,La-Liga
Andrés Martín,es ESP,"FW,MF",Rayo Vallecano,22.0,1999.0,2.1,0,0,0,0,0,0,1,0.0,1,1,0,1,0,0,0,0,Matches,2021-2022,La-Liga
Carlos Martín,es ESP,DF,Atlético Madrid,19.0,2002.0,0.1,0,0,0,0,0,0,0,,0,0,0,0,0,0,1,0,Matches,2021-2022,La-Liga
Iván Martín,es ESP,"MF,FW",Alavés,22.0,1999.0,1.8,1,1,1,0,0,0,1,0.0,1,2,0,2,1,2,1,0,Matches,2021-2022,La-Liga
Iñigo Martínez,es ESP,DF,Athletic Club,30.0,1991.0,26.0,28,13,18,7,3,14,23,60.9,9,22,10,12,39,67,143,0,Matches,2021-2022,La-Liga
Javi Martínez,es ESP,"MF,FW",Osasuna,21.0,1999.0,9.8,21,14,8,11,2,10,29,34.5,19,6,0,6,9,30,10,0,Matches,2021-2022,La-Liga
Pablo Martínez,es ESP,MF,Levante,23.0,1998.0,7.3,15,8,7,8,0,4,13,30.8,9,6,3,3,15,30,5,0,Matches,2021-2022,La-Liga
Omar Mascarell,gq EQG,MF,Elche,28.0,1993.0,27.7,46,26,16,23,7,24,60,40.0,36,42,14,28,48,94,52,2,Matches,2021-2022,La-Liga
Jaime Mata,es ESP,FW,Getafe,32.0,1988.0,7.5,7,5,3,1,3,1,9,11.1,8,4,1,3,1,8,5,0,Matches,2021-2022,La-Liga
Luís Maximiano,pt POR,GK,Granada,22.0,1999.0,34.8,3,1,3,0,0,3,6,50.0,3,0,0,0,1,4,16,2,Matches,2021-2022,La-Liga
Borja Mayoral,es ESP,FW,Getafe,24.0,1997.0,11.6,7,5,2,3,2,1,2,50.0,1,10,4,6,4,11,3,0,Matches,2021-2022,La-Liga
Jordi Mboula,es ESP,FW,Mallorca,22.0,1999.0,4.8,8,2,3,3,2,5,9,55.6,4,7,1,6,3,11,3,0,Matches,2021-2022,La-Liga
Óscar Melendo,es ESP,"MF,FW",Espanyol,23.0,1997.0,11.0,11,5,4,4,3,3,13,23.1,10,4,1,3,1,12,10,0,Matches,2021-2022,La-Liga
Gonzalo Melero,es ESP,MF,Levante,27.0,1994.0,18.8,29,16,10,15,4,16,36,44.4,20,21,8,13,7,36,22,0,Matches,2021-2022,La-Liga
Memphis,nl NED,FW,Barcelona,27.0,1994.0,20.6,10,4,2,4,4,3,13,23.1,10,9,1,8,3,13,4,0,Matches,2021-2022,La-Liga
Tomás Mendes,es ESP,MF,Alavés,16.0,2004.0,0.1,0,0,0,0,0,0,0,,0,0,0,0,0,0,1,0,Matches,2021-2022,La-Liga
Brais Méndez,es ESP,MF,Celta Vigo,24.0,1997.0,33.6,68,35,24,35,9,26,87,29.9,61,52,6,46,37,105,30,0,Matches,2021-2022,La-Liga
Édgar Méndez,es ESP,"FW,MF",Alavés,31.0,1990.0,17.9,25,14,11,10,4,11,34,32.4,23,16,0,16,4,29,17,0,Matches,2021-2022,La-Liga
Ferland Mendy,fr FRA,DF,Real Madrid,26.0,1995.0,19.3,24,14,11,10,3,8,14,57.1,6,8,2,6,18,42,27,3,Matches,2021-2022,La-Liga
Fran Mérida,es ESP,MF,Espanyol,31.0,1990.0,3.0,7,3,5,2,0,4,10,40.0,6,1,0,1,6,13,1,0,Matches,2021-2022,La-Liga
Mikel Merino,es ESP,MF,Real Sociedad,25.0,1996.0,32.1,71,38,21,40,10,26,67,38.8,41,50,10,40,21,92,56,2,Matches,2021-2022,La-Liga
Martín Merquelanz,es ESP,"FW,MF",Rayo Vallecano,26.0,1995.0,1.9,2,1,2,0,0,2,6,33.3,4,2,0,2,0,2,1,0,Matches,2021-2022,La-Liga
Matt Miazga,us USA,DF,Alavés,26.0,1995.0,9.3,7,7,3,4,0,2,7,28.6,5,14,12,2,11,18,55,1,Matches,2021-2022,La-Liga
Miguel,es ESP,"FW,MF",Alavés,21.0,1999.0,9.2,7,3,1,5,1,2,15,13.3,13,6,0,6,1,8,7,0,Matches,2021-2022,La-Liga
Éder Militão,br BRA,DF,Real Madrid,23.0,1998.0,33.7,50,32,30,12,8,20,39,51.3,19,42,20,22,52,102,107,3,Matches,2021-2022,La-Liga
Luis Milla,es ESP,MF,Granada,26.0,1994.0,30.8,59,29,25,30,4,25,64,39.1,39,28,4,24,25,84,34,0,Matches,2021-2022,La-Liga
Pere Milla,es ESP,"MF,FW",Elche,28.0,1992.0,18.3,20,15,14,5,1,8,44,18.2,36,21,1,20,5,25,21,0,Matches,2021-2022,La-Liga
Santi Mina,es ESP,FW,Celta Vigo,25.0,1995.0,26.3,27,17,8,15,4,5,32,15.6,27,28,2,26,6,33,22,0,Matches,2021-2022,La-Liga
Óscar Mingueza,es ESP,DF,Barcelona,22.0,1999.0,9.9,25,11,12,11,2,16,23,69.6,7,5,0,5,9,34,22,1,Matches,2021-2022,La-Liga
Rafa Mir,es ESP,FW,Sevilla,24.0,1997.0,20.1,4,3,1,1,2,0,11,0.0,11,4,3,1,0,4,17,0,Matches,2021-2022,La-Liga
Jorge Miramón,es ESP,DF,Levante,32.0,1989.0,22.0,36,19,16,12,8,15,44,34.1,29,15,3,12,35,71,58,0,Matches,2021-2022,La-Liga
Juan Miranda,es ESP,DF,Betis,21.0,2000.0,8.7,21,11,16,4,1,12,22,54.5,10,10,4,6,15,36,22,0,Matches,2021-2022,La-Liga
Stefan Mitrović,rs SRB,DF,Getafe,31.0,1990.0,29.6,16,8,12,4,0,8,13,61.5,5,28,18,10,22,38,114,1,Matches,2021-2022,La-Liga
Luka Modrić,hr CRO,MF,Real Madrid,35.0,1985.0,22.6,18,10,8,7,3,6,27,22.2,21,10,4,6,20,38,9,0,Matches,2021-2022,La-Liga
Johan Mojica,co COL,DF,Elche,28.0,1992.0,31.7,46,25,34,7,5,23,31,74.2,8,22,3,19,25,71,61,3,Matches,2021-2022,La-Liga
Jorge Molina,es ESP,FW,Granada,39.0,1982.0,21.8,4,2,2,1,1,2,18,11.1,16,13,2,11,6,10,11,0,Matches,2021-2022,La-Liga
Jon Moncayola,es ESP,MF,Osasuna,23.0,1998.0,32.4,40,20,18,18,4,17,44,38.6,27,26,9,17,20,60,43,0,Matches,2021-2022,La-Liga
Monchu,es ESP,MF,Granada,21.0,1999.0,7.4,15,6,5,9,1,5,10,50.0,5,8,3,5,4,19,4,0,Matches,2021-2022,La-Liga
Gonzalo Montiel,ar ARG,DF,Sevilla,24.0,1997.0,11.8,15,4,8,5,2,12,24,50.0,12,8,2,6,10,25,22,0,Matches,2021-2022,La-Liga
Ángel Montoro,es ESP,MF,Granada,33.0,1988.0,14.8,26,13,16,7,3,17,27,63.0,10,11,1,10,11,37,29,1,Matches,2021-2022,La-Liga
Martín Montoya,es ESP,DF,Betis,30.0,1991.0,5.8,20,12,11,7,2,15,26,57.7,11,6,0,6,11,31,20,0,Matches,2021-2022,La-Liga
Jon Morcillo,es ESP,"MF,FW",Athletic Club,22.0,1998.0,0.6,3,0,1,2,0,3,4,75.0,1,1,0,1,0,3,0,0,Matches,2021-2022,La-Liga
Alberto Moreno,es ESP,"MF,DF",Villarreal,29.0,1992.0,13.6,13,7,5,7,1,5,18,27.8,13,13,1,12,27,40,15,0,Matches,2021-2022,La-Liga
Álex Moreno,es ESP,DF,Betis,28.0,1993.0,26.7,76,40,53,15,8,33,60,55.0,27,28,6,22,34,110,82,1,Matches,2021-2022,La-Liga
Gerard Moreno,es ESP,FW,Villarreal,29.0,1992.0,13.2,5,2,2,2,1,1,7,14.3,6,6,1,5,6,11,14,0,Matches,2021-2022,La-Liga
Tete Morente,es ESP,MF,Elche,24.0,1996.0,18.1,21,14,13,7,1,7,28,25.0,21,30,1,29,12,33,12,0,Matches,2021-2022,La-Liga
Ilaix Moriba,gn GUI,MF,Valencia,18.0,2003.0,9.1,26,18,10,13,3,14,35,40.0,21,15,0,15,12,38,14,0,Matches,2021-2022,La-Liga
Manu Morlanes,es ESP,MF,Espanyol,22.0,1999.0,12.7,36,15,16,17,3,18,43,41.9,25,24,5,19,13,49,17,0,Matches,2021-2022,La-Liga
Loren Morón,es ESP,"FW,MF",Espanyol,27.0,1993.0,6.3,6,4,1,3,2,0,12,0.0,12,11,1,10,2,8,9,0,Matches,2021-2022,La-Liga
Loren Morón,es ESP,FW,Betis,27.0,1993.0,0.0,1,1,1,0,0,1,1,100.0,0,0,0,0,0,1,0,0,Matches,2021-2022,La-Liga
Cristhian Mosquera,es ESP,DF,Valencia,17.0,2004.0,2.4,4,2,3,0,1,3,6,50.0,3,1,0,1,3,7,1,1,Matches,2021-2022,La-Liga
Toni Moya,es ESP,MF,Alavés,23.0,1998.0,15.4,23,10,7,13,3,13,43,30.2,30,18,5,13,20,43,18,0,Matches,2021-2022,La-Liga
Iker Muniain,es ESP,MF,Athletic Club,28.0,1992.0,30.9,32,10,8,19,5,12,40,30.0,28,20,1,19,17,49,8,1,Matches,2021-2022,La-Liga
Aihen Muñoz,es ESP,DF,Real Sociedad,23.0,1997.0,14.9,28,17,14,13,1,18,29,62.1,11,11,1,10,17,45,34,0,Matches,2021-2022,La-Liga
Jeison Murillo,co COL,DF,Celta Vigo,29.0,1992.0,12.4,15,10,13,2,0,9,13,69.2,4,11,8,3,17,32,37,0,Matches,2021-2022,La-Liga
Vedat Muriqi,xk KVX,FW,Mallorca,27.0,1994.0,16.0,6,3,1,3,2,1,7,14.3,6,12,0,12,6,12,29,0,Matches,2021-2022,La-Liga
Yunus Musah,us USA,"MF,FW",Valencia,18.0,2002.0,14.0,23,13,8,8,7,6,20,30.0,14,19,1,18,14,37,11,0,Matches,2021-2022,La-Liga
Shkodran Mustafi,de GER,DF,Levante,29.0,1992.0,7.3,9,6,6,3,0,5,9,55.6,4,6,3,3,15,24,40,0,Matches,2021-2022,La-Liga
Nacho,es ESP,DF,Real Madrid,31.0,1990.0,17.3,18,14,9,9,0,12,22,54.5,10,22,15,7,34,52,50,0,Matches,2021-2022,La-Liga
Roberto Navarro,es ESP,"MF,FW",Real Sociedad,19.0,2002.0,2.2,5,3,1,1,3,3,5,60.0,2,2,0,2,2,7,2,0,Matches,2021-2022,La-Liga
Ximo Navarro,es ESP,DF,Alavés,31.0,1990.0,15.0,28,19,21,6,1,13,27,48.1,14,11,5,6,22,50,56,2,Matches,2021-2022,La-Liga
Jesús Navas,es ESP,DF,Sevilla,35.0,1985.0,19.8,18,13,11,5,2,9,17,52.9,8,15,2,13,17,35,26,1,Matches,2021-2022,La-Liga
Álvaro Negredo,es ESP,FW,Cádiz,35.0,1985.0,24.0,5,3,1,4,0,3,6,50.0,3,11,5,6,2,7,23,0,Matches,2021-2022,La-Liga
Neto,br BRA,GK,Barcelona,32.0,1989.0,3.0,0,0,0,0,0,0,0,,0,0,0,0,0,0,2,1,Matches,2021-2022,La-Liga
Carlos Neva,es ESP,DF,Granada,25.0,1996.0,23.4,31,19,24,7,0,16,28,57.1,12,27,9,18,32,63,81,0,Matches,2021-2022,La-Liga
Saúl Ñíguez,es ESP,"FW,MF",Atlético Madrid,26.0,1994.0,2.2,7,2,0,6,1,3,4,75.0,1,7,1,6,0,7,3,0,Matches,2021-2022,La-Liga
Fernando Niño,es ESP,FW,Mallorca,20.0,2000.0,9.8,10,4,3,2,5,2,12,16.7,10,9,2,7,3,13,15,0,Matches,2021-2022,La-Liga
Peru Nolaskoain,es ESP,DF,Athletic Club,22.0,1998.0,0.0,0,0,0,0,0,0,0,,0,0,0,0,0,0,0,0,Matches,2021-2022,La-Liga
Nolito,es ESP,MF,Celta Vigo,34.0,1986.0,15.4,25,15,14,7,4,13,47,27.7,34,20,1,19,9,34,5,0,Matches,2021-2022,La-Liga
Randy Nteka,ao ANG,"FW,MF",Rayo Vallecano,23.0,1997.0,16.2,24,13,9,11,4,8,19,42.1,11,21,1,20,8,32,12,0,Matches,2021-2022,La-Liga
Unai Núñez,es ESP,DF,Athletic Club,24.0,1997.0,6.9,4,4,2,2,0,3,6,50.0,3,9,8,1,8,12,26,2,Matches,2021-2022,La-Liga
Allan Nyom,cm CMR,DF,Getafe,33.0,1988.0,2.7,3,1,2,1,0,2,2,100.0,0,2,1,1,2,5,7,0,Matches,2021-2022,La-Liga
Jan Oblak,si SVN,GK,Atlético Madrid,28.0,1993.0,38.0,0,0,0,0,0,0,0,,0,0,0,0,1,1,10,4,Matches,2021-2022,La-Liga
Lucas Ocampos,ar ARG,FW,Sevilla,27.0,1994.0,23.6,45,24,23,18,4,23,55,41.8,32,35,1,34,9,54,24,1,Matches,2021-2022,La-Liga
Lucas Olaza,uy URU,DF,Elche,27.0,1994.0,3.3,5,3,3,1,1,1,1,100.0,0,5,1,4,4,9,6,0,Matches,2021-2022,La-Liga
Oier Olazábal,es ESP,GK,Espanyol,31.0,1989.0,1.5,0,0,0,0,0,0,0,,0,0,0,0,0,0,0,0,Matches,2021-2022,La-Liga
Brian Oliván,es ESP,DF,Mallorca,27.0,1994.0,24.3,33,20,22,9,2,12,23,52.2,11,17,7,10,28,61,63,0,Matches,2021-2022,La-Liga
Mathías Olivera,uy URU,DF,Getafe,23.0,1997.0,31.1,79,47,39,34,6,40,69,58.0,29,45,4,41,55,134,67,1,Matches,2021-2022,La-Liga
Javier Ontiveros,es ESP,"FW,MF",Osasuna,23.0,1997.0,0.4,0,0,0,0,0,0,2,0.0,2,0,0,0,1,1,0,1,Matches,2021-2022,La-Liga
Pedro Ortiz,es ESP,MF,Sevilla,20.0,2000.0,0.1,0,0,0,0,0,0,0,,0,0,0,0,0,0,1,0,Matches,2021-2022,La-Liga
Milutin Osmajić,me MNE,"FW,MF",Cádiz,22.0,1999.0,2.9,1,1,0,1,0,0,0,,0,0,0,0,1,2,3,0,Matches,2021-2022,La-Liga
Jesús Owono,gq EQG,GK,Alavés,20.0,2001.0,1.0,0,0,0,0,0,0,0,,0,0,0,0,0,0,1,0,Matches,2021-2022,La-Liga
Mikel Oyarzabal,es ESP,"FW,MF",Real Sociedad,24.0,1997.0,18.6,18,10,7,7,4,7,21,33.3,14,18,2,16,10,28,16,1,Matches,2021-2022,La-Liga
Fernando Pacheco,es ESP,GK,Alavés,29.0,1992.0,33.9,2,1,2,0,0,2,2,100.0,0,0,0,0,0,2,18,1,Matches,2021-2022,La-Liga
Jon Pacheco,es ESP,DF,Real Sociedad,20.0,2001.0,4.2,6,4,4,2,0,3,3,100.0,0,6,4,2,6,12,18,0,Matches,2021-2022,La-Liga
Helibelton Palacios,co COL,DF,Elche,28.0,1993.0,21.5,69,38,56,10,3,37,55,67.3,18,21,8,13,18,87,61,0,Matches,2021-2022,La-Liga
Isaac Palazón Camacho,es ESP,"FW,MF",Rayo Vallecano,26.0,1994.0,25.4,42,28,20,19,3,18,59,30.5,41,31,3,28,13,55,22,0,Matches,2021-2022,La-Liga
Daniel Parejo,es ESP,MF,Villarreal,32.0,1989.0,30.0,43,29,15,15,13,20,52,38.5,32,32,7,25,29,72,19,1,Matches,2021-2022,La-Liga
Raúl Parra,es ESP,DF,Cádiz,21.0,1999.0,1.0,2,1,2,0,0,1,3,33.3,2,0,0,0,0,2,5,0,Matches,2021-2022,La-Liga
Javier Pastore,ar ARG,"MF,FW",Elche,32.0,1989.0,5.8,7,3,3,2,2,3,12,25.0,9,5,1,4,4,11,2,0,Matches,2021-2022,La-Liga
Gabriel Paulista,br BRA,DF,Valencia,30.0,1990.0,17.7,21,12,16,5,0,14,20,70.0,6,18,12,6,39,60,88,0,Matches,2021-2022,La-Liga
Alfonso Pedraza,es ESP,DF,Villarreal,25.0,1996.0,18.9,34,16,17,12,5,10,28,35.7,18,12,3,9,31,65,32,0,Matches,2021-2022,La-Liga
Pedri,es ESP,MF,Barcelona,18.0,2002.0,9.8,20,12,9,8,3,7,20,35.0,13,13,0,13,5,25,7,1,Matches,2021-2022,La-Liga
Adrià Pedrosa,es ESP,DF,Espanyol,23.0,1998.0,30.2,58,30,38,14,6,26,57,45.6,31,25,7,18,25,83,92,2,Matches,2021-2022,La-Liga
Facundo Pellistri,uy URU,"MF,FW",Alavés,19.0,2001.0,7.5,9,5,4,3,2,1,10,10.0,9,13,2,11,6,15,7,0,Matches,2021-2022,La-Liga
Rubén Peña,es ESP,"MF,FW",Villarreal,30.0,1991.0,1.5,2,0,1,1,0,2,6,33.3,4,1,0,1,5,7,2,0,Matches,2021-2022,La-Liga
Alberto Perea,es ESP,MF,Cádiz,30.0,1990.0,8.6,19,9,7,9,3,6,20,30.0,14,15,1,14,9,28,4,0,Matches,2021-2022,La-Liga
Iñigo Pérez,es ESP,MF,Osasuna,33.0,1988.0,3.8,3,2,2,1,0,2,4,50.0,2,1,0,1,0,3,3,0,Matches,2021-2022,La-Liga
Juan Pérez,es ESP,GK,Osasuna,25.0,1996.0,2.0,0,0,0,0,0,0,1,0.0,1,0,0,0,0,0,1,1,Matches,2021-2022,La-Liga
Kike Pérez,es ESP,"MF,FW",Elche,24.0,1997.0,5.8,8,6,1,3,4,0,10,0.0,10,6,1,5,3,11,4,0,Matches,2021-2022,La-Liga
Lucas Pérez,es ESP,FW,Elche,32.0,1988.0,14.1,4,1,2,1,1,3,10,30.0,7,2,0,2,3,7,4,0,Matches,2021-2022,La-Liga
Lucas Pérez,es ESP,"FW,MF",Cádiz,32.0,1988.0,11.8,3,3,2,1,0,0,10,0.0,10,3,1,2,0,3,1,0,Matches,2021-2022,La-Liga
Njegoš Petrović,rs SRB,MF,Granada,22.0,1999.0,10.2,24,11,4,19,1,8,14,57.1,6,16,4,12,9,33,11,0,Matches,2021-2022,La-Liga
Alex Petxa,es ESP,"DF,MF",Athletic Club,24.0,1997.0,4.6,12,9,4,7,1,4,8,50.0,4,8,2,6,4,16,6,0,Matches,2021-2022,La-Liga
Germán Pezzella,ar ARG,DF,Betis,30.0,1991.0,22.1,21,9,16,5,0,16,29,55.2,13,29,18,11,39,60,106,0,Matches,2021-2022,La-Liga
Pablo Piatti,ar ARG,"MF,FW",Elche,32.0,1989.0,3.5,9,4,5,3,1,3,8,37.5,5,5,1,4,2,11,3,0,Matches,2021-2022,La-Liga
Cristiano Piccini,it ITA,DF,Valencia,28.0,1992.0,3.6,14,8,9,5,0,5,7,71.4,2,3,2,1,1,15,11,0,Matches,2021-2022,La-Liga
Tomás Pina Isla,es ESP,MF,Alavés,33.0,1987.0,16.0,28,16,13,11,4,14,29,48.3,15,12,3,9,22,50,23,0,Matches,2021-2022,La-Liga
Orbelín Pineda,mx MEX,"MF,FW",Celta Vigo,25.0,1996.0,1.1,4,1,4,0,0,1,2,50.0,1,0,0,0,0,4,1,0,Matches,2021-2022,La-Liga
Yeremi Pino,es ESP,"MF,FW",Villarreal,18.0,2002.0,18.6,32,14,14,8,10,10,24,41.7,14,33,4,29,6,38,12,1,Matches,2021-2022,La-Liga
Gerard Piqué,es ESP,DF,Barcelona,34.0,1987.0,23.2,22,12,18,4,0,11,14,78.6,3,19,16,3,34,56,86,1,Matches,2021-2022,La-Liga
Ezequiel Ponce,ar ARG,FW,Elche,24.0,1997.0,7.4,5,4,1,3,1,3,10,30.0,7,5,0,5,1,6,7,0,Matches,2021-2022,La-Liga
Pere Pons,es ESP,MF,Alavés,28.0,1993.0,15.2,26,18,4,20,2,7,21,33.3,14,10,1,9,6,32,11,0,Matches,2021-2022,La-Liga
Portu,es ESP,"FW,MF",Real Sociedad,29.0,1992.0,17.7,16,7,2,6,8,3,19,15.8,16,21,3,18,7,23,8,0,Matches,2021-2022,La-Liga
Sergio Postigo,es ESP,DF,Levante,32.0,1988.0,9.4,11,7,8,2,1,4,8,50.0,4,7,5,2,7,18,45,1,Matches,2021-2022,La-Liga
Darío Poveda,es ESP,"FW,MF",Getafe,24.0,1997.0,4.2,2,0,1,0,1,0,5,0.0,5,7,1,6,1,3,1,0,Matches,2021-2022,La-Liga
José Pozo,es ESP,"MF,DF",Rayo Vallecano,25.0,1996.0,0.8,2,2,0,2,0,2,3,66.7,1,1,0,1,0,2,1,0,Matches,2021-2022,La-Liga
Abdón Prats,es ESP,FW,Mallorca,28.0,1992.0,7.1,2,2,1,0,1,1,5,20.0,4,5,0,5,1,3,6,0,Matches,2021-2022,La-Liga
Alejandro Primo,es ESP,GK,Levante,17.0,2004.0,1.0,0,0,0,0,0,0,0,,0,0,0,0,0,0,0,0,Matches,2021-2022,La-Liga
Javi Puado,es ESP,"MF,FW",Espanyol,23.0,1998.0,24.9,24,14,18,5,1,12,37,32.4,25,18,2,16,11,35,24,0,Matches,2021-2022,La-Liga
Marc Pubill,es ESP,"DF,MF",Levante,18.0,2003.0,5.7,12,6,10,2,0,4,8,50.0,4,7,2,5,4,16,8,2,Matches,2021-2022,La-Liga
Antonio Puertas,es ESP,"MF,FW",Granada,29.0,1992.0,25.1,34,20,18,12,4,17,44,38.6,27,33,3,30,11,45,36,0,Matches,2021-2022,La-Liga
Riqui Puig,es ESP,MF,Barcelona,21.0,1999.0,5.4,6,3,2,4,0,2,14,14.3,12,5,0,5,3,9,0,0,Matches,2021-2022,La-Liga
Yacine Qasmi,ma MAR,FW,Rayo Vallecano,30.0,1991.0,0.0,0,0,0,0,0,0,0,,0,0,0,0,0,0,0,0,Matches,2021-2022,La-Liga
Quini,es ESP,DF,Granada,31.0,1989.0,25.6,73,34,48,21,4,42,79,53.2,37,28,10,18,36,109,62,0,Matches,2021-2022,La-Liga
Dani Raba,es ESP,"MF,FW",Villarreal,25.0,1995.0,1.0,1,0,0,1,0,1,2,50.0,1,2,0,2,0,1,2,0,Matches,2021-2022,La-Liga
Dani Raba,es ESP,"MF,FW",Granada,25.0,1995.0,0.3,2,2,1,0,1,2,3,66.7,1,0,0,0,1,3,0,0,Matches,2021-2022,La-Liga
Uroš Račić,rs SRB,MF,Valencia,23.0,1998.0,13.4,32,18,9,19,4,12,33,36.4,21,16,6,10,16,48,21,0,Matches,2021-2022,La-Liga
Nemanja Radoja,rs SRB,MF,Levante,28.0,1993.0,13.5,25,8,9,13,3,8,20,40.0,12,16,9,7,22,47,16,2,Matches,2021-2022,La-Liga
Rafinha,br BRA,MF,Real Sociedad,28.0,1993.0,11.7,43,27,17,20,6,16,28,57.1,12,21,2,19,12,55,4,0,Matches,2021-2022,La-Liga
Antonio Raillo,es ESP,DF,Mallorca,29.0,1991.0,17.0,16,7,10,4,2,5,6,83.3,1,17,14,3,18,34,81,0,Matches,2021-2022,La-Liga
Ivan Rakitić,hr CRO,MF,Sevilla,33.0,1988.0,24.2,40,22,12,23,5,13,40,32.5,27,31,8,23,23,63,35,0,Matches,2021-2022,La-Liga
Jonás Ramalho,es ESP,DF,Osasuna,28.0,1993.0,2.7,4,2,2,2,0,2,3,66.7,1,4,1,3,3,7,9,0,Matches,2021-2022,La-Liga
Sandro Ramírez,es ESP,FW,Getafe,26.0,1995.0,16.2,7,3,1,3,3,1,12,8.3,11,14,3,11,2,9,3,0,Matches,2021-2022,La-Liga
Raúl,es ESP,"FW,DF",Betis,20.0,2000.0,0.0,0,0,0,0,0,0,0,,0,0,0,0,0,0,0,0,Matches,2021-2022,La-Liga
Lluís Recasens,es ESP,DF,Espanyol,19.0,2002.0,0.5,2,0,2,0,0,1,1,100.0,0,0,0,0,2,4,2,0,Matches,2021-2022,La-Liga
Manolo Reina,es ESP,GK,Mallorca,36.0,1985.0,21.0,0,0,0,0,0,0,0,,0,0,0,0,1,1,6,2,Matches,2021-2022,La-Liga
Karim Rekik,nl NED,DF,Sevilla,26.0,1994.0,12.2,11,8,4,6,1,2,9,22.2,7,11,6,5,9,20,19,0,Matches,2021-2022,La-Liga
Álex Remiro,es ESP,GK,Real Sociedad,26.0,1995.0,35.0,0,0,0,0,0,0,0,,0,0,0,0,1,1,24,2,Matches,2021-2022,La-Liga
Nico Ribaudo,es ESP,"MF,FW",Espanyol,20.0,2001.0,12.4,15,6,9,5,1,11,34,32.4,23,14,2,12,7,22,3,0,Matches,2021-2022,La-Liga
Diego Rico,es ESP,DF,Real Sociedad,28.0,1993.0,18.3,41,20,19,17,5,22,45,48.9,23,29,4,25,30,71,54,0,Matches,2021-2022,La-Liga
Sergio Rico,es ESP,GK,Mallorca,27.0,1993.0,14.0,0,0,0,0,0,0,0,,0,0,0,0,0,0,5,2,Matches,2021-2022,La-Liga
Luis Rioja,es ESP,"MF,FW",Alavés,27.0,1993.0,34.6,28,15,11,10,7,14,58,24.1,44,22,1,21,25,53,20,0,Matches,2021-2022,La-Liga
Rober,es ESP,DF,Levante,26.0,1995.0,22.3,36,20,27,7,2,23,39,59.0,16,25,15,10,30,66,90,1,Matches,2021-2022,La-Liga
Sergi Roberto,es ESP,"MF,DF",Barcelona,29.0,1992.0,4.4,5,1,2,3,0,3,5,60.0,2,2,0,2,4,9,6,0,Matches,2021-2022,La-Liga
Rubén Rochina,es ESP,"MF,FW",Granada,30.0,1991.0,8.3,21,13,7,8,6,8,28,28.6,20,11,1,10,6,27,5,1,Matches,2021-2022,La-Liga
Enzo Roco,cl CHI,DF,Elche,28.0,1992.0,28.4,36,20,24,11,1,15,24,62.5,9,38,27,11,28,64,110,3,Matches,2021-2022,La-Liga
Rodri,es ESP,FW,Betis,21.0,2000.0,9.8,10,7,4,5,1,5,22,22.7,17,11,0,11,3,13,4,0,Matches,2021-2022,La-Liga
Kévin Rodrigues,pt POR,"DF,FW",Rayo Vallecano,27.0,1994.0,4.8,15,11,8,7,0,6,10,60.0,4,10,1,9,7,22,6,0,Matches,2021-2022,La-Liga
Ángel Rodríguez,es ESP,"FW,MF",Mallorca,34.0,1987.0,17.2,15,9,6,7,2,4,21,19.0,17,15,1,14,3,18,13,0,Matches,2021-2022,La-Liga
Óscar Rodríguez Arnaiz,es ESP,"MF,FW",Getafe,23.0,1998.0,10.5,16,11,6,8,2,4,12,33.3,8,7,1,6,11,27,6,0,Matches,2021-2022,La-Liga
Óscar Rodríguez Arnaiz,es ESP,"FW,MF",Sevilla,23.0,1998.0,4.6,4,3,1,3,0,2,3,66.7,1,2,0,2,5,9,7,1,Matches,2021-2022,La-Liga
Dani Rodríguez,es ESP,"MF,FW",Mallorca,33.0,1988.0,31.5,53,31,20,24,9,15,46,32.6,31,28,3,25,20,73,27,0,Matches,2021-2022,La-Liga
Guido Rodríguez,ar ARG,MF,Betis,27.0,1994.0,28.1,97,53,46,45,6,54,98,55.1,44,55,12,43,31,128,56,0,Matches,2021-2022,La-Liga
Rodrygo,br BRA,FW,Real Madrid,20.0,2001.0,16.9,18,14,7,4,7,3,18,16.7,15,21,0,21,11,29,3,0,Matches,2021-2022,La-Liga
Leo Román,es ESP,GK,Mallorca,21.0,2000.0,2.0,0,0,0,0,0,0,0,,0,0,0,0,0,0,2,0,Matches,2021-2022,La-Liga
Iván Romero,es ESP,FW,Sevilla,20.0,2001.0,2.0,2,2,0,2,0,0,0,,0,1,0,1,2,4,0,0,Matches,2021-2022,La-Liga
Unai Ropero,es ESP,MF,Alavés,19.0,2001.0,0.1,0,0,0,0,0,0,0,,0,0,0,0,1,1,0,0,Matches,2021-2022,La-Liga
Rubén,es ESP,DF,Espanyol,20.0,2001.0,1.7,6,1,4,2,0,4,7,57.1,3,0,0,0,2,8,4,0,Matches,2021-2022,La-Liga
Aitor Ruibal,es ESP,"FW,DF",Betis,25.0,1996.0,9.5,21,15,13,3,5,10,34,29.4,24,8,0,8,8,29,6,0,Matches,2021-2022,La-Liga
Isma Ruiz,es ESP,MF,Granada,20.0,2001.0,3.1,3,1,3,0,0,1,9,11.1,8,5,2,3,3,6,2,0,Matches,2021-2022,La-Liga
Víctor Ruiz,es ESP,DF,Betis,32.0,1989.0,15.8,11,9,7,2,2,6,9,66.7,3,18,13,5,29,40,71,1,Matches,2021-2022,La-Liga
Gerónimo Rulli,ar ARG,GK,Villarreal,29.0,1992.0,32.0,0,0,0,0,0,0,4,0.0,4,0,0,0,1,1,15,5,Matches,2021-2022,La-Liga
Franco Russo,ar ARG,DF,Mallorca,26.0,1994.0,16.3,19,10,10,9,0,13,31,41.9,18,14,9,5,27,46,73,1,Matches,2021-2022,La-Liga
Mathew Ryan,au AUS,GK,Real Sociedad,29.0,1992.0,3.0,0,0,0,0,0,0,0,,0,0,0,0,0,0,2,0,Matches,2021-2022,La-Liga
Youssouf Sabaly,sn SEN,DF,Betis,28.0,1993.0,8.8,12,10,11,0,1,7,13,53.8,6,11,4,7,13,25,16,1,Matches,2021-2022,La-Liga
Salvi,es ESP,"MF,FW",Cádiz,30.0,1991.0,15.5,20,10,9,8,3,8,20,40.0,12,17,2,15,6,26,11,0,Matches,2021-2022,La-Liga
Fede San Emeterio,es ESP,MF,Cádiz,24.0,1997.0,9.2,16,5,5,8,3,5,15,33.3,10,5,0,5,8,24,6,0,Matches,2021-2022,La-Liga
Oihan Sancet,es ESP,FW,Athletic Club,21.0,2000.0,15.8,12,7,2,8,2,5,20,25.0,15,2,0,2,5,17,13,0,Matches,2021-2022,La-Liga
Antonio Sánchez,es ESP,"MF,FW",Mallorca,24.0,1997.0,18.0,53,24,29,17,7,19,49,38.8,30,32,2,30,32,85,32,1,Matches,2021-2022,La-Liga
Germán Sánchez,es ESP,DF,Granada,34.0,1986.0,25.5,27,19,18,9,0,11,20,55.0,9,19,16,3,28,55,137,0,Matches,2021-2022,La-Liga
Manu Sánchez,es ESP,DF,Osasuna,20.0,2000.0,25.1,72,34,41,22,9,43,79,54.4,36,28,3,25,18,90,43,0,Matches,2021-2022,La-Liga
Oier Sanjurjo,es ESP,MF,Osasuna,35.0,1986.0,8.4,10,6,3,7,0,2,19,10.5,17,8,3,5,1,11,9,0,Matches,2021-2022,La-Liga
Jesús Santiago,es ESP,MF,Valencia,17.0,2004.0,0.9,2,2,1,1,0,0,2,0.0,2,1,0,1,0,2,1,0,Matches,2021-2022,La-Liga
Sergio Santos,es ESP,DF,Real Madrid,20.0,2001.0,0.1,0,0,0,0,0,0,0,,0,0,0,0,0,0,0,0,Matches,2021-2022,La-Liga
Alvaro Sanz,es ESP,MF,Barcelona,20.0,2001.0,0.3,0,0,0,0,0,0,1,0.0,1,0,0,0,0,0,0,0,Matches,2021-2022,La-Liga
Marcelo Saracchi,uy URU,DF,Levante,23.0,1998.0,2.1,8,5,6,1,1,2,4,50.0,2,3,0,3,4,12,7,1,Matches,2021-2022,La-Liga
Joan Sastre Vanrell,es ESP,DF,Mallorca,24.0,1997.0,2.9,6,3,5,0,1,3,4,75.0,1,3,0,3,2,8,10,0,Matches,2021-2022,La-Liga
Esteban Saveljich,me MNE,DF,Rayo Vallecano,30.0,1991.0,18.9,18,11,11,7,0,9,15,60.0,6,20,12,8,16,34,69,0,Matches,2021-2022,La-Liga
Stefan Savić,me MNE,DF,Atlético Madrid,30.0,1991.0,27.1,46,20,25,20,1,29,43,67.4,14,19,12,7,37,83,102,1,Matches,2021-2022,La-Liga
Valentino Scotta,es ESP,DF,Sevilla,19.0,2001.0,0.0,0,0,0,0,0,0,0,,0,0,0,0,0,0,0,0,Matches,2021-2022,La-Liga
Aleksandar Sedlar,rs SRB,"DF,MF",Mallorca,29.0,1991.0,4.5,5,3,4,1,0,3,5,60.0,2,4,4,0,5,10,19,0,Matches,2021-2022,La-Liga
Javier Serrano,es ESP,MF,Atlético Madrid,18.0,2003.0,0.8,3,1,0,3,0,2,4,50.0,2,0,0,0,3,6,2,0,Matches,2021-2022,La-Liga
Nicolás Serrano,es ESP,"MF,FW",Athletic Club,18.0,2003.0,3.5,9,6,3,5,1,3,10,30.0,7,5,1,4,2,11,3,0,Matches,2021-2022,La-Liga
Salva Sevilla,es ESP,MF,Mallorca,37.0,1984.0,16.7,18,12,8,8,2,6,17,35.3,11,12,6,6,14,32,11,0,Matches,2021-2022,La-Liga
David Silva,es ESP,MF,Real Sociedad,35.0,1986.0,19.1,28,17,10,11,7,3,20,15.0,17,13,3,10,7,35,12,0,Matches,2021-2022,La-Liga
Jonathan Silva,ar ARG,"DF,FW",Getafe,27.0,1994.0,2.5,10,8,4,4,2,7,12,58.3,5,4,0,4,3,13,7,0,Matches,2021-2022,La-Liga
Rui Silva,pt POR,GK,Betis,27.0,1994.0,21.8,1,0,1,0,0,1,2,50.0,1,0,0,0,1,2,11,1,Matches,2021-2022,La-Liga
Giuliano Simeone,ar ARG,MF,Atlético Madrid,18.0,2002.0,0.0,0,0,0,0,0,0,0,,0,0,0,0,0,0,0,0,Matches,2021-2022,La-Liga
Unai Simón,es ESP,GK,Athletic Club,24.0,1997.0,34.0,0,0,0,0,0,0,0,,0,0,0,0,1,1,5,1,Matches,2021-2022,La-Liga
Antonio Sivera,es ESP,GK,Alavés,24.0,1996.0,3.1,0,0,0,0,0,0,1,0.0,1,0,0,0,0,0,0,0,Matches,2021-2022,La-Liga
Rubén Sobrino,es ESP,MF,Valencia,29.0,1992.0,0.2,1,1,1,0,0,1,1,100.0,0,1,0,1,2,3,0,0,Matches,2021-2022,La-Liga
Rubén Sobrino,es ESP,"FW,MF",Cádiz,29.0,1992.0,20.7,28,17,11,10,7,5,35,14.3,30,21,1,20,21,49,18,0,Matches,2021-2022,La-Liga
Alex Sola,es ESP,"DF,FW",Real Sociedad,22.0,1999.0,0.5,1,1,1,0,0,1,3,33.3,2,1,0,1,2,3,3,0,Matches,2021-2022,La-Liga
Augusto Solari,ar ARG,"MF,DF",Celta Vigo,29.0,1992.0,7.9,24,12,9,12,3,12,32,37.5,20,14,4,10,7,31,10,1,Matches,2021-2022,La-Liga
Roberto Soldado,es ESP,FW,Levante,36.0,1985.0,7.4,3,1,0,1,2,1,3,33.3,2,4,0,4,1,4,7,0,Matches,2021-2022,La-Liga
Carlos Soler,es ESP,MF,Valencia,24.0,1997.0,27.5,29,19,10,15,4,11,37,29.7,26,19,4,15,14,43,28,0,Matches,2021-2022,La-Liga
Son,es ESP,DF,Levante,27.0,1994.0,21.9,28,18,16,7,5,17,34,50.0,17,11,5,6,19,47,33,1,Matches,2021-2022,La-Liga
David Soria,es ESP,GK,Getafe,28.0,1993.0,37.9,1,0,1,0,0,1,2,50.0,1,0,0,0,0,1,22,2,Matches,2021-2022,La-Liga
Alberto Soro,es ESP,"MF,FW",Granada,22.0,1999.0,6.4,12,10,3,6,3,1,7,14.3,6,21,2,19,3,15,4,0,Matches,2021-2022,La-Liga
Hugo Sotelo,es ESP,FW,Celta Vigo,17.0,2003.0,0.0,0,0,0,0,0,0,0,,0,0,0,0,0,0,0,0,Matches,2021-2022,La-Liga
Damián Suárez,uy URU,DF,Getafe,33.0,1988.0,30.1,74,47,34,30,10,42,91,46.2,49,46,5,41,31,105,30,0,Matches,2021-2022,La-Liga
Denis Suárez,es ESP,MF,Celta Vigo,27.0,1994.0,31.3,61,29,20,33,8,25,82,30.5,57,32,4,28,16,77,11,0,Matches,2021-2022,La-Liga
Luis Suárez,uy URU,FW,Atlético Madrid,34.0,1987.0,20.4,8,5,2,4,2,2,10,20.0,8,8,1,7,1,9,14,0,Matches,2021-2022,La-Liga
Mario Suárez,es ESP,DF,Rayo Vallecano,34.0,1987.0,7.9,9,4,7,2,0,3,9,33.3,6,6,4,2,7,16,37,1,Matches,2021-2022,La-Liga
Suso,es ESP,FW,Sevilla,27.0,1993.0,4.3,4,3,1,3,0,3,13,23.1,10,4,0,4,0,4,0,0,Matches,2021-2022,La-Liga
Mamadou Sylla,sn SEN,"FW,MF",Alavés,27.0,1994.0,4.4,2,2,0,1,1,0,1,0.0,1,0,0,0,1,3,5,0,Matches,2021-2022,La-Liga
Mamadou Sylla,sn SEN,FW,Rayo Vallecano,27.0,1994.0,2.8,1,1,1,0,0,0,1,0.0,1,2,0,2,4,5,3,0,Matches,2021-2022,La-Liga
Alexander Sørloth,no NOR,FW,Real Sociedad,25.0,1995.0,19.6,20,7,4,10,6,7,17,41.2,10,14,1,13,4,24,15,0,Matches,2021-2022,La-Liga
Tachi,es ESP,DF,Alavés,23.0,1997.0,2.7,6,3,3,3,0,5,7,71.4,2,4,3,1,1,7,9,0,Matches,2021-2022,La-Liga
Renato Tapia,pe PER,MF,Celta Vigo,26.0,1995.0,15.7,50,31,15,31,4,20,50,40.0,30,21,5,16,28,78,43,0,Matches,2021-2022,La-Liga
Cristian Tello,es ESP,FW,Betis,29.0,1991.0,9.1,17,11,6,7,4,13,31,41.9,18,9,0,9,10,27,6,0,Matches,2021-2022,La-Liga
Nahuel Tenaglia,ar ARG,DF,Alavés,25.0,1996.0,11.9,42,27,30,9,3,24,37,64.9,13,10,2,8,26,68,42,0,Matches,2021-2022,La-Liga
Marc Tenas,es ESP,"FW,MF",Alavés,20.0,2001.0,0.6,1,1,1,0,0,1,1,100.0,0,1,0,1,0,1,0,1,Matches,2021-2022,La-Liga
Marc-André ter Stegen,de GER,GK,Barcelona,29.0,1992.0,35.0,0,0,0,0,0,0,1,0.0,1,0,0,0,1,1,13,5,Matches,2021-2022,La-Liga
David Timor,es ESP,MF,Getafe,31.0,1989.0,3.8,1,1,1,0,0,0,3,0.0,3,3,2,1,1,2,4,1,Matches,2021-2022,La-Liga
Mircea Ţîrlea,ro ROU,DF,Alavés,21.0,2000.0,0.2,0,0,0,0,0,0,0,,0,0,0,0,0,0,1,0,Matches,2021-2022,La-Liga
Raúl de Tomás,es ESP,FW,Espanyol,26.0,1994.0,32.4,15,11,6,7,2,6,17,35.3,11,12,3,9,6,21,42,1,Matches,2021-2022,La-Liga
Raúl Torrente,es ESP,DF,Granada,19.0,2001.0,14.2,31,21,18,11,2,16,29,55.2,13,14,9,5,12,43,69,0,Matches,2021-2022,La-Liga
Ferrán Torres,es ESP,FW,Barcelona,21.0,2000.0,15.7,10,5,3,4,3,3,7,42.9,4,12,3,9,6,16,7,0,Matches,2021-2022,La-Liga
Óliver Torres,es ESP,"MF,FW",Sevilla,26.0,1994.0,11.2,22,12,8,7,7,8,25,32.0,17,10,1,9,6,28,4,0,Matches,2021-2022,La-Liga
Pau Torres,es ESP,DF,Villarreal,24.0,1997.0,31.7,32,19,23,7,2,18,25,72.0,7,32,23,9,19,51,105,2,Matches,2021-2022,La-Liga
Roberto Torres,es ESP,"MF,FW",Osasuna,32.0,1989.0,9.0,7,4,3,1,3,3,15,20.0,12,8,0,8,8,15,4,0,Matches,2021-2022,La-Liga
Lucas Torró,es ESP,MF,Osasuna,27.0,1994.0,30.3,71,40,25,38,8,29,57,50.9,28,32,11,21,47,118,55,0,Matches,2021-2022,La-Liga
Adama Traoré,es ESP,FW,Barcelona,25.0,1996.0,4.2,4,2,0,3,1,3,5,60.0,2,2,0,2,4,8,3,1,Matches,2021-2022,La-Liga
Óscar Trejo,ar ARG,MF,Rayo Vallecano,33.0,1988.0,22.3,42,24,14,18,10,15,50,30.0,35,26,1,25,13,55,11,0,Matches,2021-2022,La-Liga
Manu Trigueros,es ESP,"MF,FW",Villarreal,29.0,1991.0,24.2,45,25,16,18,11,23,66,34.8,43,19,3,16,13,58,17,0,Matches,2021-2022,La-Liga
Kieran Trippier,eng ENG,"DF,FW",Atlético Madrid,30.0,1990.0,10.8,22,12,12,5,5,12,21,57.1,9,12,1,11,10,32,11,0,Matches,2021-2022,La-Liga
Beñat Turrientes,es ESP,MF,Real Sociedad,19.0,2002.0,2.3,0,0,0,0,0,0,4,0.0,4,1,0,1,2,2,2,0,Matches,2021-2022,La-Liga
Samuel Umtiti,fr FRA,DF,Barcelona,27.0,1993.0,1.0,2,2,2,0,0,1,2,50.0,1,1,1,0,0,2,4,0,Matches,2021-2022,La-Liga
Enes Ünal,tr TUR,FW,Getafe,24.0,1997.0,31.1,37,22,2,18,17,5,42,11.9,37,25,5,20,5,42,36,0,Matches,2021-2022,La-Liga
Myrto Uzuni,al ALB,"FW,MF",Granada,26.0,1995.0,9.5,7,4,6,1,0,0,2,0.0,2,13,1,12,10,17,7,0,Matches,2021-2022,La-Liga
Álvaro Vadillo,es ESP,"DF,MF",Espanyol,26.0,1994.0,0.1,1,1,1,0,0,1,2,50.0,1,0,0,0,0,1,1,0,Matches,2021-2022,La-Liga
Óscar Valentín,es ESP,MF,Rayo Vallecano,26.0,1994.0,28.5,102,53,46,51,5,44,105,41.9,61,56,10,46,39,141,43,0,Matches,2021-2022,La-Liga
Germán Valera,es ESP,FW,Real Sociedad,19.0,2002.0,0.6,3,2,3,0,0,1,1,100.0,0,0,0,0,0,3,1,0,Matches,2021-2022,La-Liga
Martin Valjent,sk SVK,DF,Mallorca,25.0,1995.0,35.3,31,19,18,12,1,13,24,54.2,11,34,26,8,31,62,173,1,Matches,2021-2022,La-Liga
Jesús Vallejo,es ESP,DF,Real Madrid,24.0,1997.0,3.8,7,5,7,0,0,5,6,83.3,1,9,8,1,6,13,16,0,Matches,2021-2022,La-Liga
Manu Vallejo,es ESP,"MF,FW",Alavés,24.0,1997.0,4.1,8,2,1,4,3,4,13,30.8,9,7,0,7,0,8,4,0,Matches,2021-2022,La-Liga
Manu Vallejo,es ESP,"FW,MF",Valencia,24.0,1997.0,1.1,2,1,1,1,0,0,1,0.0,1,0,0,0,0,2,1,0,Matches,2021-2022,La-Liga
Federico Valverde,uy URU,MF,Real Madrid,23.0,1998.0,20.4,36,16,11,16,9,12,31,38.7,19,23,5,18,24,60,12,0,Matches,2021-2022,La-Liga
José Luis García Vayá,es ESP,MF,Levante,22.0,1998.0,22.4,46,27,10,31,5,16,41,39.0,25,24,5,19,38,84,30,0,Matches,2021-2022,La-Liga
Jesus Vazquez,es ESP,DF,Valencia,18.0,2003.0,9.0,24,13,10,8,6,10,22,45.5,12,16,3,13,9,33,19,0,Matches,2021-2022,La-Liga
Kevin Vázquez,es ESP,DF,Celta Vigo,28.0,1993.0,14.8,34,24,12,13,9,14,28,50.0,14,20,7,13,36,70,34,0,Matches,2021-2022,La-Liga
Lucas Vázquez,es ESP,DF,Real Madrid,30.0,1991.0,20.4,43,22,24,9,10,17,35,48.6,18,25,7,18,20,63,41,1,Matches,2021-2022,La-Liga
Gabriel Veiga,es ESP,MF,Celta Vigo,19.0,2002.0,1.2,5,4,0,4,1,3,12,25.0,9,2,0,2,4,9,1,0,Matches,2021-2022,La-Liga
Unai Vencedor Paris,es ESP,MF,Athletic Club,20.0,2000.0,26.5,26,11,11,9,6,8,42,19.0,34,31,13,18,19,45,22,0,Matches,2021-2022,La-Liga
Gonzalo Verdú,es ESP,DF,Elche,32.0,1988.0,15.5,19,9,15,4,0,8,16,50.0,8,20,14,6,13,32,59,1,Matches,2021-2022,La-Liga
Mikel Vesga,es ESP,MF,Athletic Club,28.0,1993.0,15.1,27,14,7,18,2,11,31,35.5,20,16,5,11,20,47,34,2,Matches,2021-2022,La-Liga
Rúben Vezo,pt POR,DF,Levante,27.0,1994.0,26.9,41,29,28,12,1,26,41,63.4,15,41,25,16,36,77,105,1,Matches,2021-2022,La-Liga
Aleix Vidal,es ESP,"DF,MF",Espanyol,31.0,1989.0,21.1,31,25,17,9,5,19,39,48.7,20,19,6,13,25,56,35,2,Matches,2021-2022,La-Liga
Nacho Vidal,es ESP,DF,Osasuna,26.0,1995.0,32.2,83,47,49,25,9,39,77,50.6,38,32,14,18,58,141,79,0,Matches,2021-2022,La-Liga
Dídac Vilà,es ESP,"DF,MF",Espanyol,32.0,1989.0,2.3,7,5,2,5,0,4,9,44.4,5,2,1,1,3,10,8,0,Matches,2021-2022,La-Liga
Tonny Vilhena,nl NED,"MF,FW",Espanyol,26.0,1995.0,10.3,16,6,7,8,1,7,21,33.3,14,10,2,8,8,24,17,0,Matches,2021-2022,La-Liga
Daniel Villahermosa,es ESP,MF,Espanyol,20.0,2001.0,0.3,0,0,0,0,0,0,0,,0,0,0,0,0,0,1,0,Matches,2021-2022,La-Liga
Asier Villalibre,es ESP,FW,Athletic Club,23.0,1997.0,6.1,4,3,2,1,1,1,2,50.0,1,3,1,2,1,5,7,0,Matches,2021-2022,La-Liga
Gonzalo Villar,es ESP,MF,Getafe,23.0,1998.0,3.3,5,3,4,1,0,2,5,40.0,3,4,1,3,1,6,1,0,Matches,2021-2022,La-Liga
Vitolo,es ESP,MF,Getafe,31.0,1989.0,2.5,3,2,1,1,1,2,5,40.0,3,3,0,3,1,4,1,0,Matches,2021-2022,La-Liga
Daniel Vivian,es ESP,DF,Athletic Club,22.0,1999.0,22.1,32,21,24,7,1,17,24,70.8,7,20,15,5,26,58,107,1,Matches,2021-2022,La-Liga
Šime Vrsaljko,hr CRO,DF,Atlético Madrid,29.0,1992.0,10.2,27,17,14,12,1,12,20,60.0,8,10,1,9,12,39,30,0,Matches,2021-2022,La-Liga
Nikola Vukčević,me MNE,MF,Levante,29.0,1991.0,1.3,3,2,2,1,0,0,1,0.0,1,2,0,2,2,5,1,0,Matches,2021-2022,La-Liga
Daniel Wass,dk DEN,"DF,FW",Atlético Madrid,32.0,1989.0,0.5,0,0,0,0,0,0,0,,0,0,0,0,0,0,3,0,Matches,2021-2022,La-Liga
Daniel Wass,dk DEN,MF,Valencia,32.0,1989.0,17.6,23,13,6,14,3,8,31,25.8,23,13,2,11,13,36,19,0,Matches,2021-2022,La-Liga
Iñaki Williams,gh GHA,FW,Athletic Club,27.0,1994.0,30.9,14,5,1,6,7,5,17,29.4,12,18,3,15,3,17,20,0,Matches,2021-2022,La-Liga
Nico Williams,es ESP,MF,Athletic Club,19.0,2002.0,14.9,20,10,6,11,3,10,31,32.3,21,18,2,16,5,25,9,0,Matches,2021-2022,La-Liga
Okay Yokuşlu,tr TUR,"DF,MF",Getafe,27.0,1994.0,5.2,9,8,6,2,1,5,5,100.0,0,7,5,2,5,14,17,0,Matches,2021-2022,La-Liga
Okay Yokuşlu,tr TUR,"DF,MF",Celta Vigo,27.0,1994.0,1.6,4,1,2,1,1,2,3,66.7,1,2,1,1,2,6,6,0,Matches,2021-2022,La-Liga
Joseba Zaldúa,es ESP,DF,Real Sociedad,29.0,1992.0,13.0,31,22,20,8,3,16,22,72.7,6,14,4,10,13,44,35,0,Matches,2021-2022,La-Liga
Oier Zarraga,es ESP,MF,Athletic Club,22.0,1999.0,13.0,13,5,4,7,2,3,28,10.7,25,17,10,7,19,32,10,0,Matches,2021-2022,La-Liga
Luca Zidane,fr FRA,GK,Rayo Vallecano,23.0,1998.0,7.2,0,0,0,0,0,0,1,0.0,1,0,0,0,0,0,1,1,Matches,2021-2022,La-Liga
Igor Zubeldia,es ESP,DF,Real Sociedad,24.0,1997.0,18.3,20,10,12,8,0,12,18,66.7,6,16,6,10,27,47,53,0,Matches,2021-2022,La-Liga
Martín Zubimendi,es ESP,MF,Real Sociedad,22.0,1999.0,28.8,52,25,19,30,3,22,44,50.0,22,30,13,17,49,101,48,1,Matches,2021-2022,La-Liga
Abner,br BRA,DF,Betis,22.0,2000.0,6.7,12,9,9,2,1,7,16,43.8,9,8,2,6,8,20,24,0,Matches,2022-2023,La-Liga
Álvaro Aceves,es ESP,GK,Valladolid,19.0,2003.0,0.1,0,0,0,0,0,0,0,,0,0,0,0,0,0,0,0,Matches,2022-2023,La-Liga
Marcos Acuña,ar ARG,DF,Sevilla,30.0,1991.0,21.2,57,36,34,17,6,30,42,71.4,12,16,5,11,23,80,36,0,Matches,2022-2023,La-Liga
Julen Agirrezabala,es ESP,GK,Athletic Club,21.0,2000.0,7.5,0,0,0,0,0,0,0,,0,0,0,0,0,0,2,0,Matches,2022-2023,La-Liga
Álvaro Aguado,es ESP,MF,Valladolid,26.0,1996.0,21.0,27,15,13,11,3,15,25,60.0,10,16,4,12,13,40,15,0,Matches,2022-2023,La-Liga
Joseph Aidoo,gh GHA,DF,Celta Vigo,26.0,1995.0,34.7,51,36,33,17,1,16,28,57.1,12,26,14,12,31,82,150,0,Matches,2022-2023,La-Liga
Sergio Akieme,es ESP,DF,Almería,24.0,1997.0,25.5,27,16,19,6,2,12,22,54.5,10,22,6,16,14,41,41,0,Matches,2022-2023,La-Liga
Babatunde Akinsola,ng NGA,FW,Valladolid,19.0,2003.0,0.1,1,1,0,0,1,0,0,,0,0,0,0,0,1,0,0,Matches,2022-2023,La-Liga
Paul Akouokou,ci CIV,"MF,DF",Betis,24.0,1997.0,5.0,16,9,13,3,0,13,20,65.0,7,2,2,0,12,28,17,1,Matches,2022-2023,La-Liga
David Alaba,at AUT,DF,Real Madrid,30.0,1992.0,20.4,15,11,8,4,3,9,15,60.0,6,18,9,9,14,29,37,1,Matches,2022-2023,La-Liga
Ángel Alarcón,es ESP,"FW,MF",Barcelona,18.0,2004.0,0.3,0,0,0,0,0,0,2,0.0,2,0,0,0,0,0,0,0,Matches,2022-2023,La-Liga
Tomás Alarcón,cl CHI,MF,Cádiz,23.0,1999.0,2.5,3,2,0,2,1,1,2,50.0,1,1,0,1,2,5,2,0,Matches,2022-2023,La-Liga
Jordi Alba,es ESP,DF,Barcelona,33.0,1989.0,15.8,25,18,13,11,1,12,28,42.9,16,12,5,7,11,36,23,0,Matches,2022-2023,La-Liga
Raúl Albiol,es ESP,DF,Villarreal,36.0,1985.0,23.5,25,17,17,6,2,14,18,77.8,4,17,13,4,14,39,111,0,Matches,2022-2023,La-Liga
Rubén Alcaraz,es ESP,MF,Cádiz,31.0,1991.0,22.7,43,31,24,18,1,19,54,35.2,35,23,8,15,19,62,37,0,Matches,2022-2023,La-Liga
Omar Alderete,py PAR,DF,Getafe,25.0,1996.0,22.7,35,20,21,14,0,28,40,70.0,12,23,16,7,26,61,85,0,Matches,2022-2023,La-Liga
Iván Alejo,es ESP,"MF,FW",Cádiz,27.0,1995.0,14.6,32,21,19,9,4,17,37,45.9,20,18,3,15,5,37,12,1,Matches,2022-2023,La-Liga
Carles Aleñá,es ESP,"MF,FW",Getafe,24.0,1998.0,23.5,18,10,7,5,6,5,34,14.7,29,19,1,18,4,22,18,0,Matches,2022-2023,La-Liga
Alejandro Alfaro,es ESP,MF,Elche,20.0,2002.0,0.2,0,0,0,0,0,0,0,,0,0,0,0,0,0,0,0,Matches,2022-2023,La-Liga
Ángel Algobia,es ESP,MF,Getafe,23.0,1999.0,12.6,27,13,14,13,0,22,48,45.8,26,15,5,10,3,30,11,0,Matches,2022-2023,La-Liga
Mohamed Ali Cho,fr FRA,"FW,MF",Real Sociedad,18.0,2004.0,6.5,13,10,6,5,2,4,10,40.0,6,9,0,9,2,15,2,0,Matches,2022-2023,La-Liga
Domingos André Ribeiro Almeida,pt POR,MF,Valencia,22.0,2000.0,28.2,66,42,23,32,11,26,57,45.6,31,26,0,26,20,86,16,1,Matches,2022-2023,La-Liga
Marcos Alonso,es ESP,DF,Barcelona,31.0,1990.0,13.0,15,10,10,5,0,9,12,75.0,3,14,10,4,11,26,32,0,Matches,2022-2023,La-Liga
Carlos Álvarez,es ESP,MF,Sevilla,18.0,2003.0,0.1,1,1,0,1,0,0,0,,0,0,0,0,0,1,0,0,Matches,2022-2023,La-Liga
Gastón Álvarez,uy URU,DF,Getafe,22.0,2000.0,16.7,38,30,24,9,5,23,42,54.8,19,15,5,10,15,53,35,0,Matches,2022-2023,La-Liga
Yeray Álvarez,es ESP,DF,Athletic Club,27.0,1995.0,25.9,34,23,26,7,1,24,31,77.4,7,23,13,10,48,82,101,0,Matches,2022-2023,La-Liga
Selim Amallah,ma MAR,"MF,FW",Valladolid,25.0,1996.0,3.0,15,9,7,8,0,5,8,62.5,3,2,0,2,5,20,2,0,Matches,2022-2023,La-Liga
Amath,sn SEN,"MF,FW",Mallorca,26.0,1996.0,13.6,29,19,14,8,7,14,22,63.6,8,13,1,12,5,34,5,0,Matches,2022-2023,La-Liga
Jordan Amavi,fr FRA,DF,Getafe,28.0,1994.0,2.2,3,2,3,0,0,1,3,33.3,2,3,0,3,4,7,7,0,Matches,2022-2023,La-Liga
Marcos André,br BRA,"FW,MF",Valencia,25.0,1996.0,5.0,4,1,1,1,2,1,2,50.0,1,4,1,3,0,4,0,0,Matches,2022-2023,La-Liga
Fabrizio Angileri,ar ARG,DF,Getafe,28.0,1994.0,6.5,12,9,8,3,1,10,17,58.8,7,8,3,5,7,19,10,0,Matches,2022-2023,La-Liga
Josep Antoni Gayá,es ESP,"DF,MF",Mallorca,22.0,2000.0,1.1,0,0,0,0,0,0,0,,0,4,2,2,1,1,6,0,Matches,2022-2023,La-Liga
José Antonio,es ESP,"MF,DF",Cádiz,18.0,2004.0,0.5,2,1,0,0,2,0,0,,0,0,0,0,0,2,0,0,Matches,2022-2023,La-Liga
Anuar,ma MAR,"MF,FW",Valladolid,27.0,1995.0,2.3,4,4,0,1,3,0,0,,0,5,2,3,3,7,3,0,Matches,2022-2023,La-Liga
Mauro Arambarri,uy URU,MF,Getafe,26.0,1995.0,11.0,14,6,9,4,1,3,17,17.6,14,17,5,12,14,28,19,0,Matches,2022-2023,La-Liga
Ronald Araújo,uy URU,DF,Barcelona,23.0,1999.0,20.0,26,18,12,13,1,6,9,66.7,3,15,7,8,12,38,41,1,Matches,2022-2023,La-Liga
Adu Ares,es ESP,"FW,MF",Athletic Club,20.0,2001.0,0.9,4,2,2,1,1,4,4,100.0,0,1,0,1,2,6,1,0,Matches,2022-2023,La-Liga
Sergio Arribas,es ESP,"MF,FW",Real Madrid,20.0,2001.0,0.2,0,0,0,0,0,0,0,,0,1,0,1,0,0,0,0,Matches,2022-2023,La-Liga
Roberto Arroyo,es ESP,MF,Valladolid,18.0,2003.0,0.2,1,1,0,1,0,1,1,100.0,0,0,0,0,0,1,0,0,Matches,2022-2023,La-Liga
Ricard Artero,es ESP,"MF,FW",Girona,19.0,2003.0,1.5,3,3,2,1,0,1,1,100.0,0,2,0,2,1,4,3,0,Matches,2022-2023,La-Liga
Santiago Arzamendia,py PAR,"DF,MF",Cádiz,24.0,1998.0,5.4,9,8,7,1,1,6,21,28.6,15,11,1,10,2,11,15,1,Matches,2022-2023,La-Liga
Sergio Asenjo,es ESP,GK,Valladolid,33.0,1989.0,10.0,0,0,0,0,0,0,0,,0,0,0,0,0,0,10,2,Matches,2022-2023,La-Liga
Marco Asensio,es ESP,"FW,MF",Real Madrid,26.0,1996.0,16.0,16,10,8,6,2,8,19,42.1,11,8,3,5,5,21,4,0,Matches,2022-2023,La-Liga
Iago Aspas,es ESP,FW,Celta Vigo,34.0,1987.0,31.9,8,4,0,4,4,3,22,13.6,19,10,1,9,7,15,23,0,Matches,2022-2023,La-Liga
Pierre-Emerick Aubameyang,ga GAB,FW,Barcelona,33.0,1989.0,0.1,0,0,0,0,0,0,0,,0,0,0,0,0,0,0,0,Matches,2022-2023,La-Liga
Ludwig Augustinsson,se SWE,DF,Mallorca,28.0,1994.0,1.5,2,1,2,0,0,1,3,33.3,2,1,0,1,1,3,3,0,Matches,2022-2023,La-Liga
Ezequiel Ávila,ar ARG,"FW,MF",Osasuna,28.0,1994.0,19.0,8,5,2,4,2,6,23,26.1,17,12,1,11,8,16,16,0,Matches,2022-2023,La-Liga
Iddrisu Baba,gh GHA,"MF,DF",Mallorca,26.0,1996.0,18.9,31,17,15,16,0,15,32,46.9,17,18,8,10,11,42,39,0,Matches,2022-2023,La-Liga
Srđan Babić,rs SRB,DF,Almería,26.0,1996.0,33.3,28,18,20,8,0,15,32,46.9,17,34,22,12,29,57,124,1,Matches,2022-2023,La-Liga
Loïc Bade,fr FRA,DF,Sevilla,22.0,2000.0,16.1,27,20,23,3,1,17,30,56.7,13,21,13,8,23,50,77,0,Matches,2022-2023,La-Liga
Édgar Badía,es ESP,GK,Elche,30.0,1992.0,36.0,1,0,1,0,0,1,2,50.0,1,0,0,0,0,1,19,3,Matches,2022-2023,La-Liga
Alex Baena,es ESP,"MF,FW",Villarreal,21.0,2001.0,21.6,30,17,9,15,6,15,45,33.3,30,15,3,12,7,37,16,0,Matches,2022-2023,La-Liga
Alejandro Balde,es ESP,DF,Barcelona,18.0,2003.0,27.5,42,30,22,16,4,24,41,58.5,17,25,3,22,12,54,17,1,Matches,2022-2023,La-Liga
Mikel Balenziaga,es ESP,DF,Athletic Club,34.0,1988.0,1.3,4,4,1,2,1,4,4,100.0,0,0,0,0,1,5,2,0,Matches,2022-2023,La-Liga
Iván Balliu,al ALB,DF,Rayo Vallecano,30.0,1992.0,35.9,52,29,26,20,6,18,30,60.0,12,26,3,23,25,77,72,1,Matches,2022-2023,La-Liga
Léo Baptistão,br BRA,"FW,MF",Almería,29.0,1992.0,19.2,32,20,13,16,3,13,33,39.4,20,17,2,15,19,51,12,0,Matches,2022-2023,La-Liga
Keidi Bare,al ALB,MF,Espanyol,24.0,1997.0,5.6,15,8,7,5,3,7,13,53.8,6,8,2,6,11,26,8,0,Matches,2022-2023,La-Liga
Kike Barja,es ESP,"FW,MF",Osasuna,25.0,1997.0,14.6,15,9,6,5,4,8,24,33.3,16,7,0,7,4,19,3,0,Matches,2022-2023,La-Liga
Ander Barrenetxea,es ESP,"FW,DF",Real Sociedad,20.0,2001.0,9.8,21,15,15,6,0,12,28,42.9,16,15,1,14,5,26,7,0,Matches,2022-2023,La-Liga
Pablo Barrios,es ESP,MF,Atlético Madrid,19.0,2003.0,8.0,19,10,3,10,6,8,15,53.3,7,12,2,10,9,28,6,1,Matches,2022-2023,La-Liga
Rodrigo Battaglia,ar ARG,MF,Mallorca,31.0,1991.0,7.6,12,5,7,5,0,6,14,42.9,8,16,7,9,5,17,18,0,Matches,2022-2023,La-Liga
Bebé,cv CPV,FW,Rayo Vallecano,32.0,1990.0,0.7,0,0,0,0,0,0,2,0.0,2,1,0,1,0,0,0,0,Matches,2022-2023,La-Liga
Héctor Bellerín,es ESP,DF,Barcelona,27.0,1995.0,1.6,2,0,0,2,0,2,3,66.7,1,2,0,2,3,5,2,0,Matches,2022-2023,La-Liga
Fran Beltrán,es ESP,MF,Celta Vigo,23.0,1999.0,31.7,34,22,15,14,5,14,55,25.5,41,29,5,24,53,87,35,2,Matches,2022-2023,La-Liga
Iker Benito,es ESP,"FW,MF",Osasuna,19.0,2002.0,2.0,4,3,0,3,1,2,4,50.0,2,0,0,0,2,6,4,0,Matches,2022-2023,La-Liga
Karim Benzema,fr FRA,FW,Real Madrid,34.0,1987.0,22.6,9,5,2,4,3,2,11,18.2,9,11,0,11,2,11,5,0,Matches,2022-2023,La-Liga
Yuri Berchiche,es ESP,DF,Athletic Club,32.0,1990.0,26.7,56,32,28,20,8,35,59,59.3,24,37,12,25,40,96,59,1,Matches,2022-2023,La-Liga
Álex Berenguer,es ESP,FW,Athletic Club,27.0,1995.0,25.5,58,37,17,25,16,23,60,38.3,37,37,4,33,10,68,6,0,Matches,2022-2023,La-Liga
Pedro Bigas,es ESP,DF,Elche,31.0,1990.0,22.4,37,20,30,7,0,18,29,62.1,11,25,14,11,33,70,95,0,Matches,2022-2023,La-Liga
El Bilal Touré,ml MLI,FW,Almería,20.0,2001.0,14.0,4,3,2,1,1,0,3,0.0,3,6,1,5,1,5,23,0,Matches,2022-2023,La-Liga
Antonio Blanco,es ESP,MF,Cádiz,22.0,2000.0,1.8,6,4,5,1,0,4,6,66.7,2,5,0,5,1,7,3,0,Matches,2022-2023,La-Liga
Lautaro Blanco,ar ARG,"DF,MF",Elche,23.0,1999.0,9.7,16,9,10,4,2,9,26,34.6,17,8,1,7,2,18,10,1,Matches,2022-2023,La-Liga
Theo Bongonda,cd COD,"MF,FW",Cádiz,26.0,1995.0,21.5,28,20,11,14,3,17,40,42.5,23,21,2,19,6,34,14,0,Matches,2022-2023,La-Liga
Yassine Bounou,ma MAR,GK,Sevilla,31.0,1991.0,23.9,2,1,2,0,0,1,4,25.0,3,0,0,0,2,4,11,1,Matches,2022-2023,La-Liga
Lucas Boyé,ar ARG,FW,Elche,26.0,1996.0,27.4,36,16,12,16,8,17,35,48.6,18,33,5,28,15,51,46,0,Matches,2022-2023,La-Liga
Martin Braithwaite,dk DEN,"FW,MF",Espanyol,31.0,1991.0,27.3,12,2,2,4,6,5,14,35.7,9,10,0,10,5,17,11,0,Matches,2022-2023,La-Liga
Darko Brašanac,rs SRB,MF,Osasuna,30.0,1992.0,11.6,29,20,12,10,7,12,23,52.2,11,14,2,12,12,41,9,0,Matches,2022-2023,La-Liga
Claudio Bravo,cl CHI,GK,Betis,39.0,1983.0,12.0,0,0,0,0,0,0,0,,0,0,0,0,2,2,1,1,Matches,2022-2023,La-Liga
Ante Budimir,hr CRO,FW,Osasuna,31.0,1991.0,20.0,19,9,0,12,7,2,10,20.0,8,10,0,10,5,24,19,0,Matches,2022-2023,La-Liga
Manu Bueno,es ESP,MF,Sevilla,18.0,2004.0,1.7,7,4,3,3,1,5,8,62.5,3,0,0,0,0,7,2,0,Matches,2022-2023,La-Liga
Santiago Bueno,uy URU,DF,Girona,23.0,1998.0,33.4,63,38,43,19,1,24,36,66.7,12,34,22,12,31,94,105,2,Matches,2022-2023,La-Liga
Sergio Busquets,es ESP,MF,Barcelona,34.0,1988.0,26.0,58,26,24,26,8,29,51,56.9,22,32,6,26,27,85,36,2,Matches,2022-2023,La-Liga
Leandro Cabrera,uy URU,DF,Espanyol,31.0,1991.0,29.7,46,24,34,12,0,28,43,65.1,15,37,23,14,43,89,114,2,Matches,2022-2023,La-Liga
Cala,es ESP,DF,Cádiz,32.0,1989.0,1.5,2,1,1,1,0,1,2,50.0,1,2,1,1,1,3,12,0,Matches,2022-2023,La-Liga
Fernando Calero,es ESP,"DF,MF",Espanyol,26.0,1995.0,17.9,46,29,27,15,4,21,34,61.8,13,31,13,18,13,59,52,0,Matches,2022-2023,La-Liga
Alexander Callens,pe PER,DF,Girona,30.0,1992.0,1.3,3,3,2,1,0,3,4,75.0,1,3,1,2,1,4,9,0,Matches,2022-2023,La-Liga
Eduardo Camavinga,fr FRA,"MF,DF",Real Madrid,19.0,2002.0,22.3,68,48,32,21,15,24,64,37.5,40,24,5,19,17,85,25,0,Matches,2022-2023,La-Liga
Sergio Camello,es ESP,FW,Rayo Vallecano,21.0,2001.0,26.7,16,10,3,9,4,5,17,29.4,12,9,1,8,2,18,26,0,Matches,2022-2023,La-Liga
Sergio Canales,es ESP,"FW,MF",Betis,31.0,1991.0,26.7,25,14,10,8,7,14,33,42.4,19,18,0,18,14,39,8,0,Matches,2022-2023,La-Liga
Ander Capa,es ESP,DF,Athletic Club,30.0,1992.0,1.2,1,1,1,0,0,1,5,20.0,4,5,0,5,0,1,2,0,Matches,2022-2023,La-Liga
Étienne Capoue,fr FRA,MF,Villarreal,34.0,1988.0,21.7,21,12,6,13,2,10,18,55.6,8,12,5,7,19,40,20,1,Matches,2022-2023,La-Liga
Isaac Carcelen,es ESP,DF,Cádiz,29.0,1993.0,24.4,69,51,41,22,6,41,63,65.1,22,35,11,24,19,88,80,1,Matches,2022-2023,La-Liga
Juan Carlos,es ESP,GK,Girona,34.0,1988.0,10.0,0,0,0,0,0,0,0,,0,0,0,0,1,1,7,1,Matches,2022-2023,La-Liga
José Carlos Lazo,es ESP,"MF,FW",Almería,26.0,1996.0,0.2,0,0,0,0,0,0,0,,0,0,0,0,0,0,0,0,Matches,2022-2023,La-Liga
José Carlos Lazo,es ESP,"MF,FW",Espanyol,26.0,1996.0,1.8,5,3,2,2,1,3,3,100.0,0,2,0,2,3,8,5,0,Matches,2022-2023,La-Liga
Carmona,es ESP,"MF,DF",Elche,20.0,2002.0,6.5,16,9,7,6,3,6,16,37.5,10,14,2,12,8,24,9,0,Matches,2022-2023,La-Liga
Carmona,es ESP,DF,Sevilla,20.0,2002.0,5.9,13,11,5,3,5,9,16,56.3,7,10,6,4,7,20,17,1,Matches,2022-2023,La-Liga
Yannick Carrasco,be BEL,"DF,MF",Atlético Madrid,28.0,1993.0,25.7,35,14,21,10,4,23,54,42.6,31,23,1,22,12,47,19,0,Matches,2022-2023,La-Liga
Dani Carvajal,es ESP,DF,Real Madrid,30.0,1992.0,19.8,32,18,15,12,5,18,35,51.4,17,24,6,18,15,47,49,0,Matches,2022-2023,La-Liga
William Carvalho,pt POR,MF,Betis,30.0,1992.0,27.1,43,27,18,23,2,17,44,38.6,27,27,6,21,16,59,22,0,Matches,2022-2023,La-Liga
Casemiro,br BRA,MF,Real Madrid,30.0,1992.0,0.1,0,0,0,0,0,0,0,,0,0,0,0,0,0,1,0,Matches,2022-2023,La-Liga
Valentín Castellanos,ar ARG,FW,Girona,23.0,1998.0,28.9,12,5,2,7,3,0,18,0.0,18,22,2,20,6,18,26,0,Matches,2022-2023,La-Liga
Samu Castillejo,es ESP,"FW,MF",Valencia,27.0,1995.0,15.1,21,12,8,9,4,8,40,20.0,32,21,2,19,9,30,2,0,Matches,2022-2023,La-Liga
Catena,es ESP,DF,Rayo Vallecano,27.0,1994.0,34.5,29,14,23,4,2,13,27,48.1,14,32,25,7,28,57,159,1,Matches,2022-2023,La-Liga
Edinson Cavani,uy URU,FW,Valencia,35.0,1987.0,16.1,7,4,3,3,1,3,15,20.0,12,10,3,7,2,9,11,0,Matches,2022-2023,La-Liga
Dani Ceballos,es ESP,MF,Real Madrid,25.0,1996.0,17.4,43,29,13,15,15,25,64,39.1,39,23,2,21,25,68,6,1,Matches,2022-2023,La-Liga
Álex Centelles,es ESP,DF,Almería,24.0,1997.0,12.5,22,14,16,3,3,16,22,72.7,6,13,2,11,11,33,40,0,Matches,2022-2023,La-Liga
Franco Cervi,ar ARG,"MF,DF",Celta Vigo,28.0,1994.0,21.0,76,46,29,36,11,33,66,50.0,33,33,1,32,36,112,16,0,Matches,2022-2023,La-Liga
Pep Chavarría,es ESP,"FW,MF",Rayo Vallecano,24.0,1998.0,4.1,6,4,2,1,3,1,5,20.0,4,8,0,8,2,8,8,0,Matches,2022-2023,La-Liga
Pape Cheikh Diop,sn SEN,MF,Elche,24.0,1997.0,0.4,0,0,0,0,0,0,1,0.0,1,0,0,0,0,0,0,0,Matches,2022-2023,La-Liga
Andreas Christensen,dk DEN,DF,Barcelona,26.0,1996.0,19.6,20,15,9,11,0,10,16,62.5,6,14,12,2,21,41,47,0,Matches,2022-2023,La-Liga
Samuel Chukwueze,ng NGA,"FW,MF",Villarreal,23.0,1999.0,26.0,14,7,7,2,5,7,23,30.4,16,13,0,13,12,26,16,0,Matches,2022-2023,La-Liga
Chumi,es ESP,DF,Almería,23.0,1999.0,16.5,29,16,18,9,2,14,23,60.9,9,20,7,13,15,44,53,0,Matches,2022-2023,La-Liga
Víctor Chust,es ESP,DF,Cádiz,22.0,2000.0,10.7,9,6,7,2,0,4,7,57.1,3,8,3,5,10,19,53,0,Matches,2022-2023,La-Liga
Pathé Ciss,sn SEN,"MF,DF",Rayo Vallecano,28.0,1994.0,14.2,39,29,11,23,5,15,34,44.1,19,23,10,13,22,61,34,0,Matches,2022-2023,La-Liga
Carlos Clerc,es ESP,"DF,MF",Elche,30.0,1992.0,29.3,75,51,55,16,4,31,50,62.0,19,29,7,22,28,103,94,1,Matches,2022-2023,La-Liga
Álex Collado,es ESP,MF,Elche,23.0,1999.0,8.0,26,14,13,11,2,8,13,61.5,5,12,1,11,2,28,4,0,Matches,2022-2023,La-Liga
Diego Collado,es ESP,FW,Villarreal,21.0,2001.0,0.1,0,0,0,0,0,0,0,,0,0,0,0,0,0,0,0,Matches,2022-2023,La-Liga
Eray Cömert,ch SUI,DF,Valencia,24.0,1998.0,18.6,35,23,24,10,1,17,33,51.5,16,23,8,15,29,64,76,1,Matches,2022-2023,La-Liga
Santi Comesaña,es ESP,MF,Rayo Vallecano,25.0,1996.0,27.2,71,44,24,41,6,38,82,46.3,44,39,3,36,32,103,17,0,Matches,2022-2023,La-Liga
Copete,es ESP,DF,Mallorca,22.0,1999.0,24.5,53,28,35,16,2,26,36,72.2,10,38,17,21,44,97,111,2,Matches,2022-2023,La-Liga
Francis Coquelin,fr FRA,MF,Villarreal,31.0,1991.0,8.3,18,13,7,9,2,7,7,100.0,0,8,2,6,9,27,7,0,Matches,2022-2023,La-Liga
Jesús Corona,mx MEX,FW,Sevilla,29.0,1993.0,1.2,1,0,1,0,0,0,1,0.0,1,0,0,0,1,2,1,0,Matches,2022-2023,La-Liga
Ángel Correa,ar ARG,"FW,MF",Atlético Madrid,27.0,1995.0,16.2,12,6,6,3,3,5,16,31.3,11,17,0,17,10,22,6,1,Matches,2022-2023,La-Liga
Thierry Correia,pt POR,DF,Valencia,23.0,1999.0,22.3,71,52,46,22,3,31,54,57.4,23,25,2,23,24,95,54,2,Matches,2022-2023,La-Liga
Jaume Costa,es ESP,DF,Mallorca,34.0,1988.0,28.9,50,34,26,17,7,29,51,56.9,22,13,5,8,22,72,44,1,Matches,2022-2023,La-Liga
Samu Costa,pt POR,MF,Almería,21.0,2000.0,22.1,61,31,35,20,6,29,61,47.5,32,29,7,22,37,98,64,4,Matches,2022-2023,La-Liga
Thibaut Courtois,be BEL,GK,Real Madrid,30.0,1992.0,31.0,1,0,1,0,0,1,1,100.0,0,0,0,0,3,4,7,1,Matches,2022-2023,La-Liga
Yan Couto,br BRA,"DF,MF",Girona,20.0,2002.0,12.9,25,18,11,11,3,12,20,60.0,8,7,2,5,5,30,10,0,Matches,2022-2023,La-Liga
Juan Cruz Armada,es ESP,DF,Osasuna,30.0,1992.0,22.9,24,14,17,4,3,13,23,56.5,10,21,8,13,13,37,58,0,Matches,2022-2023,La-Liga
Juan Cruz,es ESP,FW,Betis,22.0,2000.0,2.0,1,0,0,1,0,1,3,33.3,2,1,0,1,0,1,0,0,Matches,2022-2023,La-Liga
Jorge Cuenca,es ESP,DF,Villarreal,22.0,1999.0,5.6,9,7,7,2,0,4,7,57.1,3,10,8,2,6,15,44,0,Matches,2022-2023,La-Liga
Braian Cufré,ar ARG,DF,Mallorca,25.0,1996.0,2.4,5,2,2,1,2,2,5,40.0,3,2,1,1,2,7,1,0,Matches,2022-2023,La-Liga
Matheus Cunha,br BRA,"FW,MF",Atlético Madrid,23.0,1999.0,4.2,4,1,1,3,0,0,3,0.0,3,4,1,3,2,6,3,0,Matches,2022-2023,La-Liga
Curro,es ESP,MF,Almería,26.0,1996.0,0.5,2,0,1,1,0,1,2,50.0,1,0,0,0,0,2,0,0,Matches,2022-2023,La-Liga
Arnaut Danjuma,nl NED,FW,Villarreal,25.0,1997.0,5.3,3,3,1,0,2,1,2,50.0,1,0,0,0,0,3,1,1,Matches,2022-2023,La-Liga
Sergi Darder,es ESP,MF,Espanyol,28.0,1993.0,36.9,69,38,12,43,14,29,73,39.7,44,34,2,32,24,93,23,0,Matches,2022-2023,La-Liga
Rodrigo De Paul,ar ARG,MF,Atlético Madrid,28.0,1994.0,21.4,35,21,11,18,6,18,35,51.4,17,20,3,17,8,43,7,0,Matches,2022-2023,La-Liga
Alberto Del Moral,es ESP,MF,Villarreal,22.0,2000.0,0.1,0,0,0,0,0,0,0,,0,0,0,0,0,0,0,0,Matches,2022-2023,La-Liga
Thomas Delaney,dk DEN,MF,Sevilla,30.0,1991.0,3.4,4,2,0,4,0,3,5,60.0,2,3,2,1,4,8,3,0,Matches,2022-2023,La-Liga
Fran Delgado,es ESP,DF,Betis,21.0,2001.0,0.1,0,0,0,0,0,0,0,,0,0,0,0,0,0,0,0,Matches,2022-2023,La-Liga
Ousmane Dembélé,fr FRA,FW,Barcelona,25.0,1997.0,15.7,19,12,4,8,7,4,15,26.7,11,10,1,9,0,19,2,0,Matches,2022-2023,La-Liga
Mouctar Diakhaby,gn GUI,DF,Valencia,25.0,1996.0,27.2,30,16,19,11,0,13,20,65.0,7,30,17,13,20,50,111,2,Matches,2022-2023,La-Liga
Mamady Diarra,ml MLI,"MF,DF",Cádiz,22.0,2000.0,0.7,2,1,2,0,0,1,2,50.0,1,2,0,2,0,2,0,0,Matches,2022-2023,La-Liga
Youba Diarra,ml MLI,MF,Cádiz,24.0,1998.0,1.1,3,0,2,1,0,1,5,20.0,4,7,1,6,2,5,3,0,Matches,2022-2023,La-Liga
Stole Dimitrievski,mk MKD,GK,Rayo Vallecano,28.0,1993.0,36.9,1,0,1,0,0,1,2,50.0,1,2,0,2,1,2,17,3,Matches,2022-2023,La-Liga
Djené,tg TOG,DF,Getafe,30.0,1991.0,31.6,41,28,23,17,1,22,38,57.9,16,25,10,15,42,83,81,1,Matches,2022-2023,La-Liga
Marko Dmitrović,rs SRB,GK,Sevilla,30.0,1992.0,14.1,0,0,0,0,0,0,0,,0,0,0,0,0,0,6,0,Matches,2022-2023,La-Liga
Matt Doherty,ie IRL,DF,Atlético Madrid,30.0,1992.0,0.2,0,0,0,0,0,0,0,,0,2,0,2,0,0,0,0,Matches,2022-2023,La-Liga
Kasper Dolberg,dk DEN,FW,Sevilla,24.0,1997.0,2.2,1,0,0,1,0,1,3,33.3,2,0,0,0,0,1,5,0,Matches,2022-2023,La-Liga
Carlos Dominguez,es ESP,DF,Celta Vigo,21.0,2001.0,1.2,1,1,0,1,0,1,2,50.0,1,1,1,0,0,1,7,0,Matches,2022-2023,La-Liga
John Donald,es ESP,"MF,DF",Elche,21.0,2000.0,12.1,20,11,9,9,2,7,14,50.0,7,14,7,7,14,34,23,1,Matches,2022-2023,La-Liga
Domingos Duarte,pt POR,DF,Getafe,27.0,1995.0,29.5,26,18,21,5,0,19,26,73.1,7,29,23,6,39,65,145,0,Matches,2022-2023,La-Liga
Pablo Durán,es ESP,"MF,DF",Celta Vigo,21.0,2001.0,0.4,0,0,0,0,0,0,0,,0,2,1,1,1,1,2,0,Matches,2022-2023,La-Liga
Hugo Duro,es ESP,FW,Valencia,22.0,1999.0,15.4,15,12,2,6,7,7,17,41.2,10,11,1,10,2,17,7,1,Matches,2022-2023,La-Liga
Íñigo Eguaras,es ESP,MF,Almería,30.0,1992.0,10.7,11,8,4,6,1,5,18,27.8,13,9,3,6,6,17,15,0,Matches,2022-2023,La-Liga
Aritz Elustondo,es ESP,DF,Real Sociedad,28.0,1994.0,16.1,26,17,15,10,1,14,26,53.8,12,15,6,9,20,46,43,1,Matches,2022-2023,La-Liga
Rodrigo Ely,br BRA,DF,Almería,28.0,1993.0,35.1,30,21,26,4,0,18,25,72.0,7,46,33,13,31,61,203,1,Matches,2022-2023,La-Liga
Adri Embarba,es ESP,"FW,MF",Almería,30.0,1992.0,16.4,50,27,21,26,3,22,46,47.8,24,23,0,23,9,59,9,0,Matches,2022-2023,La-Liga
Adri Embarba,es ESP,FW,Espanyol,30.0,1992.0,0.4,1,0,0,1,0,1,1,100.0,0,1,0,1,0,1,0,0,Matches,2022-2023,La-Liga
Youssef En-Nesyri,ma MAR,FW,Sevilla,25.0,1997.0,18.5,16,8,3,7,6,4,14,28.6,10,6,2,4,4,20,16,0,Matches,2022-2023,La-Liga
Gonzalo Escalante,ar ARG,MF,Cádiz,29.0,1993.0,12.5,36,24,15,20,1,15,29,51.7,14,18,4,14,17,53,26,1,Matches,2022-2023,La-Liga
Sergio Escudero,es ESP,DF,Valladolid,32.0,1989.0,16.0,33,19,21,8,4,15,35,42.9,20,26,6,20,26,59,46,0,Matches,2022-2023,La-Liga
Alfonso Espino,uy URU,DF,Cádiz,30.0,1992.0,34.7,87,56,55,20,12,48,96,50.0,48,52,11,41,48,135,99,3,Matches,2022-2023,La-Liga
Bernardo Espinosa,co COL,DF,Girona,33.0,1989.0,13.6,6,2,2,4,0,3,9,33.3,6,17,10,7,12,18,70,2,Matches,2022-2023,La-Liga
Edu Expósito,es ESP,MF,Espanyol,25.0,1996.0,12.9,34,20,16,15,3,13,23,56.5,10,7,0,7,12,46,20,0,Matches,2022-2023,La-Liga
Nicolás Ezequiel Fernández,ar ARG,"MF,DF",Elche,22.0,2000.0,5.7,23,12,10,7,6,9,17,52.9,8,7,0,7,5,28,2,1,Matches,2022-2023,La-Liga
Abde Ezzalzouli,ma MAR,"FW,MF",Osasuna,20.0,2001.0,16.7,29,19,13,12,4,13,23,56.5,10,20,0,20,4,33,6,0,Matches,2022-2023,La-Liga
Radamel Falcao,co COL,"FW,MF",Rayo Vallecano,36.0,1986.0,6.8,4,4,1,3,0,1,8,12.5,7,5,1,4,2,6,10,0,Matches,2022-2023,La-Liga
Fali,es ESP,"DF,MF",Cádiz,28.0,1993.0,19.0,27,19,19,8,0,18,29,62.1,11,24,15,9,13,40,70,1,Matches,2022-2023,La-Liga
Mamadou Fall,sn SEN,DF,Villarreal,19.0,2002.0,0.3,0,0,0,0,0,0,0,,0,1,0,1,0,0,1,0,Matches,2022-2023,La-Liga
Ansu Fati,es ESP,FW,Barcelona,19.0,2002.0,15.5,16,9,8,4,4,5,18,27.8,13,19,0,19,5,21,6,0,Matches,2022-2023,La-Liga
Zouhair Feddal,ma MAR,DF,Valladolid,33.0,1989.0,4.2,4,2,1,3,0,3,4,75.0,1,9,9,0,5,9,27,0,Matches,2022-2023,La-Liga
Nabil Fekir,fr FRA,MF,Betis,29.0,1993.0,10.7,11,5,3,3,5,2,9,22.2,7,6,2,4,1,12,0,0,Matches,2022-2023,La-Liga
Felipe,br BRA,DF,Atlético Madrid,33.0,1989.0,2.2,3,2,1,2,0,2,4,50.0,2,2,2,0,0,3,7,0,Matches,2022-2023,La-Liga
Luiz Felipe,it ITA,DF,Betis,25.0,1997.0,19.6,34,23,23,11,0,18,34,52.9,16,43,24,19,28,62,106,0,Matches,2022-2023,La-Liga
João Félix,pt POR,"FW,MF",Atlético Madrid,22.0,1999.0,7.2,10,7,2,3,5,1,6,16.7,5,1,0,1,3,13,2,0,Matches,2022-2023,La-Liga
Kiko Femenía,es ESP,DF,Villarreal,31.0,1991.0,12.6,18,9,14,3,1,13,18,72.2,5,15,6,9,20,38,22,0,Matches,2022-2023,La-Liga
Aitor Fernández,es ESP,GK,Osasuna,31.0,1991.0,21.0,1,1,1,0,0,0,1,0.0,1,0,0,0,2,3,17,0,Matches,2022-2023,La-Liga
Álex Fernández,es ESP,"MF,FW",Cádiz,29.0,1992.0,17.5,13,7,6,4,3,4,14,28.6,10,14,1,13,8,21,19,0,Matches,2022-2023,La-Liga
Álvaro Fernández,es ESP,GK,Espanyol,24.0,1998.0,11.0,0,0,0,0,0,0,0,,0,0,0,0,0,0,7,2,Matches,2022-2023,La-Liga
Carlos Fernández,es ESP,FW,Real Sociedad,26.0,1996.0,7.0,6,4,1,3,2,1,15,6.7,14,1,0,1,1,7,4,0,Matches,2022-2023,La-Liga
Federico Fernández,ar ARG,DF,Elche,33.0,1989.0,1.0,1,1,1,0,0,1,1,100.0,0,0,0,0,2,3,12,0,Matches,2022-2023,La-Liga
Joaquín Fernández,es ESP,DF,Valladolid,26.0,1996.0,24.0,35,28,20,11,4,19,30,63.3,11,31,22,9,27,62,98,1,Matches,2022-2023,La-Liga
Valery Fernández,es ESP,"MF,DF",Girona,22.0,1999.0,10.7,12,6,4,6,2,5,9,55.6,4,8,1,7,10,22,9,1,Matches,2022-2023,La-Liga
Fernando,es ESP,GK,Almería,32.0,1990.0,36.5,0,0,0,0,0,0,2,0.0,2,2,0,2,1,1,20,3,Matches,2022-2023,La-Liga
Fernando,br BRA,"MF,DF",Sevilla,35.0,1987.0,17.5,34,23,14,17,3,18,30,60.0,12,21,10,11,24,58,29,0,Matches,2022-2023,La-Liga
Fidel,es ESP,"MF,FW",Elche,32.0,1989.0,19.0,15,10,8,5,2,4,38,10.5,34,9,0,9,5,20,8,0,Matches,2022-2023,La-Liga
Dimitri Foulquier,fr FRA,DF,Valencia,29.0,1993.0,19.3,31,19,17,8,6,20,28,71.4,8,19,3,16,14,45,40,0,Matches,2022-2023,La-Liga
Juan Foyth,ar ARG,DF,Villarreal,24.0,1998.0,21.8,73,48,49,22,2,41,57,71.9,16,32,11,21,20,93,68,0,Matches,2022-2023,La-Liga
Iván Fresneda,es ESP,DF,Valladolid,17.0,2004.0,19.4,48,34,31,13,4,29,47,61.7,18,32,8,24,15,63,60,0,Matches,2022-2023,La-Liga
Javi Galán,es ESP,DF,Celta Vigo,27.0,1994.0,35.1,104,72,60,40,4,48,98,49.0,50,54,5,49,41,145,63,1,Matches,2022-2023,La-Liga
Iñigo Ruiz de Galarreta,es ESP,MF,Mallorca,28.0,1993.0,27.2,54,38,27,23,4,20,52,38.5,32,26,9,17,30,84,19,0,Matches,2022-2023,La-Liga
Aleix García,es ESP,MF,Girona,25.0,1997.0,26.0,37,20,9,18,10,15,33,45.5,18,24,8,16,31,68,35,1,Matches,2022-2023,La-Liga
Álvaro García,es ESP,"FW,MF",Rayo Vallecano,29.0,1992.0,31.9,49,28,21,13,15,11,33,33.3,22,41,4,37,34,83,24,1,Matches,2022-2023,La-Liga
Borja García,es ESP,"MF,FW",Girona,31.0,1990.0,7.5,10,4,7,2,1,2,9,22.2,7,3,1,2,5,15,6,1,Matches,2022-2023,La-Liga
Carlos García,es ESP,DF,Cádiz,22.0,2000.0,0.3,0,0,0,0,0,0,0,,0,0,0,0,0,0,2,0,Matches,2022-2023,La-Liga
Dani García,es ESP,MF,Athletic Club,32.0,1990.0,16.5,46,27,17,25,4,29,47,61.7,18,21,6,15,19,65,21,1,Matches,2022-2023,La-Liga
David García,es ESP,DF,Osasuna,28.0,1994.0,29.8,34,20,22,12,0,19,22,86.4,3,28,13,15,45,79,151,0,Matches,2022-2023,La-Liga
Eric García,es ESP,"DF,MF",Barcelona,21.0,2001.0,15.7,24,16,16,5,3,9,20,45.0,11,23,10,13,19,43,36,1,Matches,2022-2023,La-Liga
Fran Garcia,es ESP,DF,Rayo Vallecano,22.0,1999.0,37.9,84,54,53,23,8,55,96,57.3,41,49,8,41,44,128,66,0,Matches,2022-2023,La-Liga
Joan García,es ESP,GK,Espanyol,21.0,2001.0,1.0,0,0,0,0,0,0,0,,0,0,0,0,0,0,0,0,Matches,2022-2023,La-Liga
Raúl García,es ESP,"FW,MF",Athletic Club,36.0,1986.0,10.7,12,8,3,4,5,5,15,33.3,10,13,1,12,6,18,9,0,Matches,2022-2023,La-Liga
Rubén García,es ESP,"FW,MF",Osasuna,29.0,1993.0,12.9,20,11,12,4,4,7,24,29.2,17,14,1,13,12,32,13,0,Matches,2022-2023,La-Liga
Unai García,es ESP,DF,Osasuna,30.0,1992.0,19.0,23,13,13,8,2,12,17,70.6,5,23,14,9,19,42,60,2,Matches,2022-2023,La-Liga
Felix Garreta,es ESP,DF,Betis,18.0,2004.0,1.0,1,0,0,1,0,0,0,,0,1,1,0,1,2,4,0,Matches,2022-2023,La-Liga
Aleix Garrido,es ESP,FW,Barcelona,18.0,2004.0,0.1,2,1,1,0,1,1,1,100.0,0,1,0,1,0,2,0,0,Matches,2022-2023,La-Liga
Sékou Gassama,sn SEN,FW,Valladolid,27.0,1995.0,0.4,0,0,0,0,0,0,0,,0,0,0,0,0,0,0,0,Matches,2022-2023,La-Liga
Gavi,es ESP,"MF,FW",Barcelona,17.0,2004.0,28.1,47,31,7,30,10,21,55,38.2,34,32,5,27,18,65,22,0,Matches,2022-2023,La-Liga
Paulo Gazzaniga,ar ARG,GK,Girona,30.0,1992.0,28.0,0,0,0,0,0,0,1,0.0,1,0,0,0,1,1,9,5,Matches,2022-2023,La-Liga
Bryan Gil,es ESP,"FW,DF",Sevilla,21.0,2001.0,10.2,22,11,11,7,4,10,23,43.5,13,10,0,10,8,30,10,0,Matches,2022-2023,La-Liga
David Gil,es ESP,GK,Cádiz,28.0,1994.0,4.0,0,0,0,0,0,0,0,,0,0,0,0,0,0,3,0,Matches,2022-2023,La-Liga
Óscar Gil,es ESP,DF,Espanyol,25.0,1997.0,28.4,63,37,38,16,9,32,61,52.5,29,51,18,33,31,94,55,1,Matches,2022-2023,La-Liga
Álvaro Giménez,es ESP,FW,Cádiz,31.0,1991.0,0.2,0,0,0,0,0,0,1,0.0,1,0,0,0,0,0,0,0,Matches,2022-2023,La-Liga
Dani Gómez,es ESP,"MF,FW",Espanyol,24.0,1998.0,1.0,2,1,1,1,0,1,2,50.0,1,0,0,0,1,3,0,0,Matches,2022-2023,La-Liga
Maxi Gómez,uy URU,FW,Valencia,25.0,1996.0,1.2,0,0,0,0,0,0,0,,0,0,0,0,0,0,2,0,Matches,2022-2023,La-Liga
Moi Gómez,es ESP,"MF,FW",Osasuna,28.0,1994.0,27.3,26,17,9,14,3,15,32,46.9,17,15,3,12,10,36,5,1,Matches,2022-2023,La-Liga
Papu Gómez,ar ARG,"FW,MF",Sevilla,34.0,1988.0,11.8,6,4,3,3,0,2,10,20.0,8,8,1,7,4,10,5,0,Matches,2022-2023,La-Liga
Sergi Gómez,es ESP,DF,Espanyol,30.0,1992.0,26.0,29,16,20,9,0,18,22,81.8,4,33,19,14,27,56,125,1,Matches,2022-2023,La-Liga
Antonio Gomis,es ESP,GK,Atlético Madrid,19.0,2003.0,0.1,0,0,0,0,0,0,0,,0,0,0,0,0,0,0,0,Matches,2022-2023,La-Liga
Diego González,es ESP,DF,Elche,27.0,1995.0,10.6,12,7,9,3,0,7,11,63.6,4,14,12,2,7,19,50,1,Matches,2022-2023,La-Liga
Édgar González,es ESP,DF,Betis,25.0,1997.0,19.7,28,19,18,7,3,14,27,51.9,13,12,9,3,21,49,120,0,Matches,2022-2023,La-Liga
Giovanni González,uy URU,DF,Mallorca,27.0,1994.0,10.3,16,8,11,2,3,9,22,40.9,13,8,2,6,7,23,22,0,Matches,2022-2023,La-Liga
Nicolás González,es ESP,MF,Valencia,20.0,2002.0,15.6,27,15,11,13,3,9,25,36.0,16,21,7,14,19,46,16,0,Matches,2022-2023,La-Liga
Roberto González,es ESP,"FW,MF",Betis,21.0,2001.0,0.6,0,0,0,0,0,0,1,0.0,1,0,0,0,1,1,0,0,Matches,2022-2023,La-Liga
Andoni Gorosabel,es ESP,DF,Real Sociedad,25.0,1996.0,19.0,41,25,23,9,9,26,43,60.5,17,21,2,19,17,58,23,0,Matches,2022-2023,La-Liga
José Gragera,es ESP,"MF,DF",Espanyol,21.0,2000.0,5.1,19,9,11,6,2,6,11,54.5,5,10,4,6,7,26,18,0,Matches,2022-2023,La-Liga
Ivo Grbić,hr CRO,GK,Atlético Madrid,26.0,1996.0,10.2,0,0,0,0,0,0,0,,0,0,0,0,0,0,9,1,Matches,2022-2023,La-Liga
Dominik Greif,sk SVK,GK,Mallorca,25.0,1997.0,1.0,0,0,0,0,0,0,0,,0,0,0,0,0,0,0,0,Matches,2022-2023,La-Liga
Clément Grenier,fr FRA,MF,Mallorca,31.0,1991.0,8.0,20,8,6,12,2,10,20,50.0,10,9,1,8,6,26,7,0,Matches,2022-2023,La-Liga
Antoine Griezmann,fr FRA,"FW,MF",Atlético Madrid,31.0,1991.0,31.8,49,34,15,23,11,20,66,30.3,46,34,3,31,24,73,31,0,Matches,2022-2023,La-Liga
Andrés Guardado,mx MEX,MF,Betis,35.0,1986.0,15.3,41,25,17,20,4,18,43,41.9,25,14,5,9,23,64,29,0,Matches,2022-2023,La-Liga
Sergi Guardiola,es ESP,FW,Valladolid,31.0,1991.0,5.6,12,7,6,5,1,2,4,50.0,2,6,0,6,2,14,7,0,Matches,2022-2023,La-Liga
Sergi Guardiola,es ESP,FW,Cádiz,31.0,1991.0,12.9,9,7,0,6,3,3,12,25.0,9,5,0,5,3,12,7,0,Matches,2022-2023,La-Liga
Nemanja Gudelj,rs SRB,"DF,MF",Sevilla,30.0,1991.0,30.9,43,33,22,18,3,20,33,60.6,13,39,29,10,34,77,102,1,Matches,2022-2023,La-Liga
Javier Guerra,es ESP,MF,Valencia,19.0,2003.0,6.7,16,13,7,4,5,9,20,45.0,11,8,1,7,11,27,9,0,Matches,2022-2023,La-Liga
Ander Guevara,es ESP,MF,Real Sociedad,25.0,1997.0,2.5,5,2,2,2,1,1,4,25.0,3,6,1,5,2,7,3,0,Matches,2022-2023,La-Liga
Pape Gueye,sn SEN,MF,Sevilla,23.0,1999.0,13.0,37,22,13,21,3,16,33,48.5,17,21,5,16,22,59,10,0,Matches,2022-2023,La-Liga
Hugo Guillamón,es ESP,MF,Valencia,22.0,2000.0,18.1,20,12,10,8,2,8,24,33.3,16,14,2,12,19,39,30,2,Matches,2022-2023,La-Liga
Gerard Gumbau,es ESP,MF,Elche,27.0,1994.0,30.4,44,25,17,23,4,18,51,35.3,33,32,8,24,28,72,40,0,Matches,2022-2023,La-Liga
Gorka Guruzeta,es ESP,FW,Athletic Club,25.0,1996.0,15.8,24,20,6,12,6,11,24,45.8,13,23,2,21,4,28,8,0,Matches,2022-2023,La-Liga
Raúl Guti,es ESP,MF,Elche,25.0,1996.0,12.4,18,12,8,9,1,8,18,44.4,10,10,3,7,8,26,6,0,Matches,2022-2023,La-Liga
Miguel Gutiérrez,es ESP,DF,Girona,21.0,2001.0,26.6,41,23,23,13,5,23,37,62.2,14,23,5,18,18,59,42,1,Matches,2022-2023,La-Liga
Munir El Haddadi,ma MAR,"MF,FW",Getafe,26.0,1995.0,12.8,12,7,3,7,2,2,10,20.0,8,23,2,21,9,21,7,0,Matches,2022-2023,La-Liga
Dennis Hadzikadunic,ba BIH,DF,Mallorca,24.0,1998.0,6.8,9,6,4,5,0,4,4,100.0,0,5,4,1,3,12,27,0,Matches,2022-2023,La-Liga
Haissem Hassan,fr FRA,"FW,MF",Villarreal,20.0,2002.0,0.6,0,0,0,0,0,0,2,0.0,2,0,0,0,1,1,0,0,Matches,2022-2023,La-Liga
Eden Hazard,be BEL,FW,Real Madrid,31.0,1991.0,2.2,0,0,0,0,0,0,2,0.0,2,1,0,1,1,1,0,0,Matches,2022-2023,La-Liga
Luiz Henrique,br BRA,FW,Betis,21.0,2001.0,20.1,48,34,27,15,6,20,44,45.5,24,22,0,22,14,62,17,0,Matches,2022-2023,La-Liga
Mario Hermoso,es ESP,DF,Atlético Madrid,27.0,1995.0,23.4,22,15,14,6,2,9,30,30.0,21,19,9,10,19,41,85,1,Matches,2022-2023,La-Liga
Javi Hernández,es ESP,DF,Girona,24.0,1998.0,12.4,21,12,12,7,2,13,21,61.9,8,10,5,5,7,28,38,0,Matches,2022-2023,La-Liga
Aridane Hernández,es ESP,DF,Osasuna,33.0,1989.0,19.9,21,15,17,4,0,12,25,48.0,13,34,21,13,28,49,96,1,Matches,2022-2023,La-Liga
Luis Hernández,es ESP,DF,Cádiz,33.0,1989.0,35.0,33,21,25,7,1,22,36,61.1,14,31,24,7,31,64,145,0,Matches,2022-2023,La-Liga
Mario Hernández,es ESP,DF,Rayo Vallecano,23.0,1999.0,1.1,3,2,2,1,0,3,7,42.9,4,2,0,2,2,5,0,0,Matches,2022-2023,La-Liga
Jorge Herrando,es ESP,DF,Osasuna,21.0,2001.0,0.3,0,0,0,0,0,0,0,,0,1,0,1,0,0,3,0,Matches,2022-2023,La-Liga
Ander Herrera,es ESP,MF,Athletic Club,32.0,1989.0,7.7,18,10,8,7,3,6,18,33.3,12,12,3,9,11,29,12,0,Matches,2022-2023,La-Liga
Sergio Herrera,es ESP,GK,Osasuna,29.0,1993.0,17.0,2,0,2,0,0,2,2,100.0,0,1,0,1,1,3,6,2,Matches,2022-2023,La-Liga
Yangel Herrera,ve VEN,"MF,FW",Girona,24.0,1998.0,10.7,26,9,9,14,3,6,15,40.0,9,14,1,13,4,30,12,0,Matches,2022-2023,La-Liga
Omar El Hilali,ma MAR,"DF,MF",Espanyol,18.0,2003.0,1.0,3,2,3,0,0,1,2,50.0,1,1,0,1,1,4,6,0,Matches,2022-2023,La-Liga
Martin Hongla,cm CMR,"DF,MF",Valladolid,24.0,1998.0,14.5,18,13,13,5,0,11,21,52.4,10,15,12,3,8,26,46,1,Matches,2022-2023,La-Liga
Pablo Ibáñez,es ESP,MF,Osasuna,23.0,1998.0,11.8,29,13,7,17,5,12,35,34.3,23,19,2,17,8,37,24,0,Matches,2022-2023,La-Liga
Iglesias,es ESP,"DF,MF",Getafe,24.0,1998.0,23.8,61,35,40,18,3,33,65,50.8,32,40,5,35,21,82,91,1,Matches,2022-2023,La-Liga
Borja Iglesias,es ESP,FW,Betis,29.0,1993.0,26.3,8,4,3,3,2,2,13,15.4,11,9,1,8,1,9,17,0,Matches,2022-2023,La-Liga
Asier Illarramendi,es ESP,MF,Real Sociedad,32.0,1990.0,12.0,36,18,10,22,4,16,44,36.4,28,27,8,19,18,54,20,0,Matches,2022-2023,La-Liga
Alexander Isak,se SWE,FW,Real Sociedad,22.0,1999.0,1.7,1,1,0,0,1,0,0,,0,0,0,0,0,1,2,0,Matches,2022-2023,La-Liga
Isco,es ESP,"MF,FW",Sevilla,30.0,1992.0,8.9,15,9,6,5,4,8,14,57.1,6,3,0,3,10,25,3,0,Matches,2022-2023,La-Liga
Diego Iturralde,es ESP,DF,Sevilla,19.0,2003.0,0.5,1,0,1,0,0,0,2,0.0,2,0,0,0,0,1,1,0,Matches,2022-2023,La-Liga
Nicolas Jackson,sn SEN,FW,Villarreal,21.0,2001.0,17.8,14,11,2,10,2,2,8,25.0,6,18,2,16,2,16,4,0,Matches,2022-2023,La-Liga
Adnan Januzaj,be BEL,FW,Sevilla,27.0,1995.0,0.5,0,0,0,0,0,0,1,0.0,1,0,0,0,1,1,0,0,Matches,2022-2023,La-Liga
Luis Javier Suárez,co COL,FW,Almería,24.0,1997.0,16.6,17,11,5,6,6,6,26,23.1,20,13,3,10,3,20,10,0,Matches,2022-2023,La-Liga
Joaquín,es ESP,"MF,FW",Betis,41.0,1981.0,5.5,3,3,2,1,0,1,3,33.3,2,7,2,5,4,7,5,0,Matches,2022-2023,La-Liga
Frenkie de Jong,nl NED,MF,Barcelona,25.0,1997.0,28.2,46,26,16,21,9,17,41,41.5,24,11,1,10,35,81,22,1,Matches,2022-2023,La-Liga
Joan Jordán,es ESP,MF,Sevilla,28.0,1994.0,17.7,32,17,13,17,2,16,38,42.1,22,14,7,7,16,48,14,2,Matches,2022-2023,La-Liga
Josan,es ESP,"DF,MF",Elche,32.0,1989.0,12.0,25,20,20,5,0,14,27,51.9,13,8,0,8,7,32,15,1,Matches,2022-2023,La-Liga
Willian José,br BRA,FW,Betis,30.0,1991.0,8.1,9,6,6,3,0,4,9,44.4,5,4,0,4,1,10,15,0,Matches,2022-2023,La-Liga
Joselu,es ESP,FW,Espanyol,32.0,1990.0,33.2,13,11,3,4,6,4,17,23.5,13,25,4,21,8,21,43,0,Matches,2022-2023,La-Liga
Juanmi,es ESP,FW,Betis,29.0,1993.0,10.3,14,10,4,7,3,7,31,22.6,24,10,0,10,4,18,4,0,Matches,2022-2023,La-Liga
Juanpe,es ESP,DF,Girona,31.0,1991.0,15.8,19,11,10,9,0,11,17,64.7,6,12,9,3,10,29,60,1,Matches,2022-2023,La-Liga
Lago Junior,ci CIV,"FW,MF",Mallorca,31.0,1990.0,0.6,1,0,0,1,0,1,1,100.0,0,0,0,0,0,1,0,0,Matches,2022-2023,La-Liga
Vinicius Júnior,br BRA,FW,Real Madrid,22.0,2000.0,31.4,30,21,10,12,8,14,39,35.9,25,24,1,23,6,36,1,0,Matches,2022-2023,La-Liga
Filip Jørgensen,dk DEN,GK,Villarreal,20.0,2002.0,2.0,0,0,0,0,0,0,1,0.0,1,0,0,0,0,0,0,0,Matches,2022-2023,La-Liga
Tino Kadewere,zw ZIM,"FW,MF",Mallorca,26.0,1996.0,6.0,6,3,3,3,0,4,9,44.4,5,6,2,4,2,8,1,0,Matches,2022-2023,La-Liga
Kaiky,br BRA,DF,Almería,18.0,2004.0,6.5,5,5,5,0,0,3,7,42.9,4,18,10,8,11,16,28,0,Matches,2022-2023,La-Liga
Lee Kang-in,kr KOR,"MF,FW",Mallorca,21.0,2001.0,31.4,42,24,10,22,10,18,61,29.5,43,25,2,23,11,53,7,0,Matches,2022-2023,La-Liga
Jon Karrikaburu,es ESP,FW,Real Sociedad,19.0,2002.0,1.0,1,0,0,1,0,0,0,,0,2,0,2,0,1,0,0,Matches,2022-2023,La-Liga
Kenedy,br BRA,"FW,DF",Valladolid,26.0,1996.0,3.1,6,2,3,3,0,2,4,50.0,2,2,0,2,1,7,0,0,Matches,2022-2023,La-Liga
Franck Kessié,ci CIV,MF,Barcelona,25.0,1996.0,11.0,15,9,6,6,3,8,18,44.4,10,10,2,8,12,27,11,2,Matches,2022-2023,La-Liga
Kiké,es ESP,FW,Osasuna,32.0,1989.0,11.3,6,3,0,4,2,2,5,40.0,3,6,1,5,1,7,13,0,Matches,2022-2023,La-Liga
Justin Kluivert,nl NED,"FW,MF",Valencia,23.0,1999.0,16.1,17,14,7,4,6,6,12,50.0,6,4,0,4,7,24,4,0,Matches,2022-2023,La-Liga
Koke,es ESP,MF,Atlético Madrid,30.0,1992.0,28.3,55,38,23,25,7,28,72,38.9,44,35,13,22,20,75,19,0,Matches,2022-2023,La-Liga
Luca Koleosho,it ITA,"FW,DF",Espanyol,17.0,2004.0,0.7,2,2,0,0,2,1,2,50.0,1,1,0,1,0,2,0,0,Matches,2022-2023,La-Liga
Geoffrey Kondogbia,cf CTA,MF,Atlético Madrid,29.0,1993.0,11.2,40,23,19,20,1,17,25,68.0,8,9,1,8,26,66,12,1,Matches,2022-2023,La-Liga
Jules Koundé,fr FRA,DF,Barcelona,23.0,1998.0,27.0,37,23,18,13,6,21,31,67.7,10,24,9,15,19,56,61,3,Matches,2022-2023,La-Liga
Toni Kroos,de GER,MF,Real Madrid,32.0,1990.0,23.9,51,32,16,33,2,23,69,33.3,46,23,4,19,24,75,11,0,Matches,2022-2023,La-Liga
Takefusa Kubo,jp JPN,"FW,MF",Real Sociedad,21.0,2001.0,27.1,44,26,18,16,10,16,38,42.1,22,29,1,28,9,53,4,0,Matches,2022-2023,La-Liga
César de la Hoz,es ESP,MF,Almería,30.0,1992.0,18.6,37,20,17,18,2,19,37,51.4,18,26,6,20,13,50,37,0,Matches,2022-2023,La-Liga
Luca de la Torre,us USA,MF,Celta Vigo,24.0,1998.0,16.5,28,19,11,14,3,12,32,37.5,20,22,1,21,9,37,6,0,Matches,2022-2023,La-Liga
Érik Lamela,ar ARG,"FW,MF",Sevilla,30.0,1992.0,20.5,46,27,14,16,16,12,34,35.3,22,26,2,24,7,53,3,0,Matches,2022-2023,La-Liga
Cyle Larin,ca CAN,FW,Valladolid,27.0,1995.0,16.3,9,3,2,4,3,3,7,42.9,4,6,3,3,0,9,15,0,Matches,2022-2023,La-Liga
Juanmi Latasa,es ESP,FW,Getafe,21.0,2001.0,5.0,5,4,2,0,3,1,1,100.0,0,3,1,2,1,6,8,0,Matches,2022-2023,La-Liga
Toni Lato,es ESP,"DF,MF",Valencia,24.0,1997.0,10.2,23,11,9,12,2,9,21,42.9,12,10,1,9,6,29,14,0,Matches,2022-2023,La-Liga
Lázaro,br BRA,"FW,MF",Almería,20.0,2002.0,8.0,4,3,3,0,1,3,15,20.0,12,16,1,15,2,6,1,0,Matches,2022-2023,La-Liga
Robin Le Normand,es ESP,DF,Real Sociedad,25.0,1996.0,31.1,36,23,25,9,2,14,27,51.9,13,22,14,8,33,69,93,0,Matches,2022-2023,La-Liga
Benjamin Lecomte,fr FRA,GK,Espanyol,31.0,1991.0,10.0,0,0,0,0,0,0,0,,0,0,0,0,0,0,3,2,Matches,2022-2023,La-Liga
Jeremías Ledesma,ar ARG,GK,Cádiz,29.0,1993.0,34.0,3,2,3,0,0,3,7,42.9,4,1,0,1,2,5,23,3,Matches,2022-2023,La-Liga
Florian Lejeune,fr FRA,DF,Rayo Vallecano,31.0,1991.0,28.5,28,17,19,8,1,17,25,68.0,8,24,16,8,15,43,123,0,Matches,2022-2023,La-Liga
Iñigo Lekue,es ESP,DF,Athletic Club,29.0,1993.0,14.7,24,17,20,4,0,12,19,63.2,7,16,2,14,13,37,31,1,Matches,2022-2023,La-Liga
Thomas Lemar,fr FRA,MF,Atlético Madrid,26.0,1995.0,13.9,30,18,10,13,7,10,28,35.7,18,12,3,9,7,37,12,0,Matches,2022-2023,La-Liga
Sergio León,es ESP,FW,Valladolid,33.0,1989.0,14.8,6,4,0,4,2,3,6,50.0,3,6,0,6,0,6,4,0,Matches,2022-2023,La-Liga
Robert Lewandowski,pl POL,FW,Barcelona,33.0,1988.0,31.6,17,11,2,5,10,7,14,50.0,7,20,0,20,2,19,14,0,Matches,2022-2023,La-Liga
Samuel Lino,br BRA,"FW,MF",Valencia,22.0,1999.0,32.1,66,43,17,37,12,26,72,36.1,46,34,0,34,18,84,16,0,Matches,2022-2023,La-Liga
Pol Lirola,es ESP,DF,Elche,24.0,1997.0,7.0,13,6,9,3,1,8,13,61.5,5,3,2,1,7,20,16,0,Matches,2022-2023,La-Liga
Javier Llabrés,es ESP,FW,Mallorca,19.0,2002.0,0.2,0,0,0,0,0,0,0,,0,0,0,0,0,0,1,0,Matches,2022-2023,La-Liga
Marcos Llorente,es ESP,"MF,DF",Atlético Madrid,27.0,1995.0,18.9,32,15,16,10,6,17,30,56.7,13,26,2,24,17,49,19,0,Matches,2022-2023,La-Liga
Giovani Lo Celso,ar ARG,"MF,FW",Villarreal,26.0,1996.0,12.5,32,28,7,15,10,12,21,57.1,9,14,2,12,6,38,5,0,Matches,2022-2023,La-Liga
David López,es ESP,DF,Girona,32.0,1989.0,18.4,31,18,17,13,1,19,27,70.4,8,29,19,10,14,45,64,1,Matches,2022-2023,La-Liga
Diego López,es ESP,GK,Rayo Vallecano,40.0,1981.0,1.1,0,0,0,0,0,0,0,,0,0,0,0,0,0,0,1,Matches,2022-2023,La-Liga
Diego López,es ESP,"FW,MF",Valencia,20.0,2002.0,5.0,2,2,1,1,0,2,15,13.3,13,9,0,9,3,5,5,0,Matches,2022-2023,La-Liga
Unai López,es ESP,MF,Rayo Vallecano,26.0,1995.0,13.9,32,20,10,17,5,13,37,35.1,24,12,1,11,15,47,6,1,Matches,2022-2023,La-Liga
Anthony Lozano,hn HON,FW,Cádiz,29.0,1993.0,16.0,6,4,1,4,1,1,7,14.3,6,12,1,11,3,9,17,0,Matches,2022-2023,La-Liga
Pol Lozano,es ESP,MF,Espanyol,22.0,1999.0,0.2,0,0,0,0,0,0,0,,0,1,0,1,0,0,1,0,Matches,2022-2023,La-Liga
José Luis Gayà,es ESP,DF,Valencia,27.0,1995.0,30.1,80,46,61,16,3,43,74,58.1,31,28,9,19,23,103,48,0,Matches,2022-2023,La-Liga
José Luis Morales,es ESP,"FW,MF",Villarreal,35.0,1987.0,13.5,7,6,1,2,4,5,17,29.4,12,12,1,11,2,9,2,0,Matches,2022-2023,La-Liga
Andriy Lunin,ua UKR,GK,Real Madrid,23.0,1999.0,7.0,0,0,0,0,0,0,0,,0,0,0,0,0,0,1,0,Matches,2022-2023,La-Liga
Awer Mabil,au AUS,"MF,FW",Cádiz,26.0,1995.0,1.8,2,0,0,1,1,1,3,33.3,2,1,1,0,0,2,1,0,Matches,2022-2023,La-Liga
Darwin Machís,ve VEN,FW,Valladolid,29.0,1993.0,6.7,3,2,0,2,1,1,8,12.5,7,5,0,5,3,6,4,0,Matches,2022-2023,La-Liga
Pablo Maffeo,es ESP,DF,Mallorca,25.0,1997.0,33.1,75,46,54,16,5,45,78,57.7,33,38,11,27,26,101,76,0,Matches,2022-2023,La-Liga
Lisandro Magallán,ar ARG,DF,Elche,28.0,1993.0,10.0,19,11,11,5,3,10,12,83.3,2,14,5,9,13,32,30,1,Matches,2022-2023,La-Liga
Jon Magunazelaia,es ESP,"MF,FW",Real Sociedad,22.0,2000.0,0.7,1,0,0,0,1,0,2,0.0,2,0,0,0,0,1,1,0,Matches,2022-2023,La-Liga
Nemanja Maksimović,rs SRB,MF,Getafe,27.0,1995.0,22.8,41,30,17,18,6,19,32,59.4,13,36,14,22,34,75,27,0,Matches,2022-2023,La-Liga
Hugo Mallo,es ESP,DF,Celta Vigo,31.0,1991.0,24.0,53,29,34,14,5,28,42,66.7,14,28,7,21,24,77,73,0,Matches,2022-2023,La-Liga
Mickael Malsa,mq MTQ,MF,Valladolid,26.0,1995.0,0.8,2,2,1,1,0,1,4,25.0,3,1,1,0,2,4,3,0,Matches,2022-2023,La-Liga
Giorgi Mamardashvili,ge GEO,GK,Valencia,21.0,2000.0,38.0,0,0,0,0,0,0,0,,0,0,0,0,1,1,11,4,Matches,2022-2023,La-Liga
Reinildo Mandava,mz MOZ,DF,Atlético Madrid,28.0,1994.0,20.6,66,43,46,19,1,38,49,77.6,11,27,12,15,30,96,59,0,Matches,2022-2023,La-Liga
Aïssa Mandi,dz ALG,DF,Villarreal,30.0,1991.0,16.2,18,10,14,3,1,6,12,50.0,6,19,14,5,21,39,58,0,Matches,2022-2023,La-Liga
Marcão,br BRA,DF,Sevilla,26.0,1996.0,4.2,2,2,1,1,0,1,1,100.0,0,3,3,0,6,8,14,0,Matches,2022-2023,La-Liga
Agustín Marchesín,ar ARG,GK,Celta Vigo,34.0,1988.0,19.0,0,0,0,0,0,0,1,0.0,1,0,0,0,0,0,7,0,Matches,2022-2023,La-Liga
Óscar de Marcos,es ESP,DF,Athletic Club,33.0,1989.0,31.3,67,33,34,22,11,40,76,52.6,36,42,6,36,29,96,59,0,Matches,2022-2023,La-Liga
Alberto Marí,es ESP,"FW,MF",Valencia,21.0,2001.0,1.0,0,0,0,0,0,0,2,0.0,2,0,0,0,0,0,1,0,Matches,2022-2023,La-Liga
José Mari,es ESP,MF,Cádiz,34.0,1987.0,4.4,16,7,12,3,1,10,16,62.5,6,3,1,2,5,21,9,0,Matches,2022-2023,La-Liga
José María Giménez,uy URU,DF,Atlético Madrid,27.0,1995.0,26.9,43,25,28,14,1,24,35,68.6,11,37,17,20,24,67,138,1,Matches,2022-2023,La-Liga
Mariano,do DOM,FW,Real Madrid,28.0,1993.0,1.7,1,0,0,1,0,0,0,,0,1,0,1,0,1,0,0,Matches,2022-2023,La-Liga
Pablo Marín,es ESP,"MF,FW",Real Sociedad,19.0,2003.0,4.0,10,5,5,4,1,2,7,28.6,5,1,0,1,4,14,2,0,Matches,2022-2023,La-Liga
Diego Mariño,es ESP,GK,Almería,32.0,1990.0,0.5,0,0,0,0,0,0,0,,0,0,0,0,0,0,0,0,Matches,2022-2023,La-Liga
Roger Martí,es ESP,FW,Elche,31.0,1991.0,7.3,5,2,3,2,0,1,5,20.0,4,4,0,4,1,6,7,0,Matches,2022-2023,La-Liga
Roger Martí,es ESP,FW,Cádiz,31.0,1991.0,7.1,6,4,2,3,1,1,8,12.5,7,7,0,7,2,8,7,0,Matches,2022-2023,La-Liga
Ander Martin,es ESP,"MF,FW",Real Sociedad,21.0,2000.0,0.5,2,2,1,1,0,1,4,25.0,3,0,0,0,0,2,1,0,Matches,2022-2023,La-Liga
Andrés Martín,es ESP,"FW,MF",Rayo Vallecano,23.0,1999.0,2.3,4,2,2,1,1,3,5,60.0,2,2,0,2,1,5,2,0,Matches,2022-2023,La-Liga
Carlos Martín,es ESP,"FW,MF",Atlético Madrid,20.0,2002.0,0.3,2,2,0,2,0,2,3,66.7,1,0,0,0,1,3,0,0,Matches,2022-2023,La-Liga
Iván Martín,es ESP,MF,Girona,23.0,1999.0,17.6,9,7,4,4,1,8,23,34.8,15,12,0,12,9,18,12,0,Matches,2022-2023,La-Liga
Arnau Martinez,es ESP,DF,Girona,19.0,2003.0,30.4,69,45,41,19,9,38,85,44.7,47,44,10,34,25,94,54,2,Matches,2022-2023,La-Liga
Iñigo Martínez,es ESP,DF,Athletic Club,31.0,1991.0,14.9,18,8,11,7,0,6,9,66.7,3,17,11,6,18,36,55,0,Matches,2022-2023,La-Liga
Roger Martínez,es ESP,DF,Espanyol,18.0,2004.0,0.1,0,0,0,0,0,0,0,,0,0,0,0,0,0,0,0,Matches,2022-2023,La-Liga
Omar Mascarell,gq EQG,"MF,DF",Elche,29.0,1993.0,27.2,53,26,32,19,2,31,64,48.4,33,51,19,32,45,98,54,1,Matches,2022-2023,La-Liga
Jordi Masip,es ESP,GK,Valladolid,33.0,1989.0,27.9,0,0,0,0,0,0,2,0.0,2,0,0,0,1,1,3,2,Matches,2022-2023,La-Liga
Jaime Mata,es ESP,"FW,MF",Getafe,33.0,1988.0,4.9,13,10,4,5,4,7,22,31.8,15,7,2,5,3,16,6,0,Matches,2022-2023,La-Liga
Borja Mayoral,es ESP,FW,Getafe,25.0,1997.0,30.7,9,4,7,2,0,5,31,16.1,26,18,0,18,3,12,10,0,Matches,2022-2023,La-Liga
Mamadou Mbaye,sn SEN,DF,Cádiz,24.0,1998.0,8.4,10,7,7,3,0,6,8,75.0,2,10,8,2,7,17,50,1,Matches,2022-2023,La-Liga
Fernando Medrano,es ESP,DF,Celta Vigo,22.0,2000.0,0.1,2,1,2,0,0,1,1,100.0,0,0,0,0,1,3,1,0,Matches,2022-2023,La-Liga
Gonzalo Melero,es ESP,MF,Almería,28.0,1994.0,20.6,32,16,9,18,5,11,39,28.2,28,23,2,21,7,39,19,1,Matches,2022-2023,La-Liga
Memphis,nl NED,FW,Atlético Madrid,28.0,1994.0,3.0,1,0,0,0,1,0,1,0.0,1,0,0,0,0,1,0,0,Matches,2022-2023,La-Liga
Memphis,nl NED,FW,Barcelona,28.0,1994.0,1.3,1,1,1,0,0,0,1,0.0,1,0,0,0,0,1,0,0,Matches,2022-2023,La-Liga
Houboulang Mendes,gw GNB,DF,Almería,24.0,1998.0,9.8,19,11,16,3,0,11,27,40.7,16,12,2,10,7,26,23,1,Matches,2022-2023,La-Liga
Brais Méndez,es ESP,MF,Real Sociedad,25.0,1997.0,26.7,58,34,18,30,10,24,64,37.5,40,27,3,24,12,70,14,1,Matches,2022-2023,La-Liga
Diego Méndez,es ESP,MF,Rayo Vallecano,18.0,2003.0,0.0,0,0,0,0,0,0,0,,0,0,0,0,1,1,0,0,Matches,2022-2023,La-Liga
Ferland Mendy,fr FRA,DF,Real Madrid,27.0,1995.0,15.0,21,12,14,6,1,12,20,60.0,8,7,2,5,14,35,16,0,Matches,2022-2023,La-Liga
Jorge Meré,es ESP,DF,Cádiz,25.0,1997.0,6.7,11,7,9,2,0,5,8,62.5,3,9,6,3,6,17,32,0,Matches,2022-2023,La-Liga
Mikel Merino,es ESP,MF,Real Sociedad,26.0,1996.0,27.7,77,49,28,33,16,31,62,50.0,31,38,8,30,20,97,51,1,Matches,2022-2023,La-Liga
Roque Mesa,es ESP,MF,Valladolid,33.0,1989.0,18.0,27,15,16,10,1,12,38,31.6,26,16,4,12,13,40,18,0,Matches,2022-2023,La-Liga
Éder Militão,br BRA,DF,Real Madrid,24.0,1998.0,30.0,46,32,25,18,3,26,33,78.8,7,67,39,28,42,88,104,2,Matches,2022-2023,La-Liga
Luis Milla,es ESP,MF,Getafe,27.0,1994.0,20.6,48,30,21,18,9,19,44,43.2,25,13,1,12,32,80,25,1,Matches,2022-2023,La-Liga
Pere Milla,es ESP,"FW,MF",Elche,29.0,1992.0,20.5,31,20,18,8,5,14,41,34.1,27,18,3,15,9,40,19,1,Matches,2022-2023,La-Liga
Marko Milovanović,rs SRB,FW,Almería,18.0,2003.0,0.2,0,0,0,0,0,0,0,,0,0,0,0,0,0,0,0,Matches,2022-2023,La-Liga
Óscar Mingueza,es ESP,DF,Celta Vigo,23.0,1999.0,14.3,37,21,27,9,1,25,32,78.1,7,10,4,6,12,49,25,0,Matches,2022-2023,La-Liga
Rafa Mir,es ESP,FW,Sevilla,25.0,1997.0,14.4,8,2,2,4,2,2,5,40.0,3,5,1,4,4,12,11,0,Matches,2022-2023,La-Liga
Juan Miranda,es ESP,DF,Betis,22.0,2000.0,16.4,23,16,16,6,1,14,29,48.3,15,20,7,13,20,43,63,0,Matches,2022-2023,La-Liga
Stefan Mitrović,rs SRB,DF,Getafe,32.0,1990.0,18.7,14,6,12,2,0,7,11,63.6,4,12,10,2,17,31,90,2,Matches,2022-2023,La-Liga
Luka Modrić,hr CRO,MF,Real Madrid,36.0,1985.0,19.4,19,9,6,6,7,10,25,40.0,15,15,5,10,10,29,7,0,Matches,2022-2023,La-Liga
Johan Mojica,co COL,DF,Villarreal,29.0,1992.0,7.1,13,9,9,3,1,5,9,55.6,4,8,3,5,4,17,14,1,Matches,2022-2023,La-Liga
Johan Mojica,co COL,"DF,MF",Elche,29.0,1992.0,3.0,6,3,5,1,0,2,3,66.7,1,3,2,1,4,10,5,0,Matches,2022-2023,La-Liga
Nahuel Molina,ar ARG,DF,Atlético Madrid,24.0,1998.0,31.9,69,43,38,18,13,39,91,42.9,52,38,7,31,18,87,63,1,Matches,2022-2023,La-Liga
Jon Moncayola,es ESP,"MF,DF",Osasuna,24.0,1998.0,27.2,55,39,24,22,9,30,76,39.5,46,37,5,32,17,72,32,2,Matches,2022-2023,La-Liga
Monchu,es ESP,MF,Valladolid,22.0,1999.0,22.6,50,29,20,21,9,19,46,41.3,27,28,11,17,18,68,22,1,Matches,2022-2023,La-Liga
César Montes,mx MEX,DF,Espanyol,25.0,1997.0,17.7,17,9,10,7,0,10,18,55.6,8,19,12,7,14,31,101,0,Matches,2022-2023,La-Liga
Gonzalo Montiel,ar ARG,DF,Sevilla,25.0,1997.0,16.9,26,15,12,14,0,15,29,51.7,14,25,7,18,19,45,38,0,Matches,2022-2023,La-Liga
Martín Montoya,es ESP,DF,Betis,31.0,1991.0,5.0,13,8,9,4,0,10,12,83.3,2,6,1,5,9,22,14,1,Matches,2022-2023,La-Liga
Álvaro Morata,es ESP,FW,Atlético Madrid,29.0,1992.0,21.1,16,11,4,8,4,3,8,37.5,5,11,3,8,0,16,23,0,Matches,2022-2023,La-Liga
Jon Morcillo,es ESP,"FW,MF",Athletic Club,23.0,1998.0,0.8,1,0,1,0,0,0,1,0.0,1,0,0,0,1,2,0,0,Matches,2022-2023,La-Liga
Alberto Moreno,es ESP,DF,Villarreal,30.0,1992.0,14.4,23,12,10,10,3,11,24,45.8,13,12,1,11,23,46,26,0,Matches,2022-2023,La-Liga
Álex Moreno,es ESP,DF,Betis,29.0,1993.0,15.0,29,22,19,10,0,18,36,50.0,18,17,4,13,17,46,39,0,Matches,2022-2023,La-Liga
Diego Moreno,es ESP,DF,Osasuna,21.0,2001.0,7.1,4,4,2,2,0,3,8,37.5,5,7,4,3,5,9,21,0,Matches,2022-2023,La-Liga
Gerard Moreno,es ESP,FW,Villarreal,30.0,1992.0,13.7,11,6,0,6,5,3,6,50.0,3,6,2,4,5,16,10,0,Matches,2022-2023,La-Liga
Tete Morente,es ESP,"MF,DF",Elche,25.0,1996.0,23.0,33,21,18,13,2,15,36,41.7,21,23,3,20,25,58,28,0,Matches,2022-2023,La-Liga
Ilaix Moriba,gn GUI,MF,Valencia,19.0,2003.0,11.2,35,16,14,17,4,14,24,58.3,10,11,1,10,4,39,12,0,Matches,2022-2023,La-Liga
Manu Morlanes,es ESP,MF,Villarreal,23.0,1999.0,1.8,3,2,2,1,0,3,3,100.0,0,3,2,1,1,4,2,0,Matches,2022-2023,La-Liga
Manu Morlanes,es ESP,MF,Mallorca,23.0,1999.0,7.8,22,9,12,8,2,13,24,54.2,11,10,5,5,5,27,9,0,Matches,2022-2023,La-Liga
Loren Morón,es ESP,FW,Betis,28.0,1993.0,0.2,2,2,0,1,1,0,0,,0,0,0,0,0,2,1,0,Matches,2022-2023,La-Liga
Cristhian Mosquera,es ESP,DF,Valencia,18.0,2004.0,1.6,4,2,3,1,0,4,5,80.0,1,1,0,1,1,5,5,0,Matches,2022-2023,La-Liga
Abdul Mumin,gh GHA,DF,Rayo Vallecano,24.0,1998.0,10.2,11,9,5,6,0,3,7,42.9,4,13,5,8,9,20,36,2,Matches,2022-2023,La-Liga
Iker Muniain,es ESP,"MF,FW",Athletic Club,29.0,1992.0,18.8,21,16,7,11,3,6,17,35.3,11,10,1,9,4,25,2,0,Matches,2022-2023,La-Liga
Aihen Muñoz,es ESP,DF,Real Sociedad,24.0,1997.0,19.5,38,23,17,17,4,22,47,46.8,25,26,5,21,9,47,38,0,Matches,2022-2023,La-Liga
Iker Muñoz,es ESP,MF,Osasuna,19.0,2002.0,2.8,1,0,0,1,0,0,3,0.0,3,2,1,1,3,4,8,0,Matches,2022-2023,La-Liga
Pablo Muñoz,es ESP,MF,Rayo Vallecano,18.0,2003.0,0.1,0,0,0,0,0,0,1,0.0,1,0,0,0,0,0,0,0,Matches,2022-2023,La-Liga
Vedat Muriqi,xk KVX,FW,Mallorca,28.0,1994.0,32.6,12,7,4,7,1,3,13,23.1,10,19,7,12,12,24,73,0,Matches,2022-2023,La-Liga
Yunus Musah,us USA,MF,Valencia,19.0,2002.0,23.4,48,35,17,23,8,20,30,66.7,10,20,1,19,11,59,16,2,Matches,2022-2023,La-Liga
Francisco Mwepu,zm ZAM,FW,Cádiz,22.0,2000.0,0.2,1,0,0,1,0,0,0,,0,0,0,0,0,1,0,0,Matches,2022-2023,La-Liga
Nacho,es ESP,DF,Real Madrid,32.0,1990.0,18.2,24,16,17,5,2,12,29,41.4,17,11,6,5,18,42,37,0,Matches,2022-2023,La-Liga
Juanjo Narváez,co COL,"MF,FW",Valladolid,27.0,1995.0,1.6,1,1,1,0,0,1,1,100.0,0,2,0,2,0,1,0,0,Matches,2022-2023,La-Liga
Matija Nastasić,rs SRB,DF,Mallorca,29.0,1993.0,10.1,10,8,7,1,2,3,6,50.0,3,11,4,7,18,28,43,1,Matches,2022-2023,La-Liga
Roberto Navarro,es ESP,"MF,FW",Real Sociedad,20.0,2002.0,3.9,5,4,4,0,1,1,2,50.0,1,7,0,7,2,7,2,0,Matches,2022-2023,La-Liga
Jesús Navas,es ESP,"DF,FW",Sevilla,36.0,1985.0,22.0,19,12,8,3,8,11,22,50.0,11,18,7,11,22,41,52,1,Matches,2022-2023,La-Liga
Álvaro Negredo,es ESP,FW,Cádiz,36.0,1985.0,8.4,5,4,1,2,2,2,2,100.0,0,4,1,3,0,5,8,0,Matches,2022-2023,La-Liga
Tanguy Nianzou,fr FRA,DF,Sevilla,20.0,2002.0,15.2,20,15,10,9,1,8,11,72.7,3,8,5,3,16,36,44,3,Matches,2022-2023,La-Liga
Saúl Ñíguez,es ESP,"MF,DF",Atlético Madrid,27.0,1994.0,12.2,42,27,18,18,6,22,37,59.5,15,27,5,22,15,57,29,0,Matches,2022-2023,La-Liga
Fernando Niño,es ESP,"MF,FW",Villarreal,21.0,2000.0,0.2,0,0,0,0,0,0,0,,0,0,0,0,0,0,0,0,Matches,2022-2023,La-Liga
Randy Nteka,ao ANG,"FW,MF",Elche,24.0,1997.0,8.1,15,10,7,6,2,2,11,18.2,9,15,3,12,4,19,9,0,Matches,2022-2023,La-Liga
Randy Nteka,ao ANG,"FW,MF",Rayo Vallecano,24.0,1997.0,1.3,4,2,2,2,0,1,1,100.0,0,2,0,2,2,6,3,0,Matches,2022-2023,La-Liga
Unai Núñez,es ESP,DF,Celta Vigo,25.0,1997.0,35.0,47,35,29,15,3,18,34,52.9,16,27,17,10,72,119,135,1,Matches,2022-2023,La-Liga
Jan Oblak,si SVN,GK,Atlético Madrid,29.0,1993.0,27.7,0,0,0,0,0,0,0,,0,0,0,0,1,1,8,0,Matches,2022-2023,La-Liga
Brian Ocampo,uy URU,"MF,FW",Cádiz,23.0,1999.0,12.4,18,15,12,5,1,8,21,38.1,13,13,0,13,3,21,3,0,Matches,2022-2023,La-Liga
Lucas Ocampos,ar ARG,"FW,MF",Sevilla,28.0,1994.0,12.9,22,14,9,9,4,8,31,25.8,23,17,2,15,8,30,5,0,Matches,2022-2023,La-Liga
Álvaro Odriozola,es ESP,DF,Real Madrid,26.0,1995.0,0.4,0,0,0,0,0,0,0,,0,0,0,0,0,0,0,0,Matches,2022-2023,La-Liga
Olasagasti,es ESP,"MF,DF",Real Sociedad,21.0,2000.0,0.7,4,4,1,2,1,1,2,50.0,1,2,0,2,0,4,1,0,Matches,2022-2023,La-Liga
Lucas Olaza,uy URU,DF,Valladolid,28.0,1994.0,16.6,24,14,12,10,2,17,26,65.4,9,20,8,12,14,38,34,0,Matches,2022-2023,La-Liga
Brian Oliván,es ESP,DF,Espanyol,28.0,1994.0,26.7,47,27,30,12,5,17,26,65.4,9,26,6,20,22,69,67,0,Matches,2022-2023,La-Liga
Lucas Oliveira Rosa,br BRA,DF,Valladolid,22.0,2000.0,10.3,39,18,23,10,6,12,20,60.0,8,12,2,10,15,54,24,0,Matches,2022-2023,La-Liga
Aimar Oroz,es ESP,"MF,FW",Osasuna,20.0,2001.0,22.4,26,14,8,10,8,8,30,26.7,22,24,1,23,24,50,6,0,Matches,2022-2023,La-Liga
Pedro Ortiz,es ESP,MF,Sevilla,21.0,2000.0,0.0,0,0,0,0,0,0,0,,0,0,0,0,0,0,0,0,Matches,2022-2023,La-Liga
Mikel Oyarzabal,es ESP,"FW,MF",Real Sociedad,25.0,1997.0,13.5,13,7,5,3,5,5,19,26.3,14,14,4,10,3,16,5,0,Matches,2022-2023,La-Liga
Cenk Özkacar,tr TUR,DF,Valencia,21.0,2000.0,15.2,27,20,17,10,0,14,19,73.7,5,14,2,12,12,39,47,4,Matches,2022-2023,La-Liga
Fernando Pacheco,es ESP,GK,Almería,30.0,1992.0,1.0,0,0,0,0,0,0,0,,0,0,0,0,0,0,1,0,Matches,2022-2023,La-Liga
Fernando Pacheco,es ESP,GK,Espanyol,30.0,1992.0,16.0,0,0,0,0,0,0,1,0.0,1,0,0,0,1,1,11,0,Matches,2022-2023,La-Liga
Jon Pacheco,es ESP,DF,Real Sociedad,21.0,2001.0,13.3,16,10,10,6,0,6,10,60.0,4,9,6,3,12,28,37,1,Matches,2022-2023,La-Liga
Gonçalo Paciência,pt POR,"FW,MF",Celta Vigo,27.0,1994.0,7.4,8,5,0,5,3,2,7,28.6,5,9,1,8,0,8,4,0,Matches,2022-2023,La-Liga
Helibelton Palacios,co COL,DF,Elche,29.0,1993.0,21.3,38,20,21,15,2,19,26,73.1,7,26,12,14,20,58,55,0,Matches,2022-2023,La-Liga
Isaac Palazón Camacho,es ESP,"FW,MF",Rayo Vallecano,27.0,1994.0,32.9,45,30,11,23,11,24,66,36.4,42,42,3,39,17,62,30,0,Matches,2022-2023,La-Liga
Aitor Paredes,es ESP,DF,Athletic Club,22.0,2000.0,9.5,7,6,4,2,1,6,11,54.5,5,11,7,4,14,21,26,0,Matches,2022-2023,La-Liga
Daniel Parejo,es ESP,MF,Villarreal,33.0,1989.0,36.5,71,40,32,23,16,30,75,40.0,45,40,12,28,29,100,31,2,Matches,2022-2023,La-Liga
Moises Parra Gutierrez,es ESP,FW,Getafe,20.0,2002.0,0.1,1,0,0,1,0,0,0,,0,0,0,0,0,1,0,0,Matches,2022-2023,La-Liga
Raúl Parra,es ESP,DF,Cádiz,22.0,1999.0,3.4,4,2,4,0,0,4,9,44.4,5,5,3,2,1,5,9,0,Matches,2022-2023,La-Liga
Pascu,es ESP,"DF,FW",Villarreal,19.0,2003.0,0.1,0,0,0,0,0,0,0,,0,0,0,0,0,0,0,0,Matches,2022-2023,La-Liga
Javier Pastore,ar ARG,MF,Elche,33.0,1989.0,0.1,0,0,0,0,0,0,0,,0,0,0,0,0,0,0,0,Matches,2022-2023,La-Liga
Gabriel Paulista,br BRA,DF,Valencia,31.0,1990.0,16.7,17,9,13,4,0,13,19,68.4,6,22,14,8,32,49,79,2,Matches,2022-2023,La-Liga
Alfonso Pedraza,es ESP,DF,Villarreal,26.0,1996.0,18.1,35,26,20,10,5,19,29,65.5,10,19,1,18,18,53,31,0,Matches,2022-2023,La-Liga
Pedri,es ESP,MF,Barcelona,19.0,2002.0,22.0,39,22,15,17,7,13,45,28.9,32,27,0,27,13,52,8,1,Matches,2022-2023,La-Liga
Adrià Pedrosa,es ESP,"DF,MF",Espanyol,24.0,1998.0,2.5,5,1,5,0,0,4,7,57.1,3,1,1,0,5,10,3,0,Matches,2022-2023,La-Liga
Iñaki Peña,es ESP,GK,Barcelona,23.0,1999.0,0.8,0,0,0,0,0,0,0,,0,0,0,0,0,0,0,1,Matches,2022-2023,La-Liga
Rubén Peña,es ESP,"DF,MF",Osasuna,31.0,1991.0,14.2,32,18,10,18,4,20,41,48.8,21,23,8,15,17,49,31,0,Matches,2022-2023,La-Liga
Alberto Perea,es ESP,MF,Cádiz,31.0,1990.0,0.5,2,0,2,0,0,0,0,,0,2,0,2,0,2,0,0,Matches,2022-2023,La-Liga
Ayoze Pérez,es ESP,"FW,MF",Betis,29.0,1993.0,15.4,31,15,9,16,6,10,40,25.0,30,22,0,22,13,44,5,0,Matches,2022-2023,La-Liga
Carles Pérez,es ESP,"MF,FW",Celta Vigo,24.0,1998.0,23.8,39,23,12,17,10,22,66,33.3,44,29,3,26,6,45,9,0,Matches,2022-2023,La-Liga
Francisco Perez,es ESP,"FW,MF",Valencia,19.0,2002.0,1.6,1,1,1,0,0,0,3,0.0,3,0,0,0,0,1,1,0,Matches,2022-2023,La-Liga
Kike Pérez,es ESP,MF,Valladolid,25.0,1997.0,25.6,67,33,30,32,5,25,68,36.8,43,26,7,19,20,87,28,0,Matches,2022-2023,La-Liga
Lucas Pérez,es ESP,FW,Cádiz,33.0,1988.0,7.0,3,2,2,1,0,1,3,33.3,2,2,0,2,1,4,3,0,Matches,2022-2023,La-Liga
Luis Pérez,es ESP,DF,Valladolid,27.0,1995.0,13.5,44,24,26,12,6,27,38,71.1,11,13,4,9,16,60,29,0,Matches,2022-2023,La-Liga
Germán Pezzella,ar ARG,DF,Betis,31.0,1991.0,27.9,41,28,32,9,0,26,38,68.4,12,32,15,17,50,91,129,1,Matches,2022-2023,La-Liga
Ronaël Pierre-Gabriel,fr FRA,DF,Espanyol,24.0,1998.0,2.6,17,9,12,4,1,5,11,45.5,6,5,2,3,9,26,11,0,Matches,2022-2023,La-Liga
Yeremi Pino,es ESP,"FW,MF",Villarreal,19.0,2002.0,27.2,62,38,25,20,17,21,56,37.5,35,41,4,37,15,77,36,0,Matches,2022-2023,La-Liga
Gerard Piqué,es ESP,DF,Barcelona,35.0,1987.0,4.3,5,4,1,4,0,4,4,100.0,0,2,1,1,2,7,19,0,Matches,2022-2023,La-Liga
Óscar Plano,es ESP,"FW,MF",Valladolid,31.0,1991.0,22.6,40,25,9,17,14,12,37,32.4,25,26,2,24,29,69,23,0,Matches,2022-2023,La-Liga
Gonzalo Plata,ec ECU,FW,Valladolid,21.0,2000.0,25.6,66,35,31,24,11,23,70,32.9,47,40,0,40,12,78,10,1,Matches,2022-2023,La-Liga
Ezequiel Ponce,ar ARG,"FW,MF",Elche,25.0,1997.0,12.5,9,7,0,6,3,0,7,0.0,7,6,1,5,1,10,13,0,Matches,2022-2023,La-Liga
Francisco Portillo,es ESP,"MF,FW",Almería,32.0,1990.0,8.0,13,6,4,5,4,3,16,18.8,13,7,1,6,7,20,8,0,Matches,2022-2023,La-Liga
Portu,es ESP,"MF,DF",Getafe,30.0,1992.0,19.7,28,21,14,10,4,18,42,42.9,24,23,3,20,17,45,20,1,Matches,2022-2023,La-Liga
José Pozo,es ESP,"MF,FW",Rayo Vallecano,26.0,1996.0,1.0,2,2,0,2,0,0,0,,0,0,0,0,1,3,1,0,Matches,2022-2023,La-Liga
Manuel Pozo,es ESP,FW,Valladolid,20.0,2001.0,0.2,0,0,0,0,0,0,0,,0,2,0,2,2,2,0,0,Matches,2022-2023,La-Liga
Alejandro Pozo Pozo,es ESP,DF,Almería,23.0,1999.0,20.9,37,19,17,17,3,27,53,50.9,26,30,5,25,26,63,45,1,Matches,2022-2023,La-Liga
Abdón Prats,es ESP,"FW,MF",Mallorca,29.0,1992.0,4.6,1,0,1,0,0,0,0,,0,5,0,5,0,1,2,0,Matches,2022-2023,La-Liga
Javi Puado,es ESP,"FW,MF",Espanyol,24.0,1998.0,26.0,20,11,12,5,3,12,28,42.9,16,12,2,10,10,30,14,0,Matches,2022-2023,La-Liga
Arnau Puigmal,es ESP,"MF,FW",Almería,21.0,2001.0,8.5,22,14,10,7,5,12,17,70.6,5,7,0,7,11,33,6,0,Matches,2022-2023,La-Liga
Domingos Quina,pt POR,MF,Elche,22.0,1999.0,3.1,3,2,2,1,0,1,3,33.3,2,5,0,5,3,6,1,0,Matches,2022-2023,La-Liga
Rubén Quintanilla,es ESP,DF,Mallorca,20.0,2002.0,0.0,0,0,0,0,0,0,0,,0,1,0,1,0,0,0,0,Matches,2022-2023,La-Liga
Antonio Raillo,es ESP,DF,Mallorca,30.0,1991.0,30.7,34,21,23,11,0,10,15,66.7,5,38,29,9,31,65,158,1,Matches,2022-2023,La-Liga
Predrag Rajković,rs SRB,GK,Mallorca,26.0,1995.0,36.0,0,0,0,0,0,0,2,0.0,2,0,0,0,0,0,16,1,Matches,2022-2023,La-Liga
Ivan Rakitić,hr CRO,MF,Sevilla,34.0,1988.0,19.9,37,26,10,18,9,19,40,47.5,21,21,1,20,27,64,20,0,Matches,2022-2023,La-Liga
Largie Ramazani,be BEL,"FW,MF",Almería,21.0,2001.0,15.6,15,9,6,3,6,8,27,29.6,19,11,0,11,15,30,10,0,Matches,2022-2023,La-Liga
Chris Ramos,es ESP,FW,Cádiz,25.0,1997.0,7.9,12,9,2,7,3,4,11,36.4,7,8,3,5,1,13,19,0,Matches,2022-2023,La-Liga
Raphinha,br BRA,FW,Barcelona,25.0,1996.0,23.0,29,19,10,7,12,11,31,35.5,20,33,1,32,14,43,11,1,Matches,2022-2023,La-Liga
Sergio Reguilón,es ESP,DF,Atlético Madrid,25.0,1996.0,3.4,7,5,5,2,0,5,7,71.4,2,3,0,3,2,9,4,0,Matches,2022-2023,La-Liga
Pepe Reina,es ESP,GK,Villarreal,39.0,1982.0,22.0,0,0,0,0,0,0,1,0.0,1,0,0,0,1,1,4,4,Matches,2022-2023,La-Liga
Reinier,br BRA,"MF,FW",Girona,20.0,2002.0,7.2,12,10,7,3,2,2,8,25.0,6,6,0,6,5,17,4,0,Matches,2022-2023,La-Liga
Karim Rekik,nl NED,DF,Sevilla,27.0,1994.0,13.1,11,5,8,3,0,4,5,80.0,1,12,5,7,10,21,24,0,Matches,2022-2023,La-Liga
Álex Remiro,es ESP,GK,Real Sociedad,27.0,1995.0,38.0,1,1,1,0,0,1,3,33.3,2,0,0,0,0,1,17,3,Matches,2022-2023,La-Liga
Alejandro Revuelta Montero,es ESP,DF,Getafe,22.0,2000.0,0.0,0,0,0,0,0,0,0,,0,0,0,0,0,0,1,0,Matches,2022-2023,La-Liga
Chadi Riad,ma MAR,MF,Barcelona,19.0,2003.0,0.0,0,0,0,0,0,0,0,,0,0,0,0,0,0,0,0,Matches,2022-2023,La-Liga
Nico Ribaudo,es ESP,"MF,FW",Espanyol,21.0,2001.0,13.9,18,13,5,9,4,11,30,36.7,19,19,1,18,5,23,1,0,Matches,2022-2023,La-Liga
Diego Rico,es ESP,DF,Real Sociedad,29.0,1993.0,18.3,35,21,17,11,7,12,27,44.4,15,18,5,13,20,55,51,1,Matches,2022-2023,La-Liga
Rodrigo Riquelme,es ESP,"MF,FW",Girona,22.0,2000.0,24.2,20,8,8,8,4,9,35,25.7,26,16,0,16,11,31,5,0,Matches,2022-2023,La-Liga
Sergi Roberto,es ESP,"DF,MF",Barcelona,30.0,1992.0,14.5,22,15,12,6,4,7,18,38.9,11,15,7,8,11,33,16,0,Matches,2022-2023,La-Liga
Lucas Robertone,ar ARG,MF,Almería,25.0,1997.0,31.6,50,28,20,21,9,28,64,43.8,36,45,7,38,46,96,46,1,Matches,2022-2023,La-Liga
Joel Roca,es ESP,"MF,FW",Girona,17.0,2005.0,0.9,2,2,2,0,0,2,5,40.0,3,1,1,0,0,2,1,0,Matches,2022-2023,La-Liga
Enzo Roco,cl CHI,DF,Elche,29.0,1992.0,18.4,33,13,23,10,0,15,24,62.5,9,22,15,7,17,50,63,1,Matches,2022-2023,La-Liga
Rodri,es ESP,"FW,MF",Betis,22.0,2000.0,17.8,16,11,5,9,2,8,17,47.1,9,10,0,10,13,29,2,0,Matches,2022-2023,La-Liga
Álvaro Rodríguez,uy URU,FW,Real Madrid,18.0,2004.0,0.9,2,1,1,0,1,1,1,100.0,0,0,0,0,0,2,1,0,Matches,2022-2023,La-Liga
Ángel Rodríguez,es ESP,"FW,MF",Mallorca,35.0,1987.0,4.4,1,1,0,1,0,0,2,0.0,2,3,0,3,1,2,1,0,Matches,2022-2023,La-Liga
Óscar Rodríguez Arnaiz,es ESP,MF,Celta Vigo,24.0,1998.0,19.7,32,25,12,15,5,13,28,46.4,15,16,2,14,24,56,15,0,Matches,2022-2023,La-Liga
Dani Rodríguez,es ESP,MF,Mallorca,34.0,1988.0,23.3,42,23,18,22,2,21,46,45.7,25,31,8,23,21,63,14,0,Matches,2022-2023,La-Liga
Guido Rodríguez,ar ARG,MF,Betis,28.0,1994.0,31.9,115,75,59,50,6,54,101,53.5,47,58,14,44,42,157,76,1,Matches,2022-2023,La-Liga
Miguel Rodríguez,es ESP,"MF,FW",Celta Vigo,19.0,2003.0,2.8,7,5,4,3,0,4,11,36.4,7,6,0,6,1,8,3,0,Matches,2022-2023,La-Liga
Rodrygo,br BRA,"FW,MF",Real Madrid,21.0,2001.0,26.4,17,10,3,7,7,4,23,17.4,19,23,0,23,8,25,5,0,Matches,2022-2023,La-Liga
Leo Román,es ESP,GK,Mallorca,22.0,2000.0,1.0,0,0,0,0,0,0,0,,0,0,0,0,0,0,0,0,Matches,2022-2023,La-Liga
Iván Romero,es ESP,MF,Sevilla,21.0,2001.0,0.1,0,0,0,0,0,0,0,,0,0,0,0,0,0,0,0,Matches,2022-2023,La-Liga
Oriol Romeu,es ESP,MF,Girona,30.0,1991.0,32.8,70,38,36,26,8,26,51,51.0,25,48,10,38,37,107,54,0,Matches,2022-2023,La-Liga
Rubén,es ESP,"DF,MF",Espanyol,21.0,2001.0,9.9,30,15,18,9,3,20,29,69.0,9,14,4,10,18,48,18,0,Matches,2022-2023,La-Liga
Antonio Rüdiger,de GER,DF,Real Madrid,29.0,1993.0,26.8,18,16,12,5,1,14,23,60.9,9,23,13,10,19,37,74,0,Matches,2022-2023,La-Liga
Aitor Ruibal,es ESP,"DF,FW",Betis,26.0,1996.0,16.2,47,29,35,9,3,31,58,53.4,27,17,2,15,24,71,41,0,Matches,2022-2023,La-Liga
Víctor Ruiz,es ESP,DF,Betis,33.0,1989.0,6.2,5,3,3,2,0,3,3,100.0,0,10,7,3,6,11,34,0,Matches,2022-2023,La-Liga
Gerónimo Rulli,ar ARG,GK,Villarreal,30.0,1992.0,14.0,0,0,0,0,0,0,0,,0,1,0,1,1,1,6,2,Matches,2022-2023,La-Liga
Franco Russo,ar ARG,DF,Mallorca,27.0,1994.0,1.6,2,1,2,0,0,0,1,0.0,1,5,0,5,3,5,5,0,Matches,2022-2023,La-Liga
Youssouf Sabaly,sn SEN,DF,Betis,29.0,1993.0,18.7,45,23,29,14,2,22,33,66.7,11,35,8,27,19,64,52,1,Matches,2022-2023,La-Liga
Umar Sadiq,ng NGA,FW,Almería,25.0,1997.0,2.7,0,0,0,0,0,0,1,0.0,1,2,0,2,0,0,3,0,Matches,2022-2023,La-Liga
Umar Sadiq,ng NGA,FW,Real Sociedad,25.0,1997.0,0.9,1,1,0,0,1,0,1,0.0,1,2,0,2,0,1,0,0,Matches,2022-2023,La-Liga
Samuel Sáiz,es ESP,MF,Girona,31.0,1991.0,2.7,2,2,0,2,0,1,2,50.0,1,3,0,3,0,2,1,1,Matches,2022-2023,La-Liga
Kike Salas,es ESP,DF,Sevilla,20.0,2002.0,4.1,1,1,1,0,0,0,0,,0,4,3,1,5,6,23,0,Matches,2022-2023,La-Liga
Salvi,es ESP,"FW,MF",Rayo Vallecano,31.0,1991.0,5.4,13,8,5,5,3,2,8,25.0,6,0,0,0,2,15,2,0,Matches,2022-2023,La-Liga
Fede San Emeterio,es ESP,MF,Cádiz,25.0,1997.0,20.5,41,22,23,16,2,22,46,47.8,24,34,14,20,17,58,28,0,Matches,2022-2023,La-Liga
Oihan Sancet,es ESP,MF,Athletic Club,22.0,2000.0,28.1,27,16,2,19,6,11,37,29.7,26,10,0,10,4,31,9,1,Matches,2022-2023,La-Liga
Antonio Sánchez,es ESP,"MF,DF",Mallorca,25.0,1997.0,12.0,19,8,13,4,2,10,34,29.4,24,18,0,18,22,41,14,1,Matches,2022-2023,La-Liga
Iván Sánchez,es ESP,"MF,FW",Valladolid,29.0,1992.0,12.8,20,14,8,8,4,10,27,37.0,17,14,1,13,8,28,4,0,Matches,2022-2023,La-Liga
Javi Sánchez,es ESP,DF,Valladolid,25.0,1997.0,26.6,43,26,27,15,1,17,26,65.4,9,32,22,10,46,89,116,0,Matches,2022-2023,La-Liga
Manu Sánchez,es ESP,DF,Osasuna,21.0,2000.0,23.6,51,35,35,9,7,33,63,52.4,30,33,5,28,14,65,51,0,Matches,2022-2023,La-Liga
Esteban Saveljich,me MNE,FW,Rayo Vallecano,31.0,1991.0,0.0,0,0,0,0,0,0,0,,0,0,0,0,0,0,0,0,Matches,2022-2023,La-Liga
Stefan Savić,me MNE,DF,Atlético Madrid,31.0,1991.0,21.6,39,26,29,7,3,26,39,66.7,13,17,8,9,33,72,67,2,Matches,2022-2023,La-Liga
Haris Seferović,ch SUI,FW,Celta Vigo,30.0,1992.0,9.9,6,3,1,4,1,3,8,37.5,5,7,1,6,1,7,6,1,Matches,2022-2023,La-Liga
Jaime Seoane,es ESP,"MF,FW",Getafe,25.0,1997.0,3.6,10,4,3,4,3,2,8,25.0,6,7,3,4,1,11,2,0,Matches,2022-2023,La-Liga
David Silva,es ESP,MF,Real Sociedad,36.0,1986.0,21.5,36,21,11,18,7,11,19,57.9,8,17,2,15,15,51,16,0,Matches,2022-2023,La-Liga
Rui Silva,pt POR,GK,Betis,28.0,1994.0,26.0,4,1,4,0,0,4,4,100.0,0,0,0,0,0,4,12,1,Matches,2022-2023,La-Liga
Simo,es ESP,DF,Espanyol,17.0,2005.0,1.6,3,1,3,0,0,2,3,66.7,1,5,4,1,0,3,3,0,Matches,2022-2023,La-Liga
Unai Simón,es ESP,GK,Athletic Club,25.0,1997.0,30.5,2,0,2,0,0,1,1,100.0,0,1,0,1,0,2,9,3,Matches,2022-2023,La-Liga
Rubén Sobrino,es ESP,"MF,FW",Cádiz,30.0,1992.0,27.4,55,37,29,17,9,23,56,41.1,33,33,3,30,24,79,20,1,Matches,2022-2023,La-Liga
Alex Sola,es ESP,DF,Real Sociedad,23.0,1999.0,3.9,18,9,14,3,1,7,10,70.0,3,7,2,5,7,25,10,0,Matches,2022-2023,La-Liga
Augusto Solari,ar ARG,MF,Celta Vigo,30.0,1992.0,2.9,10,6,6,3,1,3,11,27.3,8,5,0,5,4,14,3,0,Matches,2022-2023,La-Liga
Carlos Soler,es ESP,MF,Valencia,25.0,1997.0,2.7,2,0,0,1,1,2,3,66.7,1,1,0,1,0,2,2,0,Matches,2022-2023,La-Liga
David Soria,es ESP,GK,Getafe,29.0,1993.0,38.0,0,0,0,0,0,0,1,0.0,1,0,0,0,1,1,20,4,Matches,2022-2023,La-Liga
Hugo Sotelo,es ESP,MF,Celta Vigo,18.0,2003.0,0.2,0,0,0,0,0,0,0,,0,0,0,0,0,0,0,0,Matches,2022-2023,La-Liga
Dyego Sousa,pt POR,FW,Almería,32.0,1989.0,5.9,10,6,5,4,1,4,5,80.0,1,4,2,2,1,11,14,0,Matches,2022-2023,La-Liga
Vinicius Souza,br BRA,MF,Espanyol,23.0,1999.0,27.0,99,66,41,45,13,33,59,55.9,26,31,14,17,48,147,50,1,Matches,2022-2023,La-Liga
Jørgen Strand Larsen,no NOR,FW,Celta Vigo,22.0,2000.0,18.9,15,7,3,5,7,7,30,23.3,23,14,5,9,3,18,24,0,Matches,2022-2023,La-Liga
Cristhian Stuani,uy URU,FW,Girona,35.0,1986.0,12.1,13,6,2,7,4,5,14,35.7,9,10,0,10,2,15,5,0,Matches,2022-2023,La-Liga
Damián Suárez,uy URU,"DF,MF",Getafe,34.0,1988.0,21.6,49,33,23,19,7,26,48,54.2,22,40,0,40,15,64,36,0,Matches,2022-2023,La-Liga
Denis Suárez,es ESP,"MF,FW",Espanyol,28.0,1994.0,10.5,26,20,12,12,2,13,45,28.9,32,11,1,10,5,31,4,0,Matches,2022-2023,La-Liga
Mario Suárez,es ESP,"MF,DF",Rayo Vallecano,35.0,1987.0,0.1,0,0,0,0,0,0,0,,0,1,0,1,0,0,0,0,Matches,2022-2023,La-Liga
Suso,es ESP,"MF,FW",Sevilla,28.0,1993.0,11.8,16,10,5,7,4,10,22,45.5,12,7,1,6,2,18,3,0,Matches,2022-2023,La-Liga
Williot Swedberg,se SWE,MF,Celta Vigo,18.0,2004.0,0.6,3,1,1,0,2,0,0,,0,2,0,2,0,3,1,0,Matches,2022-2023,La-Liga
Alexander Sørloth,no NOR,FW,Real Sociedad,26.0,1995.0,26.5,18,9,3,6,9,7,14,50.0,7,15,1,14,2,20,26,1,Matches,2022-2023,La-Liga
Renato Tapia,pe PER,"MF,DF",Celta Vigo,27.0,1995.0,16.1,47,25,21,21,5,18,37,48.6,19,29,11,18,19,66,37,0,Matches,2022-2023,La-Liga
Aurélien Tchouaméni,fr FRA,MF,Real Madrid,22.0,2000.0,23.5,64,40,23,36,5,23,38,60.5,15,20,6,14,49,113,50,0,Matches,2022-2023,La-Liga
Alex Telles,br BRA,DF,Sevilla,29.0,1992.0,15.9,21,13,15,6,0,13,25,52.0,12,17,5,12,20,41,38,0,Matches,2022-2023,La-Liga
Marc-André ter Stegen,de GER,GK,Barcelona,30.0,1992.0,37.2,0,0,0,0,0,0,0,,0,0,0,0,1,1,7,3,Matches,2022-2023,La-Liga
Ramón Terrats,es ESP,MF,Villarreal,21.0,2000.0,9.1,15,10,3,8,4,9,17,52.9,8,11,4,7,8,23,6,2,Matches,2022-2023,La-Liga
Ramón Terrats,es ESP,MF,Girona,21.0,2000.0,2.4,4,2,1,3,0,2,6,33.3,4,6,2,4,3,7,3,1,Matches,2022-2023,La-Liga
Raúl de Tomás,es ESP,FW,Rayo Vallecano,27.0,1994.0,8.9,3,2,0,1,2,2,6,33.3,4,4,0,4,0,3,6,0,Matches,2022-2023,La-Liga
Pablo Torre,es ESP,"FW,MF",Barcelona,19.0,2003.0,1.6,2,1,0,1,1,2,4,50.0,2,1,0,1,2,4,1,0,Matches,2022-2023,La-Liga
David Torres,es ESP,DF,Valladolid,19.0,2003.0,4.3,1,1,0,1,0,1,1,100.0,0,4,2,2,3,4,8,0,Matches,2022-2023,La-Liga
Ferrán Torres,es ESP,"FW,MF",Barcelona,22.0,2000.0,15.5,13,7,4,5,4,5,20,25.0,15,11,2,9,3,16,5,0,Matches,2022-2023,La-Liga
Óliver Torres,es ESP,"MF,FW",Sevilla,27.0,1994.0,23.7,39,23,12,13,14,18,59,30.5,41,26,5,21,10,49,10,0,Matches,2022-2023,La-Liga
Pau Torres,es ESP,DF,Villarreal,25.0,1997.0,33.9,43,25,25,13,5,23,36,63.9,13,36,27,9,13,56,146,3,Matches,2022-2023,La-Liga
Roberto Torres,es ESP,"FW,MF",Osasuna,33.0,1989.0,0.1,0,0,0,0,0,0,0,,0,0,0,0,0,0,0,0,Matches,2022-2023,La-Liga
Lucas Torró,es ESP,MF,Osasuna,28.0,1994.0,27.5,48,32,28,15,5,18,42,42.9,24,24,3,21,42,90,64,1,Matches,2022-2023,La-Liga
Nabil Touaizi,ma MAR,MF,Espanyol,21.0,2001.0,0.0,0,0,0,0,0,0,0,,0,0,0,0,0,0,0,0,Matches,2022-2023,La-Liga
Óscar Trejo,ar ARG,"MF,FW",Rayo Vallecano,34.0,1988.0,23.8,48,32,12,23,13,9,44,20.5,35,31,3,28,8,56,8,1,Matches,2022-2023,La-Liga
Manu Trigueros,es ESP,MF,Villarreal,30.0,1991.0,9.2,20,14,9,5,6,9,22,40.9,13,9,2,7,5,25,4,0,Matches,2022-2023,La-Liga
Viktor Tsyhankov,ua UKR,MF,Girona,24.0,1997.0,16.5,8,8,5,1,2,1,14,7.1,13,13,2,11,7,15,12,0,Matches,2022-2023,La-Liga
Beñat Turrientes,es ESP,"MF,FW",Real Sociedad,20.0,2002.0,1.2,3,3,3,0,0,1,5,20.0,4,2,0,2,0,3,3,0,Matches,2022-2023,La-Liga
Enes Ünal,tr TUR,FW,Getafe,25.0,1997.0,33.0,26,14,5,19,2,7,25,28.0,18,19,2,17,6,32,35,0,Matches,2022-2023,La-Liga
Oscar Ureña,do DOM,MF,Girona,19.0,2003.0,1.1,4,2,2,2,0,2,3,66.7,1,2,0,2,1,5,0,0,Matches,2022-2023,La-Liga
Óscar Valentín,es ESP,MF,Rayo Vallecano,27.0,1994.0,28.4,92,51,29,50,13,46,121,38.0,75,60,9,51,44,136,30,0,Matches,2022-2023,La-Liga
Martin Valjent,sk SVK,DF,Mallorca,26.0,1995.0,29.5,35,27,22,12,1,19,28,67.9,9,39,21,18,29,64,137,0,Matches,2022-2023,La-Liga
Jesús Vallejo,es ESP,DF,Real Madrid,25.0,1997.0,0.2,0,0,0,0,0,0,0,,0,0,0,0,0,0,0,0,Matches,2022-2023,La-Liga
Manu Vallejo,es ESP,"FW,MF",Girona,25.0,1997.0,2.3,4,1,1,2,1,1,6,16.7,5,2,0,2,1,5,3,0,Matches,2022-2023,La-Liga
Federico Valverde,uy URU,"MF,FW",Real Madrid,24.0,1998.0,27.8,31,20,14,11,6,13,26,50.0,13,31,4,27,17,48,15,0,Matches,2022-2023,La-Liga
Jesus Vazquez,es ESP,"DF,MF",Valencia,19.0,2003.0,3.4,13,8,9,1,3,6,11,54.5,5,4,0,4,1,14,8,0,Matches,2022-2023,La-Liga
Kevin Vázquez,es ESP,"DF,MF",Celta Vigo,29.0,1993.0,4.9,13,8,5,7,1,8,12,66.7,4,4,1,3,2,15,8,0,Matches,2022-2023,La-Liga
Lucas Vázquez,es ESP,DF,Real Madrid,31.0,1991.0,12.7,34,23,22,10,2,20,28,71.4,8,10,0,10,7,41,13,0,Matches,2022-2023,La-Liga
Gabriel Veiga,es ESP,MF,Celta Vigo,20.0,2002.0,25.5,43,19,14,25,4,16,52,30.8,36,30,3,27,21,64,6,0,Matches,2022-2023,La-Liga
Unai Vencedor Paris,es ESP,MF,Athletic Club,21.0,2000.0,2.1,3,1,0,3,0,1,6,16.7,5,5,0,5,1,4,1,0,Matches,2022-2023,La-Liga
Gonzalo Verdú,es ESP,DF,Elche,33.0,1988.0,7.8,10,5,8,2,0,4,8,50.0,4,8,6,2,10,20,33,0,Matches,2022-2023,La-Liga
Mikel Vesga,es ESP,MF,Athletic Club,29.0,1993.0,28.6,57,35,21,31,5,25,68,36.8,43,39,8,31,36,93,39,3,Matches,2022-2023,La-Liga
Aleix Vidal,es ESP,"MF,FW",Espanyol,32.0,1989.0,11.4,11,5,6,3,2,4,22,18.2,18,21,2,19,15,26,14,0,Matches,2022-2023,La-Liga
Nacho Vidal,es ESP,DF,Osasuna,27.0,1995.0,13.9,27,14,16,6,5,17,32,53.1,15,17,4,13,19,46,33,1,Matches,2022-2023,La-Liga
Toni Villa,es ESP,MF,Valladolid,27.0,1995.0,1.0,6,3,2,3,1,4,9,44.4,5,0,0,0,0,6,0,0,Matches,2022-2023,La-Liga
Toni Villa,es ESP,"MF,FW",Girona,27.0,1995.0,9.9,25,18,9,11,5,10,23,43.5,13,8,0,8,8,33,3,0,Matches,2022-2023,La-Liga
Asier Villalibre,es ESP,FW,Athletic Club,24.0,1997.0,1.1,0,0,0,0,0,0,0,,0,0,0,0,0,0,1,0,Matches,2022-2023,La-Liga
Gonzalo Villar,es ESP,MF,Getafe,24.0,1998.0,5.1,10,5,1,6,3,6,14,42.9,8,9,2,7,6,16,5,0,Matches,2022-2023,La-Liga
Iván Villar,es ESP,GK,Celta Vigo,25.0,1997.0,19.0,0,0,0,0,0,0,1,0.0,1,0,0,0,0,0,7,0,Matches,2022-2023,La-Liga
Daniel Vivian,es ESP,DF,Athletic Club,23.0,1999.0,26.4,57,32,36,16,5,36,45,80.0,9,27,14,13,24,81,90,3,Matches,2022-2023,La-Liga
Shon Weissman,il ISR,FW,Valladolid,26.0,1996.0,8.3,2,1,1,1,0,0,4,0.0,4,8,0,8,1,3,7,0,Matches,2022-2023,La-Liga
Axel Werner,ar ARG,GK,Elche,26.0,1996.0,2.0,0,0,0,0,0,0,1,0.0,1,0,0,0,0,0,0,0,Matches,2022-2023,La-Liga
Iñaki Williams,gh GHA,FW,Athletic Club,28.0,1994.0,31.5,22,16,5,14,3,9,24,37.5,15,18,3,15,7,29,34,0,Matches,2022-2023,La-Liga
Nico Williams,es ESP,FW,Athletic Club,20.0,2002.0,29.5,31,16,10,15,6,19,41,46.3,22,40,2,38,8,39,14,1,Matches,2022-2023,La-Liga
Axel Witsel,be BEL,"DF,MF",Atlético Madrid,33.0,1989.0,25.1,36,22,22,11,3,17,31,54.8,14,20,11,9,23,59,76,0,Matches,2022-2023,La-Liga
Lamine Yamal,es ESP,FW,Barcelona,15.0,2007.0,0.1,0,0,0,0,0,0,0,,0,0,0,0,0,0,0,0,Matches,2022-2023,La-Liga
Jawad El Yamiq,ma MAR,DF,Valladolid,30.0,1992.0,17.9,17,11,10,7,0,6,11,54.5,5,27,19,8,37,54,101,0,Matches,2022-2023,La-Liga
Joseba Zaldúa,es ESP,DF,Cádiz,30.0,1992.0,7.1,15,8,10,4,1,7,10,70.0,3,4,2,2,11,26,22,0,Matches,2022-2023,La-Liga
Oier Zarraga,es ESP,MF,Athletic Club,23.0,1999.0,9.5,14,9,5,7,2,8,20,40.0,12,7,0,7,10,24,5,0,Matches,2022-2023,La-Liga
Igor Zubeldia,es ESP,DF,Real Sociedad,25.0,1997.0,28.2,35,18,28,7,0,25,35,71.4,10,23,17,6,21,56,93,0,Matches,2022-2023,La-Liga
Martín Zubimendi,es ESP,MF,Real Sociedad,23.0,1999.0,34.5,59,33,23,30,6,24,45,53.3,21,44,17,27,37,96,55,4,Matches,2022-2023,La-Liga
Nabil Aberdin,fr FRA,DF,Getafe,20.0,2002.0,2.0,0,0,0,0,0,0,1,0.0,1,0,0,0,0,0,4,0,Matches,2023-2024,La-Liga
Abner,br BRA,DF,Betis,23.0,2000.0,15.6,25,19,15,9,1,17,34,50.0,17,23,5,18,15,40,62,0,Matches,2023-2024,La-Liga
Abdel Abqar,ma MAR,DF,Alavés,24.0,1999.0,25.7,35,19,28,5,2,21,35,60.0,14,31,26,5,23,58,115,0,Matches,2023-2024,La-Liga
Marcos Acuña,ar ARG,DF,Sevilla,31.0,1991.0,14.4,33,21,20,12,1,9,14,64.3,5,12,2,10,4,37,25,0,Matches,2023-2024,La-Liga
Julen Agirrezabala,es ESP,GK,Athletic Club,22.0,2000.0,2.6,0,0,0,0,0,0,0,,0,0,0,0,0,0,0,0,Matches,2023-2024,La-Liga
Lucien Agoume,fr FRA,MF,Sevilla,21.0,2002.0,8.6,23,18,7,14,2,9,12,75.0,3,6,1,5,7,30,8,0,Matches,2023-2024,La-Liga
Joseph Aidoo,gh GHA,DF,Celta Vigo,27.0,1995.0,4.5,8,3,6,2,0,4,8,50.0,4,3,1,2,4,12,28,0,Matches,2023-2024,La-Liga
Ilias Akhomach,ma MAR,"MF,FW",Villarreal,19.0,2004.0,16.8,36,21,11,16,9,10,20,50.0,10,10,2,8,13,49,13,0,Matches,2023-2024,La-Liga
Sergio Akieme,es ESP,DF,Almería,25.0,1997.0,18.6,27,15,18,7,2,13,16,81.3,3,14,4,10,10,37,34,0,Matches,2023-2024,La-Liga
Paul Akouokou,ci CIV,MF,Betis,25.0,1997.0,0.3,5,3,0,2,3,3,3,100.0,0,3,1,2,1,6,1,0,Matches,2023-2024,La-Liga
David Alaba,at AUT,DF,Real Madrid,31.0,1992.0,12.8,13,9,7,5,1,4,8,50.0,4,10,7,3,15,28,34,0,Matches,2023-2024,La-Liga
Raúl Albiol,es ESP,DF,Villarreal,37.0,1985.0,22.6,25,14,15,9,1,18,27,66.7,9,31,24,7,16,41,102,0,Matches,2023-2024,La-Liga
Rubén Alcaraz,es ESP,MF,Cádiz,32.0,1991.0,34.8,97,59,39,52,6,50,121,41.3,71,60,14,46,33,130,55,2,Matches,2023-2024,La-Liga
Omar Alderete,py PAR,DF,Getafe,26.0,1996.0,24.4,28,21,15,13,0,19,35,54.3,16,30,18,12,13,41,111,0,Matches,2023-2024,La-Liga
Iván Alejo,es ESP,MF,Cádiz,28.0,1995.0,18.8,40,23,23,11,6,17,57,29.8,40,20,0,20,7,47,17,0,Matches,2023-2024,La-Liga
Carles Aleñá,es ESP,MF,Getafe,25.0,1998.0,11.3,24,8,7,14,3,10,24,41.7,14,14,3,11,4,28,13,0,Matches,2023-2024,La-Liga
Mohamed Ali Cho,fr FRA,"FW,MF",Real Sociedad,19.0,2004.0,2.8,4,3,3,1,0,2,7,28.6,5,6,0,6,1,5,1,0,Matches,2023-2024,La-Liga
Tadeo Allende,ar ARG,"MF,FW",Celta Vigo,24.0,1999.0,3.7,6,1,3,2,1,4,6,66.7,2,3,0,3,3,9,3,0,Matches,2023-2024,La-Liga
Domingos André Ribeiro Almeida,pt POR,"FW,MF",Valencia,23.0,2000.0,10.7,25,15,9,12,4,9,19,47.4,10,13,1,12,6,31,5,0,Matches,2023-2024,La-Liga
Marcos Alonso,es ESP,DF,Barcelona,32.0,1990.0,2.8,5,3,2,3,0,3,4,75.0,1,2,0,2,4,9,6,0,Matches,2023-2024,La-Liga
Adrià Altimira,es ESP,"DF,MF",Villarreal,22.0,2001.0,8.6,16,7,9,6,1,9,24,37.5,15,18,5,13,5,21,18,0,Matches,2023-2024,La-Liga
Sergi Altimira,es ESP,MF,Betis,21.0,2001.0,6.3,15,8,8,6,1,11,23,47.8,12,12,1,11,9,24,10,0,Matches,2023-2024,La-Liga
Gastón Álvarez,uy URU,DF,Getafe,23.0,2000.0,28.2,68,37,43,20,5,37,57,64.9,20,40,11,29,35,103,80,0,Matches,2023-2024,La-Liga
Hugo Álvarez,es ESP,"MF,DF",Celta Vigo,20.0,2003.0,8.5,14,9,8,3,3,9,20,45.0,11,4,1,3,5,19,9,0,Matches,2023-2024,La-Liga
Yeray Álvarez,es ESP,DF,Athletic Club,28.0,1995.0,12.8,18,9,15,3,0,12,19,63.2,7,8,5,3,11,29,34,1,Matches,2023-2024,La-Liga
Selim Amallah,ma MAR,"FW,MF",Valencia,26.0,1996.0,6.7,17,12,7,7,3,3,9,33.3,6,13,0,13,11,28,6,0,Matches,2023-2024,La-Liga
Amath,sn SEN,"FW,MF",Mallorca,27.0,1996.0,4.4,9,6,7,2,0,2,10,20.0,8,2,0,2,3,12,6,0,Matches,2023-2024,La-Liga
Miguel Ángel Rubio,es ESP,DF,Granada,25.0,1998.0,17.3,20,12,14,6,0,14,21,66.7,7,31,18,13,28,48,74,2,Matches,2023-2024,La-Liga
Fabrizio Angileri,ar ARG,"DF,MF",Getafe,29.0,1994.0,1.8,1,1,1,0,0,1,3,33.3,2,0,0,0,4,5,8,0,Matches,2023-2024,La-Liga
Mauro Arambarri,uy URU,MF,Getafe,27.0,1995.0,3.8,6,2,3,2,1,1,6,16.7,5,1,0,1,2,8,7,0,Matches,2023-2024,La-Liga
Jon Aramburu,ve VEN,DF,Real Sociedad,21.0,2002.0,6.0,24,15,12,10,2,15,25,60.0,10,8,3,5,7,31,17,0,Matches,2023-2024,La-Liga
Julian Araujo,mx MEX,DF,Las Palmas,21.0,2001.0,16.2,41,22,29,7,5,23,33,69.7,10,23,16,7,10,51,52,1,Matches,2023-2024,La-Liga
Ronald Araújo,uy URU,DF,Barcelona,24.0,1999.0,22.2,27,22,11,15,1,12,17,70.6,5,20,11,9,12,39,66,2,Matches,2023-2024,La-Liga
Adu Ares,es ESP,FW,Athletic Club,21.0,2001.0,2.9,8,4,4,2,2,2,3,66.7,1,1,0,1,1,9,0,0,Matches,2023-2024,La-Liga
Jesús Areso,es ESP,DF,Osasuna,24.0,1999.0,29.6,45,24,25,13,7,31,38,81.6,7,36,15,21,18,63,58,0,Matches,2023-2024,La-Liga
Matias Arezo,uy URU,FW,Granada,20.0,2002.0,4.1,7,3,2,5,0,1,5,20.0,4,4,1,3,1,8,4,0,Matches,2023-2024,La-Liga
Iñigo Arguibide,es ESP,DF,Osasuna,18.0,2005.0,0.2,1,0,0,1,0,0,0,,0,0,0,0,0,1,1,0,Matches,2023-2024,La-Liga
José Arnaiz,es ESP,"FW,MF",Osasuna,28.0,1995.0,10.3,14,8,6,4,4,6,21,28.6,15,11,2,9,3,17,2,0,Matches,2023-2024,La-Liga
Sergio Arribas,es ESP,"MF,FW",Almería,21.0,2001.0,22.7,34,17,16,17,1,14,31,45.2,17,20,1,19,16,50,8,1,Matches,2023-2024,La-Liga
Kepa Arrizabalaga,es ESP,GK,Real Madrid,28.0,1994.0,13.3,0,0,0,0,0,0,1,0.0,1,0,0,0,0,0,4,0,Matches,2023-2024,La-Liga
Iago Aspas,es ESP,FW,Celta Vigo,35.0,1987.0,30.1,11,6,4,6,1,1,15,6.7,14,23,3,20,10,21,8,0,Matches,2023-2024,La-Liga
Ezequiel Ávila,ar ARG,"FW,MF",Osasuna,29.0,1994.0,9.6,3,2,1,1,1,3,11,27.3,8,14,0,14,4,7,8,0,Matches,2023-2024,La-Liga
Ezequiel Ávila,ar ARG,FW,Betis,29.0,1994.0,3.3,2,1,0,2,0,1,3,33.3,2,2,0,2,1,3,4,0,Matches,2023-2024,La-Liga
César Azpilicueta,es ESP,DF,Atlético Madrid,33.0,1989.0,15.8,25,14,15,9,1,12,19,63.2,7,25,6,19,16,41,46,0,Matches,2023-2024,La-Liga
Iddrisu Baba,gh GHA,MF,Almería,27.0,1996.0,15.9,46,26,27,18,1,17,39,43.6,22,20,6,14,11,57,27,2,Matches,2023-2024,La-Liga
Srđan Babić,rs SRB,DF,Almería,27.0,1996.0,1.0,2,2,0,2,0,1,1,100.0,0,1,1,0,0,2,2,0,Matches,2023-2024,La-Liga
Loïc Bade,fr FRA,DF,Sevilla,23.0,2000.0,25.3,65,41,53,12,0,30,49,61.2,19,23,15,8,38,103,116,2,Matches,2023-2024,La-Liga
Alex Baena,es ESP,"MF,FW",Villarreal,22.0,2001.0,28.7,34,21,10,16,8,20,47,42.6,27,23,2,21,13,47,17,1,Matches,2023-2024,La-Liga
Eric Bailly,ci CIV,DF,Villarreal,29.0,1994.0,9.3,5,3,4,1,0,2,2,100.0,0,8,8,0,9,14,38,2,Matches,2023-2024,La-Liga
Cédric Bakambu,cd COD,FW,Betis,32.0,1991.0,2.2,1,0,0,1,0,0,0,,0,2,0,2,0,1,0,0,Matches,2023-2024,La-Liga
Alejandro Balde,es ESP,DF,Barcelona,19.0,2003.0,15.3,20,11,11,6,3,7,11,63.6,4,14,1,13,5,25,21,1,Matches,2023-2024,La-Liga
Iván Balliu,al ALB,DF,Rayo Vallecano,31.0,1992.0,31.9,44,31,20,24,0,22,39,56.4,17,27,11,16,29,73,66,1,Matches,2023-2024,La-Liga
Jonathan Bamba,ci CIV,"MF,FW",Celta Vigo,27.0,1996.0,22.0,14,9,4,8,2,2,17,11.8,15,20,0,20,18,32,12,0,Matches,2023-2024,La-Liga
Léo Baptistão,br BRA,FW,Almería,30.0,1992.0,20.4,25,16,12,8,5,9,25,36.0,16,13,1,12,11,36,22,0,Matches,2023-2024,La-Liga
Kike Barja,es ESP,"FW,MF",Osasuna,26.0,1997.0,3.4,6,2,2,2,2,3,8,37.5,5,2,1,1,2,8,2,0,Matches,2023-2024,La-Liga
Ander Barrenetxea,es ESP,"FW,MF",Real Sociedad,21.0,2001.0,15.9,32,21,7,16,9,10,26,38.5,16,18,1,17,6,38,5,0,Matches,2023-2024,La-Liga
Pablo Barrios,es ESP,MF,Atlético Madrid,20.0,2003.0,17.3,45,25,15,29,1,19,40,47.5,21,20,3,17,28,73,24,2,Matches,2023-2024,La-Liga
Marc Bartra,es ESP,DF,Betis,32.0,1991.0,2.5,4,3,3,1,0,4,5,80.0,1,3,1,2,3,7,10,0,Matches,2023-2024,La-Liga
Augusto Batalla,ar ARG,GK,Granada,27.0,1996.0,17.0,0,0,0,0,0,0,1,0.0,1,0,0,0,0,0,10,2,Matches,2023-2024,La-Liga
Bebé,cv CPV,"MF,FW",Rayo Vallecano,33.0,1990.0,2.4,2,2,1,1,0,1,5,20.0,4,1,0,1,0,2,0,0,Matches,2023-2024,La-Liga
Sheraldo Becker,sr SUR,"FW,MF",Real Sociedad,28.0,1995.0,8.6,2,2,0,2,0,0,1,0.0,1,3,0,3,1,3,0,0,Matches,2023-2024,La-Liga
Héctor Bellerín,es ESP,DF,Betis,28.0,1995.0,19.0,34,22,14,16,4,20,53,37.7,33,13,5,8,22,56,40,1,Matches,2023-2024,La-Liga
Jude Bellingham,eng ENG,MF,Real Madrid,20.0,2003.0,25.7,42,34,14,18,10,12,36,33.3,24,55,5,50,21,63,17,0,Matches,2023-2024,La-Liga
Fran Beltrán,es ESP,MF,Celta Vigo,24.0,1999.0,27.0,56,32,22,23,11,24,63,38.1,39,28,2,26,18,74,34,0,Matches,2023-2024,La-Liga
Carlos Benavídez,uy URU,MF,Alavés,25.0,1998.0,12.6,56,35,19,26,11,19,34,55.9,15,13,5,8,19,75,31,0,Matches,2023-2024,La-Liga
Yuri Berchiche,es ESP,DF,Athletic Club,33.0,1990.0,21.4,33,25,13,14,6,19,33,57.6,14,28,9,19,20,53,62,0,Matches,2023-2024,La-Liga
Álex Berenguer,es ESP,FW,Athletic Club,28.0,1995.0,17.7,23,14,9,9,5,7,24,29.2,17,23,0,23,5,28,13,0,Matches,2023-2024,La-Liga
Antonio Blanco,es ESP,MF,Alavés,23.0,2000.0,27.0,61,36,29,27,5,31,86,36.0,55,25,2,23,35,96,30,0,Matches,2023-2024,La-Liga
Daley Blind,nl NED,DF,Girona,33.0,1990.0,33.0,47,21,33,13,1,29,47,61.7,18,37,19,18,21,68,113,0,Matches,2023-2024,La-Liga
Adri Bosch,es ESP,DF,Granada,22.0,2001.0,0.3,1,1,1,0,0,0,0,,0,0,0,0,0,1,1,0,Matches,2023-2024,La-Liga
Yassine Bounou,ma MAR,GK,Sevilla,32.0,1991.0,1.0,0,0,0,0,0,0,0,,0,0,0,0,0,0,0,0,Matches,2023-2024,La-Liga
Lucas Boyé,ar ARG,FW,Granada,27.0,1996.0,28.2,50,25,14,25,11,14,34,41.2,20,35,5,30,10,60,46,0,Matches,2023-2024,La-Liga
Darko Brašanac,rs SRB,MF,Osasuna,31.0,1992.0,0.5,1,0,1,0,0,1,1,100.0,0,1,0,1,0,1,0,0,Matches,2023-2024,La-Liga
Brau,es ESP,DF,Granada,21.0,2001.0,0.3,1,0,1,0,0,1,1,100.0,0,0,0,0,0,1,2,0,Matches,2023-2024,La-Liga
Claudio Bravo,cl CHI,GK,Betis,40.0,1983.0,7.0,0,0,0,0,0,0,1,0.0,1,0,0,0,0,0,2,0,Matches,2023-2024,La-Liga
Ben Brereton,cl CHI,"FW,MF",Villarreal,24.0,1999.0,3.0,2,2,1,0,1,0,2,0.0,2,0,0,0,0,2,0,0,Matches,2023-2024,La-Liga
Ante Budimir,hr CRO,FW,Osasuna,32.0,1991.0,27.1,21,15,2,11,8,5,14,35.7,9,19,5,14,5,26,18,0,Matches,2023-2024,La-Liga
Manu Bueno,es ESP,MF,Sevilla,19.0,2004.0,1.3,4,2,4,0,0,3,3,100.0,0,3,0,3,0,4,1,0,Matches,2023-2024,La-Liga
Pablo Busto,es ESP,DF,Betis,17.0,2005.0,0.5,1,1,0,0,1,1,1,100.0,0,0,0,0,1,2,3,0,Matches,2023-2024,La-Liga
José Callejón,es ESP,"MF,FW",Granada,36.0,1987.0,8.9,13,6,10,3,0,8,22,36.4,14,7,1,6,5,18,10,0,Matches,2023-2024,La-Liga
Eduardo Camavinga,fr FRA,"MF,DF",Real Madrid,20.0,2002.0,20.2,76,47,39,29,8,23,39,59.0,16,36,8,28,29,105,29,1,Matches,2023-2024,La-Liga
Sergio Camello,es ESP,FW,Rayo Vallecano,22.0,2001.0,18.5,16,5,3,10,3,6,15,40.0,9,10,2,8,3,19,15,0,Matches,2023-2024,La-Liga
José Campaña,es ESP,MF,Las Palmas,30.0,1993.0,1.9,2,2,1,1,0,0,2,0.0,2,3,2,1,2,4,3,0,Matches,2023-2024,La-Liga
João Cancelo,pt POR,DF,Barcelona,29.0,1994.0,27.8,64,44,35,21,8,38,58,65.5,20,35,6,29,29,93,59,1,Matches,2023-2024,La-Liga
Sergi Canós,es ESP,"MF,FW",Valencia,26.0,1997.0,13.7,23,13,7,11,5,10,24,41.7,14,14,2,12,11,34,9,0,Matches,2023-2024,La-Liga
Étienne Capoue,fr FRA,MF,Villarreal,35.0,1988.0,16.2,32,18,17,12,3,15,22,68.2,7,20,4,16,22,54,24,1,Matches,2023-2024,La-Liga
Isaac Carcelen,es ESP,DF,Cádiz,30.0,1993.0,29.0,50,31,30,15,5,25,45,55.6,20,24,7,17,27,77,87,2,Matches,2023-2024,La-Liga
Cárdenas,es ESP,GK,Rayo Vallecano,26.0,1997.0,1.0,0,0,0,0,0,0,0,,0,0,0,0,0,0,1,0,Matches,2023-2024,La-Liga
Marc Cardona,es ESP,FW,Las Palmas,28.0,1995.0,8.2,9,8,3,4,2,1,12,8.3,11,5,0,5,2,11,7,0,Matches,2023-2024,La-Liga
Sergi Cardona,es ESP,DF,Las Palmas,24.0,1999.0,31.3,90,55,52,29,9,55,96,57.3,41,45,7,38,46,136,102,0,Matches,2023-2024,La-Liga
Johnny Cardoso,us USA,MF,Betis,21.0,2001.0,14.8,48,29,19,24,5,22,33,66.7,11,20,5,15,32,80,31,0,Matches,2023-2024,La-Liga
Carmona,es ESP,"DF,MF",Getafe,21.0,2002.0,14.6,30,21,13,14,3,9,28,32.1,19,15,2,13,21,51,25,0,Matches,2023-2024,La-Liga
Yannick Carrasco,be BEL,DF,Atlético Madrid,29.0,1993.0,2.5,4,4,3,1,0,2,7,28.6,5,2,0,2,1,5,6,0,Matches,2023-2024,La-Liga
Álvaro Carreras,es ESP,"MF,FW",Granada,20.0,2003.0,5.3,13,8,8,4,1,5,11,45.5,6,5,1,4,7,20,9,1,Matches,2023-2024,La-Liga
Dani Carvajal,es ESP,DF,Real Madrid,31.0,1992.0,24.1,47,32,28,15,4,23,42,54.8,19,28,9,19,22,69,54,4,Matches,2023-2024,La-Liga
William Carvalho,pt POR,MF,Betis,31.0,1992.0,7.6,20,12,11,7,2,10,16,62.5,6,8,1,7,8,28,9,1,Matches,2023-2024,La-Liga
Marc Casado,es ESP,MF,Barcelona,19.0,2003.0,0.2,1,1,1,0,0,1,1,100.0,0,0,0,0,1,2,2,0,Matches,2023-2024,La-Liga
Catena,es ESP,DF,Osasuna,28.0,1994.0,28.2,33,18,26,6,1,19,35,54.3,16,24,15,9,15,48,119,3,Matches,2023-2024,La-Liga
Dani Ceballos,es ESP,"MF,FW",Real Madrid,26.0,1996.0,6.6,10,5,4,5,1,5,14,35.7,9,9,2,7,0,10,4,1,Matches,2023-2024,La-Liga
Álex Centelles,es ESP,DF,Almería,25.0,1997.0,10.9,11,6,9,2,0,8,18,44.4,10,5,2,3,18,29,29,0,Matches,2023-2024,La-Liga
Franco Cervi,ar ARG,"MF,DF",Celta Vigo,29.0,1994.0,6.1,24,18,13,9,2,13,24,54.2,11,16,0,16,9,33,4,0,Matches,2023-2024,La-Liga
Pep Chavarría,es ESP,"DF,MF",Rayo Vallecano,25.0,1998.0,13.0,23,18,15,6,2,11,17,64.7,6,15,3,12,6,29,29,1,Matches,2023-2024,La-Liga
Andreas Christensen,dk DEN,"DF,MF",Barcelona,27.0,1996.0,22.0,23,14,7,14,2,16,28,57.1,12,23,10,13,21,44,41,0,Matches,2023-2024,La-Liga
Chumi,es ESP,DF,Almería,24.0,1999.0,27.0,34,22,22,12,0,16,26,61.5,10,38,23,15,14,48,107,3,Matches,2023-2024,La-Liga
Víctor Chust,es ESP,DF,Cádiz,23.0,2000.0,20.7,29,18,23,5,1,18,32,56.3,14,27,21,6,11,40,92,1,Matches,2023-2024,La-Liga
Pathé Ciss,sn SEN,MF,Rayo Vallecano,29.0,1994.0,18.5,44,24,16,26,2,16,29,55.2,13,27,10,17,30,74,54,0,Matches,2023-2024,La-Liga
Silvi Clúa,es ESP,MF,Girona,18.0,2005.0,0.0,2,0,2,0,0,2,2,100.0,0,1,0,1,0,2,0,0,Matches,2023-2024,La-Liga
Saúl Coco,gq EQG,DF,Las Palmas,24.0,1999.0,25.5,32,19,25,7,0,11,18,61.1,7,27,15,12,20,52,120,3,Matches,2023-2024,La-Liga
Santi Comesaña,es ESP,MF,Villarreal,26.0,1996.0,18.4,44,26,15,21,8,19,38,50.0,19,33,9,24,22,66,27,1,Matches,2023-2024,La-Liga
Copete,es ESP,DF,Mallorca,23.0,1999.0,14.8,45,27,27,17,1,30,43,69.8,13,12,6,6,32,77,47,1,Matches,2023-2024,La-Liga
Francis Coquelin,fr FRA,MF,Villarreal,32.0,1991.0,10.1,20,12,8,10,2,5,13,38.5,8,14,4,10,16,36,15,0,Matches,2023-2024,La-Liga
Theo Corbeanu,ca CAN,"MF,FW",Granada,21.0,2002.0,2.0,5,2,2,3,0,1,3,33.3,2,3,0,3,3,8,2,0,Matches,2023-2024,La-Liga
Jesús Corona,mx MEX,"MF,DF",Sevilla,30.0,1993.0,0.2,0,0,0,0,0,0,0,,0,0,0,0,1,1,0,0,Matches,2023-2024,La-Liga
Ángel Correa,ar ARG,"FW,MF",Atlético Madrid,28.0,1995.0,17.0,22,15,3,11,8,5,17,29.4,12,13,0,13,2,24,6,0,Matches,2023-2024,La-Liga
Thierry Correia,pt POR,DF,Valencia,24.0,1999.0,23.9,63,35,39,20,4,28,49,57.1,21,39,16,23,33,96,61,0,Matches,2023-2024,La-Liga
Jaume Costa,es ESP,DF,Mallorca,35.0,1988.0,18.7,38,22,23,10,5,18,29,62.1,11,14,4,10,16,54,35,0,Matches,2023-2024,La-Liga
Samu Costa,pt POR,MF,Mallorca,22.0,2000.0,25.6,91,50,40,46,5,46,93,49.5,47,28,14,14,39,130,59,3,Matches,2023-2024,La-Liga
Thibaut Courtois,be BEL,GK,Real Madrid,31.0,1992.0,3.7,1,0,1,0,0,0,0,,0,0,0,0,0,1,0,0,Matches,2023-2024,La-Liga
Yan Couto,br BRA,"DF,FW",Girona,21.0,2002.0,24.9,45,34,25,14,6,20,40,50.0,20,14,2,12,10,55,31,1,Matches,2023-2024,La-Liga
Crespo,pt POR,MF,Rayo Vallecano,26.0,1996.0,5.9,16,9,8,6,2,9,17,52.9,8,15,6,9,10,26,7,0,Matches,2023-2024,La-Liga
Cristian,es ESP,GK,Valencia,25.0,1998.0,0.6,0,0,0,0,0,0,0,,0,0,0,0,0,0,0,0,Matches,2023-2024,La-Liga
Juan Cruz Armada,es ESP,DF,Osasuna,31.0,1992.0,18.5,27,15,16,10,1,17,25,68.0,8,14,7,7,12,39,39,1,Matches,2023-2024,La-Liga
Juan Cruz,es ESP,FW,Betis,23.0,2000.0,0.8,0,0,0,0,0,0,1,0.0,1,0,0,0,0,0,0,0,Matches,2023-2024,La-Liga
Pau Cubarsí,es ESP,DF,Barcelona,16.0,2007.0,17.3,22,14,18,3,1,13,18,72.2,5,20,16,4,12,34,65,0,Matches,2023-2024,La-Liga
Iván Cuéllar,es ESP,GK,Mallorca,39.0,1984.0,1.0,0,0,0,0,0,0,0,,0,0,0,0,0,0,0,0,Matches,2023-2024,La-Liga
Jorge Cuenca,es ESP,DF,Villarreal,23.0,1999.0,21.8,42,29,26,10,6,19,30,63.3,11,26,15,11,21,63,114,0,Matches,2023-2024,La-Liga
Eric Curbelo,es ESP,"DF,MF",Las Palmas,29.0,1994.0,1.1,4,3,2,2,0,3,4,75.0,1,3,1,2,2,6,5,1,Matches,2023-2024,La-Liga
Alberto Dadie,es ESP,MF,Real Sociedad,21.0,2002.0,0.3,2,1,2,0,0,0,0,,0,1,0,1,0,2,0,0,Matches,2023-2024,La-Liga
Sergi Darder,es ESP,MF,Mallorca,29.0,1993.0,24.0,39,26,13,21,5,12,31,38.7,19,20,4,16,16,55,16,0,Matches,2023-2024,La-Liga
Rodrigo De Paul,ar ARG,MF,Atlético Madrid,29.0,1994.0,23.1,31,21,11,14,6,15,38,39.5,23,28,1,27,11,42,15,2,Matches,2023-2024,La-Liga
Mouctar Diakhaby,gn GUI,"DF,MF",Valencia,26.0,1996.0,11.9,18,11,9,9,0,11,13,84.6,2,17,7,10,11,29,62,0,Matches,2023-2024,La-Liga
Moussa Diakité,ml MLI,MF,Cádiz,19.0,2003.0,0.0,0,0,0,0,0,0,0,,0,0,0,0,0,0,0,0,Matches,2023-2024,La-Liga
Assane Diao,sn SEN,FW,Betis,17.0,2005.0,11.6,20,12,5,9,6,6,17,35.3,11,22,4,18,7,27,7,0,Matches,2023-2024,La-Liga
Brahim Díaz,ma MAR,"FW,MF",Real Madrid,23.0,1999.0,17.2,29,19,4,16,9,6,13,46.2,7,16,1,15,5,34,2,0,Matches,2023-2024,La-Liga
Víctor Díaz,es ESP,"DF,MF",Granada,35.0,1988.0,1.8,5,3,2,3,0,1,3,33.3,2,1,0,1,1,6,8,0,Matches,2023-2024,La-Liga
Famara Diedhiou,sn SEN,"FW,MF",Granada,30.0,1992.0,1.0,1,1,0,1,0,0,1,0.0,1,0,0,0,0,1,2,0,Matches,2023-2024,La-Liga
Stole Dimitrievski,mk MKD,GK,Rayo Vallecano,29.0,1993.0,37.0,1,1,1,0,0,1,1,100.0,0,0,0,0,0,1,17,3,Matches,2023-2024,La-Liga
Djené,tg TOG,"DF,MF",Getafe,31.0,1991.0,27.6,34,19,18,13,3,15,26,57.7,11,31,15,16,23,57,70,0,Matches,2023-2024,La-Liga
Marko Dmitrović,rs SRB,GK,Sevilla,31.0,1992.0,13.0,1,1,1,0,0,1,2,50.0,1,0,0,0,1,2,5,0,Matches,2023-2024,La-Liga
Jaume Doménech,es ESP,GK,Valencia,32.0,1990.0,0.9,0,0,0,0,0,0,0,,0,0,0,0,0,0,0,0,Matches,2023-2024,La-Liga
Carlos Dominguez,es ESP,DF,Celta Vigo,22.0,2001.0,17.6,33,21,17,9,7,23,37,62.2,14,24,12,12,22,55,78,0,Matches,2023-2024,La-Liga
Mario Dominguez,es ESP,FW,Valencia,19.0,2004.0,0.3,0,0,0,0,0,0,0,,0,0,0,0,0,0,0,0,Matches,2023-2024,La-Liga
Carlos Dotor,es ESP,MF,Celta Vigo,22.0,2001.0,7.9,14,7,3,8,3,4,13,30.8,9,12,2,10,4,18,4,0,Matches,2023-2024,La-Liga
Anastasios Douvikas,gr GRE,FW,Celta Vigo,23.0,1999.0,10.1,15,7,2,6,7,3,8,37.5,5,6,3,3,2,17,9,0,Matches,2023-2024,La-Liga
Artem Dovbyk,ua UKR,FW,Girona,26.0,1997.0,28.7,4,3,2,1,1,0,2,0.0,2,8,1,7,0,4,17,0,Matches,2023-2024,La-Liga
Domingos Duarte,pt POR,DF,Getafe,28.0,1995.0,10.1,7,4,6,0,1,5,7,71.4,2,7,5,2,8,15,27,0,Matches,2023-2024,La-Liga
Rubén Duarte,es ESP,DF,Alavés,27.0,1995.0,20.9,39,20,21,16,2,21,31,67.7,10,21,6,15,23,62,69,0,Matches,2023-2024,La-Liga
Hugo Duro,es ESP,FW,Valencia,23.0,1999.0,33.1,16,8,5,8,3,9,29,31.0,20,24,5,19,5,21,27,0,Matches,2023-2024,La-Liga
Aritz Elustondo,es ESP,DF,Real Sociedad,29.0,1994.0,9.0,11,7,5,4,2,6,14,42.9,8,12,10,2,7,18,26,0,Matches,2023-2024,La-Liga
Adri Embarba,es ESP,"FW,MF",Almería,31.0,1992.0,27.5,55,37,29,15,11,26,53,49.1,27,37,1,36,15,70,12,0,Matches,2023-2024,La-Liga
Youssef En-Nesyri,ma MAR,FW,Sevilla,26.0,1997.0,28.6,10,7,3,4,3,0,10,0.0,10,9,1,8,7,17,29,1,Matches,2023-2024,La-Liga
Gonzalo Escalante,ar ARG,MF,Cádiz,30.0,1993.0,18.9,39,24,16,14,9,20,55,36.4,35,23,5,18,26,65,33,2,Matches,2023-2024,La-Liga
Aarón Escandell,es ESP,GK,Las Palmas,27.0,1995.0,1.7,0,0,0,0,0,0,0,,0,0,0,0,0,0,1,1,Matches,2023-2024,La-Liga
Alfonso Espino,uy URU,DF,Rayo Vallecano,31.0,1992.0,27.9,67,45,43,22,2,30,82,36.6,52,26,4,22,40,107,63,0,Matches,2023-2024,La-Liga
Bernardo Espinosa,co COL,DF,Girona,34.0,1989.0,0.0,1,1,1,0,0,1,1,100.0,0,0,0,0,0,1,2,0,Matches,2023-2024,La-Liga
Karl Etta,cm CMR,FW,Cádiz,19.0,2003.0,0.2,1,1,0,1,0,0,0,,0,0,0,0,0,1,0,0,Matches,2023-2024,La-Liga
Abde Ezzalzouli,ma MAR,"FW,MF",Barcelona,21.0,2001.0,0.8,1,1,0,0,1,0,1,0.0,1,1,0,1,0,1,0,0,Matches,2023-2024,La-Liga
Abde Ezzalzouli,ma MAR,FW,Betis,21.0,2001.0,9.6,17,14,7,5,5,4,14,28.6,10,10,0,10,5,22,5,0,Matches,2023-2024,La-Liga
Radamel Falcao,co COL,"FW,DF",Rayo Vallecano,37.0,1986.0,4.5,7,5,1,5,1,1,3,33.3,2,2,0,2,3,10,4,0,Matches,2023-2024,La-Liga
Fali,es ESP,DF,Cádiz,29.0,1993.0,28.3,41,26,29,11,1,21,36,58.3,15,38,24,14,27,68,120,0,Matches,2023-2024,La-Liga
Ansu Fati,es ESP,"MF,FW",Barcelona,20.0,2002.0,0.6,0,0,0,0,0,0,1,0.0,1,0,0,0,0,0,0,0,Matches,2023-2024,La-Liga
Nabil Fekir,fr FRA,"MF,FW",Betis,30.0,1993.0,11.7,15,10,5,7,3,5,10,50.0,5,9,0,9,7,22,3,0,Matches,2023-2024,La-Liga
Luiz Felipe,it ITA,DF,Betis,26.0,1997.0,4.0,7,3,5,2,0,4,5,80.0,1,10,4,6,4,11,16,0,Matches,2023-2024,La-Liga
João Félix,pt POR,FW,Barcelona,23.0,1999.0,17.1,22,16,9,7,6,8,22,36.4,14,14,1,13,10,32,11,0,Matches,2023-2024,La-Liga
Kiko Femenía,es ESP,DF,Villarreal,32.0,1991.0,17.6,35,25,19,13,3,19,34,55.9,15,21,6,15,31,66,45,0,Matches,2023-2024,La-Liga
Aitor Fernández,es ESP,GK,Osasuna,32.0,1991.0,6.1,0,0,0,0,0,0,1,0.0,1,0,0,0,0,0,5,1,Matches,2023-2024,La-Liga
Álex Fernández,es ESP,MF,Cádiz,30.0,1992.0,14.3,19,9,10,9,0,11,22,50.0,11,17,5,12,15,34,30,0,Matches,2023-2024,La-Liga
Carlos Fernández,es ESP,FW,Real Sociedad,27.0,1996.0,4.5,11,7,3,6,2,0,2,0.0,2,4,0,4,0,11,5,0,Matches,2023-2024,La-Liga
Raúl Fernández,es ESP,GK,Granada,35.0,1988.0,3.1,0,0,0,0,0,0,1,0.0,1,0,0,0,0,0,1,2,Matches,2023-2024,La-Liga
Valery Fernández,es ESP,"MF,FW",Girona,23.0,1999.0,5.6,11,9,4,7,0,6,8,75.0,2,6,1,5,1,12,4,0,Matches,2023-2024,La-Liga
Fernando,es ESP,GK,Almería,33.0,1990.0,4.0,0,0,0,0,0,0,0,,0,1,0,1,0,0,2,0,Matches,2023-2024,La-Liga
Fernando,br BRA,MF,Sevilla,36.0,1987.0,5.1,9,8,2,4,3,5,9,55.6,4,2,0,2,7,16,9,0,Matches,2023-2024,La-Liga
André Ferreira,pt POR,GK,Granada,27.0,1996.0,14.9,0,0,0,0,0,0,1,0.0,1,0,0,0,0,0,9,2,Matches,2023-2024,La-Liga
Rachad Fettal,ma MAR,FW,Almería,18.0,2005.0,0.2,1,1,1,0,0,0,0,,0,0,0,0,0,1,0,0,Matches,2023-2024,La-Liga
Pablo Fornals,es ESP,"FW,MF",Betis,27.0,1996.0,12.8,24,16,8,11,5,12,22,54.5,10,14,0,14,22,46,10,2,Matches,2023-2024,La-Liga
Héctor Fort,es ESP,DF,Barcelona,16.0,2006.0,3.5,6,5,5,1,0,4,10,40.0,6,0,0,0,2,8,4,0,Matches,2023-2024,La-Liga
Dimitri Foulquier,fr FRA,"DF,MF",Valencia,30.0,1993.0,20.5,39,22,22,13,4,18,26,69.2,8,10,1,9,16,55,49,1,Matches,2023-2024,La-Liga
Juan Foyth,ar ARG,DF,Villarreal,25.0,1998.0,11.8,26,15,18,8,0,12,27,44.4,15,17,4,13,12,38,44,0,Matches,2023-2024,La-Liga
Jorge de Frutos,es ESP,"FW,MF",Rayo Vallecano,26.0,1997.0,17.2,19,8,5,8,6,7,22,31.8,15,12,0,12,7,26,18,0,Matches,2023-2024,La-Liga
Daniel Fuzato,br BRA,GK,Getafe,26.0,1997.0,0.1,0,0,0,0,0,0,0,,0,0,0,0,0,0,1,0,Matches,2023-2024,La-Liga
Matteo Gabbia,it ITA,DF,Villarreal,23.0,1999.0,5.3,10,6,4,6,0,5,8,62.5,3,5,2,3,8,18,36,1,Matches,2023-2024,La-Liga
Javi Galán,es ESP,DF,Atlético Madrid,28.0,1994.0,1.0,5,4,2,2,1,4,5,80.0,1,1,0,1,1,6,3,0,Matches,2023-2024,La-Liga
Javi Galán,es ESP,DF,Real Sociedad,28.0,1994.0,11.9,38,22,15,19,4,15,30,50.0,15,24,1,23,14,52,17,1,Matches,2023-2024,La-Liga
Iñigo Ruiz de Galarreta,es ESP,MF,Athletic Club,29.0,1993.0,23.2,49,31,15,26,8,24,49,49.0,25,18,5,13,12,61,17,0,Matches,2023-2024,La-Liga
Aleix García,es ESP,MF,Girona,26.0,1997.0,35.5,49,28,17,26,6,28,54,51.9,26,45,17,28,36,85,53,3,Matches,2023-2024,La-Liga
Álvaro García,es ESP,"FW,MF",Rayo Vallecano,30.0,1992.0,27.5,34,25,15,10,9,7,34,20.6,27,35,0,35,36,70,33,0,Matches,2023-2024,La-Liga
Dani García,es ESP,MF,Athletic Club,33.0,1990.0,8.3,17,11,4,7,6,12,24,50.0,12,9,3,6,8,25,11,0,Matches,2023-2024,La-Liga
David García,es ESP,DF,Osasuna,29.0,1994.0,25.9,29,18,19,9,1,16,26,61.5,10,40,19,21,18,47,115,2,Matches,2023-2024,La-Liga
Eric García,es ESP,DF,Barcelona,22.0,2001.0,0.6,0,0,0,0,0,0,0,,0,1,1,0,0,0,0,0,Matches,2023-2024,La-Liga
Eric García,es ESP,DF,Girona,22.0,2001.0,29.3,55,37,34,18,3,34,49,69.4,15,36,18,18,30,85,79,2,Matches,2023-2024,La-Liga
Fran Garcia,es ESP,DF,Real Madrid,23.0,1999.0,15.5,25,17,11,12,2,13,31,41.9,18,16,3,13,19,44,28,1,Matches,2023-2024,La-Liga
Gonzalo García,es ESP,"FW,MF",Real Madrid,19.0,2004.0,0.2,0,0,0,0,0,0,1,0.0,1,1,1,0,0,0,1,0,Matches,2023-2024,La-Liga
Jastin García,es ESP,FW,Girona,19.0,2004.0,0.4,1,0,0,0,1,0,0,,0,0,0,0,0,1,1,0,Matches,2023-2024,La-Liga
Raúl García,es ESP,"FW,MF",Athletic Club,37.0,1986.0,4.7,9,6,2,4,3,4,9,44.4,5,10,1,9,3,12,9,0,Matches,2023-2024,La-Liga
Rubén García,es ESP,"FW,MF",Osasuna,30.0,1993.0,17.2,32,18,8,17,7,13,33,39.4,20,23,3,20,12,44,23,0,Matches,2023-2024,La-Liga
Santiago García,es ESP,FW,Getafe,21.0,2001.0,0.3,1,0,0,0,1,1,1,100.0,0,0,0,0,0,1,0,0,Matches,2023-2024,La-Liga
Unai García,es ESP,DF,Osasuna,31.0,1992.0,6.2,12,9,9,2,1,5,10,50.0,5,7,1,6,8,20,18,0,Matches,2023-2024,La-Liga
Yarek Gasiorowski,es ESP,DF,Valencia,18.0,2005.0,8.2,22,12,14,5,3,13,19,68.4,6,15,8,7,15,37,50,1,Matches,2023-2024,La-Liga
Federico Gattoni,ar ARG,"DF,FW",Sevilla,24.0,1999.0,0.1,1,0,1,0,0,1,1,100.0,0,0,0,0,0,1,1,0,Matches,2023-2024,La-Liga
Gavi,es ESP,"MF,FW",Barcelona,18.0,2004.0,10.5,39,21,20,14,5,18,36,50.0,18,19,3,16,8,47,16,1,Matches,2023-2024,La-Liga
Paulo Gazzaniga,ar ARG,GK,Girona,31.0,1992.0,38.0,2,2,2,0,0,2,4,50.0,2,0,0,0,0,2,12,1,Matches,2023-2024,La-Liga
David Gil,es ESP,GK,Cádiz,29.0,1994.0,4.1,0,0,0,0,0,0,1,0.0,1,0,0,0,0,0,3,0,Matches,2023-2024,La-Liga
Maxi Gómez,uy URU,FW,Cádiz,26.0,1996.0,12.9,6,4,2,3,1,3,5,60.0,2,8,3,5,3,9,3,0,Matches,2023-2024,La-Liga
Moi Gómez,es ESP,"MF,FW",Osasuna,29.0,1994.0,22.3,30,19,7,19,4,9,24,37.5,15,15,1,14,11,41,22,0,Matches,2023-2024,La-Liga
Unai Gómez,es ESP,MF,Athletic Club,20.0,2003.0,9.7,12,10,2,6,4,5,10,50.0,5,13,2,11,2,14,9,0,Matches,2023-2024,La-Liga
Édgar González,es ESP,"DF,MF",Almería,26.0,1997.0,28.0,45,21,22,20,3,25,49,51.0,24,48,28,20,38,83,130,3,Matches,2023-2024,La-Liga
Fabio González,es ESP,MF,Las Palmas,26.0,1997.0,1.4,2,2,2,0,0,1,2,50.0,1,2,0,2,0,2,0,0,Matches,2023-2024,La-Liga
Giovanni González,uy URU,DF,Mallorca,28.0,1994.0,27.4,73,45,37,32,4,40,81,49.4,41,24,3,21,31,104,60,2,Matches,2023-2024,La-Liga
Hugo González,es ESP,"MF,FW",Valencia,20.0,2003.0,1.0,2,1,0,2,0,0,0,,0,0,0,0,0,2,0,0,Matches,2023-2024,La-Liga
Iñaki González,es ESP,MF,Las Palmas,19.0,2004.0,0.1,1,0,1,0,0,0,0,,0,0,0,0,0,1,1,0,Matches,2023-2024,La-Liga
Peter González,do DOM,"MF,FW",Valencia,21.0,2002.0,7.2,5,3,3,1,1,1,10,10.0,9,11,0,11,7,12,10,0,Matches,2023-2024,La-Liga
Urko González,es ESP,MF,Real Sociedad,22.0,2001.0,1.7,4,1,0,3,1,2,2,100.0,0,1,0,1,1,5,6,0,Matches,2023-2024,La-Liga
Andoni Gorosabel,es ESP,DF,Alavés,26.0,1996.0,31.7,62,42,40,17,5,38,75,50.7,37,24,8,16,28,90,69,0,Matches,2023-2024,La-Liga
Pablo Gozalbez,es ESP,"MF,FW",Valencia,22.0,2001.0,1.1,1,0,0,0,1,1,6,16.7,5,0,0,0,1,2,2,0,Matches,2023-2024,La-Liga
Mason Greenwood,eng ENG,"MF,FW",Getafe,21.0,2001.0,29.6,11,6,3,5,3,4,21,19.0,17,9,0,9,4,15,4,0,Matches,2023-2024,La-Liga
Dominik Greif,sk SVK,GK,Mallorca,26.0,1997.0,1.0,0,0,0,0,0,0,0,,0,0,0,0,0,0,0,0,Matches,2023-2024,La-Liga
Antoine Griezmann,fr FRA,"FW,MF",Atlético Madrid,32.0,1991.0,29.4,33,19,14,14,5,15,41,36.6,26,34,3,31,10,43,23,1,Matches,2023-2024,La-Liga
Vicente Guaita,es ESP,GK,Celta Vigo,36.0,1987.0,26.7,1,1,1,0,0,1,2,50.0,1,0,0,0,0,1,9,1,Matches,2023-2024,La-Liga
Andrés Guardado,mx MEX,MF,Betis,36.0,1986.0,5.0,17,12,5,9,3,7,14,50.0,7,4,2,2,6,23,5,0,Matches,2023-2024,La-Liga
Sergi Guardiola,es ESP,"FW,MF",Cádiz,32.0,1991.0,5.5,10,7,2,6,2,4,9,44.4,5,10,0,10,0,10,4,0,Matches,2023-2024,La-Liga
Nemanja Gudelj,rs SRB,"DF,MF",Sevilla,31.0,1991.0,19.4,31,24,18,10,3,17,31,54.8,14,17,9,8,27,58,56,0,Matches,2023-2024,La-Liga
Gonçalo Guedes,pt POR,"FW,MF",Villarreal,26.0,1996.0,10.6,6,4,1,2,3,2,7,28.6,5,8,0,8,2,8,3,0,Matches,2023-2024,La-Liga
Javier Guerra,es ESP,MF,Valencia,20.0,2003.0,27.8,54,24,25,22,7,22,58,37.9,36,27,7,20,18,72,44,0,Matches,2023-2024,La-Liga
Ander Guevara,es ESP,MF,Alavés,26.0,1997.0,32.6,59,32,28,25,6,31,64,48.4,33,34,12,22,13,72,46,1,Matches,2023-2024,La-Liga
Hugo Guillamón,es ESP,MF,Valencia,23.0,2000.0,14.6,24,15,7,14,3,11,17,64.7,6,8,3,5,12,36,25,2,Matches,2023-2024,La-Liga
Marc Guiu,es ESP,"FW,MF",Barcelona,17.0,2006.0,0.8,1,0,0,1,0,0,0,,0,0,0,0,0,1,0,0,Matches,2023-2024,La-Liga
Arda Güler,tr TUR,"FW,MF",Real Madrid,18.0,2005.0,4.2,6,4,1,3,2,5,8,62.5,3,0,0,0,2,8,5,0,Matches,2023-2024,La-Liga
Gerard Gumbau,es ESP,MF,Granada,28.0,1994.0,29.7,55,34,21,30,4,23,62,37.1,39,24,5,19,25,80,30,2,Matches,2023-2024,La-Liga
İlkay Gündoğan,de GER,MF,Barcelona,32.0,1990.0,33.3,32,22,14,16,2,12,39,30.8,27,19,4,15,21,53,18,1,Matches,2023-2024,La-Liga
Jon Guridi,es ESP,MF,Alavés,28.0,1995.0,29.8,42,24,10,27,5,12,45,26.7,33,23,3,20,22,64,22,0,Matches,2023-2024,La-Liga
Gorka Guruzeta,es ESP,FW,Athletic Club,26.0,1996.0,24.6,34,23,6,25,3,9,30,30.0,21,36,2,34,17,51,23,0,Matches,2023-2024,La-Liga
Miguel Gutiérrez,es ESP,DF,Girona,22.0,2001.0,33.7,29,18,11,14,4,13,35,37.1,22,27,11,16,22,51,66,2,Matches,2023-2024,La-Liga
Munir El Haddadi,ma MAR,FW,Las Palmas,27.0,1995.0,27.2,40,27,18,17,5,17,38,44.7,21,27,1,26,11,51,16,0,Matches,2023-2024,La-Liga
Ianis Hagi,ro ROU,"MF,FW",Alavés,24.0,1998.0,8.9,17,12,2,14,1,5,12,41.7,7,8,0,8,5,22,4,0,Matches,2023-2024,La-Liga
Luiz Henrique,br BRA,FW,Betis,22.0,2001.0,6.8,15,11,4,10,1,9,14,64.3,5,11,0,11,5,20,8,0,Matches,2023-2024,La-Liga
Mario Hermoso,es ESP,DF,Atlético Madrid,28.0,1995.0,28.4,46,25,29,13,4,28,51,54.9,23,27,9,18,30,76,93,0,Matches,2023-2024,La-Liga
Javi Hernández,es ESP,DF,Cádiz,25.0,1998.0,27.9,43,24,26,12,5,25,46,54.3,21,34,9,25,19,62,72,1,Matches,2023-2024,La-Liga
Aridane Hernández,es ESP,DF,Rayo Vallecano,34.0,1989.0,18.8,10,8,5,4,1,4,11,36.4,7,19,14,5,14,24,98,1,Matches,2023-2024,La-Liga
Luis Hernández,es ESP,DF,Cádiz,34.0,1989.0,8.0,7,3,4,3,0,4,8,50.0,4,3,2,1,8,15,25,0,Matches,2023-2024,La-Liga
Jorge Herrando,es ESP,DF,Osasuna,22.0,2001.0,18.3,29,19,23,6,0,12,19,63.2,7,20,11,9,15,44,69,1,Matches,2023-2024,La-Liga
Ander Herrera,es ESP,MF,Athletic Club,33.0,1989.0,11.4,44,32,11,26,7,20,36,55.6,16,16,6,10,15,59,18,1,Matches,2023-2024,La-Liga
Cristian Herrera,es ESP,"FW,MF",Las Palmas,32.0,1991.0,1.8,1,1,0,1,0,1,2,50.0,1,1,0,1,0,1,2,0,Matches,2023-2024,La-Liga
Sergio Herrera,es ESP,GK,Osasuna,30.0,1993.0,31.9,2,2,2,0,0,2,3,66.7,1,0,0,0,0,2,22,3,Matches,2023-2024,La-Liga
Yangel Herrera,ve VEN,MF,Girona,25.0,1998.0,23.4,64,37,28,30,6,30,56,53.6,26,30,8,22,24,88,45,1,Matches,2023-2024,La-Liga
Juan Herzog,es ESP,DF,Las Palmas,20.0,2003.0,3.2,6,5,5,1,0,3,6,50.0,3,4,1,3,2,8,17,0,Matches,2023-2024,La-Liga
Martin Hongla,cm CMR,"MF,DF",Granada,25.0,1998.0,6.2,7,3,2,5,0,3,9,33.3,6,6,3,3,6,13,13,1,Matches,2023-2024,La-Liga
Xabier Huarte Armendáriz,es ESP,MF,Osasuna,22.0,2001.0,0.1,0,0,0,0,0,0,0,,0,0,0,0,0,0,0,0,Matches,2023-2024,La-Liga
Pablo Ibáñez,es ESP,MF,Osasuna,24.0,1998.0,12.8,18,9,5,7,6,5,21,23.8,16,26,3,23,9,27,17,0,Matches,2023-2024,La-Liga
Iglesias,es ESP,"DF,FW",Getafe,25.0,1998.0,15.7,41,22,25,11,5,21,33,63.6,12,18,7,11,16,57,53,0,Matches,2023-2024,La-Liga
Borja Iglesias,es ESP,FW,Betis,30.0,1993.0,4.5,0,0,0,0,0,0,3,0.0,3,0,0,0,2,2,2,0,Matches,2023-2024,La-Liga
Imanol,es ESP,DF,Athletic Club,23.0,2000.0,5.8,7,5,1,5,1,5,18,27.8,13,6,0,6,7,14,15,0,Matches,2023-2024,La-Liga
Isco,es ESP,MF,Betis,31.0,1992.0,25.8,41,27,15,21,5,14,38,36.8,24,19,1,18,10,51,7,0,Matches,2023-2024,La-Liga
Diego Iturralde,es ESP,DF,Sevilla,20.0,2003.0,0.4,0,0,0,0,0,0,0,,0,1,1,0,0,0,2,0,Matches,2023-2024,La-Liga
Adnan Januzaj,be BEL,"FW,MF",Sevilla,28.0,1995.0,2.1,3,3,2,0,1,0,1,0.0,1,2,0,2,1,4,0,0,Matches,2023-2024,La-Liga
Mikel Jauregizar,es ESP,MF,Athletic Club,19.0,2003.0,1.7,0,0,0,0,0,0,6,0.0,6,5,0,5,0,0,2,0,Matches,2023-2024,La-Liga
Luis Javier Suárez,co COL,FW,Almería,25.0,1997.0,10.2,7,5,2,5,0,2,6,33.3,4,11,0,11,0,7,13,0,Matches,2023-2024,La-Liga
Salim El Jebari,ma MAR,MF,Atlético Madrid,19.0,2004.0,0.1,1,0,0,1,0,0,0,,0,0,0,0,0,1,1,0,Matches,2023-2024,La-Liga
Frenkie de Jong,nl NED,MF,Barcelona,26.0,1997.0,18.2,43,26,14,23,6,8,19,42.1,11,18,8,10,14,57,28,1,Matches,2023-2024,La-Liga
Joan Jordán,es ESP,MF,Sevilla,29.0,1994.0,4.2,8,7,3,3,2,7,15,46.7,8,4,2,2,4,12,2,0,Matches,2023-2024,La-Liga
Jordi,es ESP,"MF,DF",Getafe,22.0,2001.0,6.4,16,11,3,11,2,7,15,46.7,8,7,2,5,8,24,7,0,Matches,2023-2024,La-Liga
Jeremy Jorge,es ESP,FW,Getafe,20.0,2003.0,0.0,0,0,0,0,0,0,0,,0,0,0,0,0,0,0,0,Matches,2023-2024,La-Liga
Willian José,br BRA,FW,Betis,31.0,1991.0,21.9,7,3,1,2,4,2,5,40.0,3,8,2,6,2,9,15,0,Matches,2023-2024,La-Liga
Joselu,es ESP,FW,Real Madrid,33.0,1990.0,18.7,6,3,1,4,1,0,7,0.0,7,11,1,10,6,12,11,0,Matches,2023-2024,La-Liga
Kamil Jóźwiak,pl POL,MF,Granada,25.0,1998.0,6.3,13,10,4,6,3,9,17,52.9,8,4,0,4,2,15,6,0,Matches,2023-2024,La-Liga
Juanmi,es ESP,FW,Cádiz,30.0,1993.0,9.7,9,4,2,7,0,2,9,22.2,7,6,0,6,6,15,3,0,Matches,2023-2024,La-Liga
Juanpe,es ESP,DF,Girona,32.0,1991.0,8.3,11,8,8,3,0,9,10,90.0,1,17,11,6,7,18,50,1,Matches,2023-2024,La-Liga
Vinicius Júnior,br BRA,FW,Real Madrid,23.0,2000.0,20.7,18,13,5,5,8,3,12,25.0,9,13,0,13,1,19,3,2,Matches,2023-2024,La-Liga
Filip Jørgensen,dk DEN,GK,Villarreal,21.0,2002.0,36.0,3,1,3,0,0,3,4,75.0,1,0,0,0,2,5,10,3,Matches,2023-2024,La-Liga
Sory Kaba,gn GUI,FW,Las Palmas,28.0,1995.0,8.0,2,0,0,2,0,0,5,0.0,5,6,0,6,0,2,9,0,Matches,2023-2024,La-Liga
Kaiky,br BRA,DF,Almería,19.0,2004.0,5.8,7,4,6,0,1,3,6,50.0,3,9,7,2,3,10,29,1,Matches,2023-2024,La-Liga
Jon Karrikaburu,es ESP,"MF,FW",Alavés,20.0,2002.0,0.2,0,0,0,0,0,0,0,,0,0,0,0,0,0,0,0,Matches,2023-2024,La-Liga
Ibrahima Kebe,ml MLI,MF,Girona,22.0,2000.0,0.1,1,1,0,1,0,0,0,,0,1,0,1,1,2,0,0,Matches,2023-2024,La-Liga
Kiké,es ESP,"FW,MF",Alavés,33.0,1989.0,15.8,8,4,2,3,3,4,9,44.4,5,16,5,11,1,9,12,0,Matches,2023-2024,La-Liga
Koke,es ESP,MF,Atlético Madrid,31.0,1992.0,27.7,66,44,27,32,7,36,79,45.6,43,37,12,25,16,82,34,1,Matches,2023-2024,La-Liga
Ibrahima Koné,ml MLI,FW,Almería,24.0,1999.0,3.1,1,0,1,0,0,1,1,100.0,0,1,0,1,0,1,4,0,Matches,2023-2024,La-Liga
Rominigue Kouamé,ml MLI,MF,Cádiz,26.0,1996.0,9.1,14,9,6,7,1,7,15,46.7,8,10,2,8,13,27,10,1,Matches,2023-2024,La-Liga
Jules Koundé,fr FRA,DF,Barcelona,24.0,1998.0,32.2,37,23,22,10,5,28,51,54.9,23,32,12,20,25,62,83,5,Matches,2023-2024,La-Liga
Toni Kroos,de GER,MF,Real Madrid,33.0,1990.0,23.6,53,34,19,25,9,24,59,40.7,35,22,4,18,17,70,11,1,Matches,2023-2024,La-Liga
Takefusa Kubo,jp JPN,"FW,MF",Real Sociedad,22.0,2001.0,23.9,26,17,15,6,5,9,23,39.1,14,21,2,19,11,37,8,1,Matches,2023-2024,La-Liga
Luca de la Torre,us USA,MF,Celta Vigo,25.0,1998.0,21.7,39,21,12,22,5,22,43,51.2,21,23,4,19,12,51,17,0,Matches,2023-2024,La-Liga
Yoel Lago,es ESP,DF,Celta Vigo,19.0,2004.0,1.0,2,0,2,0,0,0,0,,0,1,0,1,0,2,2,0,Matches,2023-2024,La-Liga
Érik Lamela,ar ARG,"FW,MF",Sevilla,31.0,1992.0,5.1,21,14,4,10,7,10,15,66.7,5,12,0,12,1,22,5,0,Matches,2023-2024,La-Liga
Bruno Langa,mz MOZ,DF,Almería,25.0,1997.0,9.1,17,12,10,5,2,6,14,42.9,8,11,4,7,4,21,33,2,Matches,2023-2024,La-Liga
Cyle Larin,ca CAN,FW,Mallorca,28.0,1995.0,20.3,17,8,6,4,7,2,7,28.6,5,16,5,11,3,20,17,0,Matches,2023-2024,La-Liga
Juanmi Latasa,es ESP,FW,Getafe,22.0,2001.0,17.3,9,7,0,6,3,1,11,9.1,10,9,0,9,4,13,21,0,Matches,2023-2024,La-Liga
Toni Lato,es ESP,DF,Mallorca,25.0,1997.0,17.2,38,23,19,13,6,16,27,59.3,11,17,3,14,17,55,27,0,Matches,2023-2024,La-Liga
Lázaro,br BRA,"FW,MF",Almería,21.0,2002.0,3.2,4,1,2,0,2,2,8,25.0,6,4,0,4,1,5,1,0,Matches,2023-2024,La-Liga
Robin Le Normand,es ESP,DF,Real Sociedad,26.0,1996.0,27.4,31,22,16,15,0,17,30,56.7,13,26,15,11,28,59,96,1,Matches,2023-2024,La-Liga
Jeremías Ledesma,ar ARG,GK,Cádiz,30.0,1993.0,33.9,1,1,1,0,0,1,4,25.0,3,0,0,0,0,1,15,3,Matches,2023-2024,La-Liga
Florian Lejeune,fr FRA,DF,Rayo Vallecano,32.0,1991.0,37.0,39,25,26,11,2,19,30,63.3,11,33,18,15,23,62,155,1,Matches,2023-2024,La-Liga
Stefan Lekovic,rs SRB,DF,Villarreal,19.0,2004.0,0.3,0,0,0,0,0,0,0,,0,1,1,0,0,0,1,0,Matches,2023-2024,La-Liga
Iñigo Lekue,es ESP,DF,Athletic Club,30.0,1993.0,22.2,40,22,25,10,5,27,53,50.9,26,24,6,18,15,55,50,0,Matches,2023-2024,La-Liga
Thomas Lemar,fr FRA,MF,Atlético Madrid,27.0,1995.0,1.8,3,1,2,1,0,1,2,50.0,1,0,0,0,0,3,0,0,Matches,2023-2024,La-Liga
Álvaro Lemos,es ESP,DF,Las Palmas,30.0,1993.0,2.8,4,1,1,3,0,0,2,0.0,2,3,1,2,2,6,4,0,Matches,2023-2024,La-Liga
Ruben Lendinez,es ESP,DF,Valencia,20.0,2003.0,0.1,2,2,0,2,0,1,1,100.0,0,0,0,0,0,2,1,0,Matches,2023-2024,La-Liga
Robert Lewandowski,pl POL,FW,Barcelona,34.0,1988.0,30.6,8,5,0,6,2,4,12,33.3,8,13,4,9,9,17,18,0,Matches,2023-2024,La-Liga
Samuel Lino,br BRA,"DF,MF",Atlético Madrid,23.0,1999.0,23.1,61,34,32,17,12,35,70,50.0,35,37,1,36,14,75,27,0,Matches,2023-2024,La-Liga
Javier Llabrés,es ESP,"MF,FW",Mallorca,20.0,2002.0,2.7,3,1,1,1,1,1,2,50.0,1,1,0,1,3,6,4,0,Matches,2023-2024,La-Liga
Marcos Llorente,es ESP,"MF,DF",Atlético Madrid,28.0,1995.0,28.5,40,23,18,17,5,16,44,36.4,28,36,11,25,14,54,35,0,Matches,2023-2024,La-Liga
Enzo Loiodice,fr FRA,MF,Las Palmas,22.0,2000.0,19.9,62,35,15,34,13,20,42,47.6,22,20,2,18,12,74,16,1,Matches,2023-2024,La-Liga
David López,es ESP,DF,Girona,33.0,1989.0,21.8,33,20,21,12,0,17,22,77.3,5,28,19,9,20,53,63,4,Matches,2023-2024,La-Liga
Diego López,es ESP,"MF,FW",Valencia,21.0,2002.0,29.5,37,25,14,16,7,13,56,23.2,43,23,1,22,20,57,12,0,Matches,2023-2024,La-Liga
Fermin López,es ESP,"MF,FW",Barcelona,20.0,2003.0,16.1,41,21,15,18,8,14,40,35.0,26,14,1,13,4,45,9,0,Matches,2023-2024,La-Liga
Javi López,es ESP,DF,Alavés,21.0,2002.0,26.5,23,12,11,9,3,15,26,57.7,11,25,9,16,10,33,77,1,Matches,2023-2024,La-Liga
Unai López,es ESP,MF,Rayo Vallecano,27.0,1995.0,23.4,48,24,18,23,7,21,53,39.6,32,24,3,21,16,64,15,2,Matches,2023-2024,La-Liga
Dion Lopy,sn SEN,MF,Almería,21.0,2002.0,21.3,62,37,36,20,6,17,44,38.6,27,23,5,18,15,77,22,2,Matches,2023-2024,La-Liga
Anthony Lozano,hn HON,"MF,FW",Getafe,30.0,1993.0,1.0,0,0,0,0,0,0,1,0.0,1,0,0,0,0,0,1,0,Matches,2023-2024,La-Liga
Anthony Lozano,hn HON,FW,Almería,30.0,1993.0,8.6,7,5,2,5,0,4,7,57.1,3,6,1,5,2,9,12,0,Matches,2023-2024,La-Liga
Lucas,br BRA,DF,Cádiz,22.0,2001.0,17.1,47,27,32,11,4,32,55,58.2,23,27,4,23,17,64,45,0,Matches,2023-2024,La-Liga
José Luis Gayà,es ESP,DF,Valencia,28.0,1995.0,19.9,71,36,44,23,4,43,67,64.2,24,18,3,15,11,82,42,0,Matches,2023-2024,La-Liga
José Luis Morales,es ESP,"FW,MF",Villarreal,36.0,1987.0,11.6,5,3,1,4,0,3,13,23.1,10,9,1,8,7,12,4,0,Matches,2023-2024,La-Liga
Dodi Lukebakio,be BEL,"FW,MF",Sevilla,25.0,1997.0,12.5,5,2,2,2,1,1,6,16.7,5,9,2,7,2,7,5,0,Matches,2023-2024,La-Liga
Andriy Lunin,ua UKR,GK,Real Madrid,24.0,1999.0,21.0,0,0,0,0,0,0,1,0.0,1,0,0,0,0,0,15,1,Matches,2023-2024,La-Liga
Darwin Machís,ve VEN,MF,Cádiz,30.0,1993.0,8.7,23,14,7,9,7,13,24,54.2,11,8,1,7,4,27,2,0,Matches,2023-2024,La-Liga
Pablo Maffeo,es ESP,DF,Mallorca,26.0,1997.0,16.2,35,22,18,13,4,23,40,57.5,17,12,2,10,10,45,23,0,Matches,2023-2024,La-Liga
Jon Magunazelaia,es ESP,"FW,MF",Real Sociedad,23.0,2000.0,1.3,5,3,2,3,0,4,8,50.0,4,3,0,3,0,5,2,0,Matches,2023-2024,La-Liga
Nemanja Maksimović,rs SRB,MF,Getafe,28.0,1995.0,36.3,65,43,26,31,8,23,41,56.1,18,56,23,33,46,111,61,0,Matches,2023-2024,La-Liga
Giorgi Mamardashvili,ge GEO,GK,Valencia,22.0,2000.0,36.5,4,3,4,0,0,4,4,100.0,0,1,0,1,2,6,22,2,Matches,2023-2024,La-Liga
Wilson Manafá,pt POR,"DF,MF",Granada,29.0,1994.0,2.7,6,4,3,2,1,4,7,57.1,3,1,0,1,1,7,4,1,Matches,2023-2024,La-Liga
Reinildo Mandava,mz MOZ,DF,Atlético Madrid,29.0,1994.0,8.1,30,22,16,11,3,19,22,86.4,3,10,2,8,15,45,21,0,Matches,2023-2024,La-Liga
Aïssa Mandi,dz ALG,DF,Villarreal,31.0,1991.0,12.4,13,8,8,5,0,7,14,50.0,7,10,7,3,8,21,41,0,Matches,2023-2024,La-Liga
Javier Manquillo,es ESP,"DF,MF",Celta Vigo,29.0,1994.0,8.3,15,11,6,5,4,8,15,53.3,7,14,3,11,3,18,17,0,Matches,2023-2024,La-Liga
Faitout Maouassa,fr FRA,"DF,MF",Granada,25.0,1998.0,2.5,8,5,6,1,1,4,5,80.0,1,6,0,6,1,9,3,0,Matches,2023-2024,La-Liga
Marcão,br BRA,DF,Sevilla,27.0,1996.0,3.9,9,6,5,4,0,6,10,60.0,4,8,6,2,4,13,11,1,Matches,2023-2024,La-Liga
Óscar de Marcos,es ESP,DF,Athletic Club,34.0,1989.0,25.1,56,39,26,24,6,42,71,59.2,29,28,6,22,15,71,44,0,Matches,2023-2024,La-Liga
Alberto Marí,es ESP,FW,Valencia,22.0,2001.0,3.1,4,2,0,1,3,1,1,100.0,0,3,0,3,0,4,5,0,Matches,2023-2024,La-Liga
José Mari,es ESP,"MF,FW",Cádiz,35.0,1987.0,0.2,2,1,0,2,0,1,2,50.0,1,0,0,0,0,2,0,0,Matches,2023-2024,La-Liga
José María Giménez,uy URU,DF,Atlético Madrid,28.0,1995.0,14.7,18,10,10,7,1,5,16,31.3,11,16,12,4,10,28,95,0,Matches,2023-2024,La-Liga
Mariano,do DOM,"FW,MF",Sevilla,29.0,1993.0,2.7,1,1,0,1,0,0,1,0.0,1,1,0,1,0,1,2,0,Matches,2023-2024,La-Liga
Rafa Marín,es ESP,DF,Alavés,21.0,2002.0,27.1,32,20,23,9,0,14,27,51.9,13,34,21,13,33,65,129,2,Matches,2023-2024,La-Liga
Diego Mariño,es ESP,GK,Almería,33.0,1990.0,1.0,0,0,0,0,0,0,0,,0,0,0,0,0,0,1,0,Matches,2023-2024,La-Liga
Mika Mármol,es ESP,DF,Las Palmas,22.0,2001.0,35.3,70,42,44,24,2,35,53,66.0,18,39,19,20,44,114,147,2,Matches,2023-2024,La-Liga
Unai Marrero,es ESP,GK,Real Sociedad,21.0,2001.0,1.6,0,0,0,0,0,0,0,,0,0,0,0,0,0,0,0,Matches,2023-2024,La-Liga
Roger Martí,es ESP,FW,Cádiz,32.0,1991.0,15.1,12,6,1,9,2,2,7,28.6,5,16,1,15,7,19,4,0,Matches,2023-2024,La-Liga
Iván Martín,es ESP,MF,Girona,24.0,1999.0,30.3,44,25,22,15,7,22,57,38.6,35,25,3,22,21,65,14,0,Matches,2023-2024,La-Liga
Jon Martin,es ESP,DF,Real Sociedad,17.0,2006.0,0.3,0,0,0,0,0,0,0,,0,0,0,0,0,0,3,0,Matches,2023-2024,La-Liga
Mario Martín,es ESP,MF,Real Madrid,19.0,2004.0,0.2,5,1,0,2,3,3,4,75.0,1,2,1,1,0,5,0,0,Matches,2023-2024,La-Liga
Arnau Martinez,es ESP,DF,Girona,20.0,2003.0,13.8,25,16,17,6,2,15,32,46.9,17,15,5,10,10,35,41,3,Matches,2023-2024,La-Liga
Iñigo Martínez,es ESP,DF,Barcelona,32.0,1991.0,14.4,10,7,9,1,0,6,8,75.0,2,13,10,3,11,21,50,0,Matches,2023-2024,La-Liga
Marc Martínez,es ESP,GK,Granada,33.0,1990.0,3.0,0,0,0,0,0,0,1,0.0,1,0,0,0,0,0,1,0,Matches,2023-2024,La-Liga
Marvin,es ESP,"FW,DF",Las Palmas,23.0,2000.0,20.6,39,25,18,17,4,18,36,50.0,18,28,2,26,14,53,18,1,Matches,2023-2024,La-Liga
Omar Mascarell,gq EQG,MF,Mallorca,30.0,1993.0,17.5,33,16,16,17,0,18,35,51.4,17,24,8,16,31,64,30,1,Matches,2023-2024,La-Liga
Jaime Mata,es ESP,"FW,MF",Getafe,34.0,1988.0,19.9,24,15,12,8,4,11,26,42.3,15,18,1,17,17,41,31,0,Matches,2023-2024,La-Liga
Luís Maximiano,pt POR,GK,Almería,24.0,1999.0,33.0,0,0,0,0,0,0,1,0.0,1,0,0,0,0,0,19,2,Matches,2023-2024,La-Liga
Borja Mayoral,es ESP,FW,Getafe,26.0,1997.0,23.9,9,5,2,2,5,5,22,22.7,17,7,0,7,4,13,16,0,Matches,2023-2024,La-Liga
Mamadou Mbaye,sn SEN,DF,Cádiz,25.0,1998.0,3.2,6,3,3,3,0,2,5,40.0,3,10,7,3,5,11,26,0,Matches,2023-2024,La-Liga
Hannibal Mejbri,tn TUN,MF,Sevilla,20.0,2003.0,1.2,3,3,1,2,0,0,1,0.0,1,1,0,1,0,3,0,0,Matches,2023-2024,La-Liga
Óscar Melendo,es ESP,"MF,FW",Granada,25.0,1997.0,12.5,14,6,4,10,0,4,12,33.3,8,13,0,13,5,19,4,1,Matches,2023-2024,La-Liga
Gonzalo Melero,es ESP,"MF,FW",Almería,29.0,1994.0,12.3,14,8,7,5,2,7,19,36.8,12,12,4,8,4,18,11,0,Matches,2023-2024,La-Liga
Memphis,nl NED,FW,Atlético Madrid,29.0,1994.0,9.9,5,2,0,3,2,3,6,50.0,3,2,0,2,1,6,0,0,Matches,2023-2024,La-Liga
Houboulang Mendes,gw GNB,DF,Almería,25.0,1998.0,4.4,16,13,11,5,0,8,16,50.0,8,4,2,2,1,17,17,1,Matches,2023-2024,La-Liga
Tomás Mendes,es ESP,MF,Alavés,18.0,2004.0,0.1,0,0,0,0,0,0,0,,0,0,0,0,0,0,0,0,Matches,2023-2024,La-Liga
Brais Méndez,es ESP,"MF,FW",Real Sociedad,26.0,1997.0,26.8,42,28,13,20,9,15,43,34.9,28,23,4,19,12,54,21,0,Matches,2023-2024,La-Liga
Bruno Méndez,uy URU,DF,Granada,23.0,1999.0,14.8,36,17,19,12,5,21,37,56.8,16,24,6,18,26,62,45,0,Matches,2023-2024,La-Liga
Diego Méndez,es ESP,MF,Rayo Vallecano,19.0,2003.0,0.1,1,1,1,0,0,1,1,100.0,0,0,0,0,1,2,0,0,Matches,2023-2024,La-Liga
Ferland Mendy,fr FRA,DF,Real Madrid,28.0,1995.0,19.1,15,10,12,2,1,11,14,78.6,3,12,2,10,13,28,26,1,Matches,2023-2024,La-Liga
Jorge Meré,es ESP,DF,Cádiz,26.0,1997.0,7.5,8,7,6,2,0,4,7,57.1,3,5,3,2,8,16,33,0,Matches,2023-2024,La-Liga
Mikel Merino,es ESP,MF,Real Sociedad,27.0,1996.0,27.6,77,43,25,34,18,22,48,45.8,26,36,11,25,16,93,55,3,Matches,2023-2024,La-Liga
Omenuke Mfulu,cd COD,"MF,FW",Las Palmas,29.0,1994.0,0.9,4,3,3,1,0,0,1,0.0,1,1,1,0,2,6,5,0,Matches,2023-2024,La-Liga
Miguel,es ESP,"FW,MF",Alavés,23.0,1999.0,0.7,0,0,0,0,0,0,0,,0,2,0,2,0,0,0,0,Matches,2023-2024,La-Liga
Éder Militão,br BRA,DF,Real Madrid,25.0,1998.0,5.5,7,3,4,3,0,6,9,66.7,3,4,3,1,4,11,19,1,Matches,2023-2024,La-Liga
Luis Milla,es ESP,MF,Getafe,28.0,1994.0,23.5,57,33,19,28,10,28,47,59.6,19,20,1,19,32,89,10,0,Matches,2023-2024,La-Liga
Marko Milovanović,rs SRB,"FW,MF",Almería,19.0,2003.0,3.4,4,4,1,3,0,2,4,50.0,2,2,0,2,0,4,5,0,Matches,2023-2024,La-Liga
Óscar Mingueza,es ESP,"DF,MF",Celta Vigo,24.0,1999.0,33.3,62,38,44,11,7,37,80,46.3,43,38,7,31,17,79,49,2,Matches,2023-2024,La-Liga
Ignasi Miquel,es ESP,DF,Granada,30.0,1992.0,33.2,47,30,39,6,2,23,40,57.5,17,32,16,16,45,92,132,4,Matches,2023-2024,La-Liga
Rafa Mir,es ESP,"FW,MF",Sevilla,26.0,1997.0,4.3,2,2,1,1,0,1,2,50.0,1,2,0,2,1,3,1,0,Matches,2023-2024,La-Liga
Juan Miranda,es ESP,DF,Betis,23.0,2000.0,20.6,38,24,21,13,4,17,31,54.8,14,31,6,25,19,57,62,0,Matches,2023-2024,La-Liga
Stefan Mitrović,rs SRB,DF,Getafe,33.0,1990.0,7.8,9,3,7,2,0,4,8,50.0,4,3,2,1,6,15,26,0,Matches,2023-2024,La-Liga
Luka Modrić,hr CRO,MF,Real Madrid,37.0,1985.0,18.8,22,15,10,6,6,9,25,36.0,16,13,4,9,21,43,9,0,Matches,2023-2024,La-Liga
Johan Mojica,co COL,DF,Osasuna,30.0,1992.0,22.7,30,22,11,15,4,16,25,64.0,9,15,2,13,21,51,40,2,Matches,2023-2024,La-Liga
Alberto Moleiro,es ESP,"FW,MF",Las Palmas,19.0,2003.0,20.0,15,6,4,7,4,6,30,20.0,24,11,0,11,7,22,10,0,Matches,2023-2024,La-Liga
Nahuel Molina,ar ARG,DF,Atlético Madrid,25.0,1998.0,20.6,38,22,16,18,4,26,54,48.1,28,19,3,16,9,47,36,1,Matches,2023-2024,La-Liga
Jon Moncayola,es ESP,MF,Osasuna,25.0,1998.0,20.0,27,18,14,10,3,17,42,40.5,25,31,5,26,15,42,21,0,Matches,2023-2024,La-Liga
César Montes,mx MEX,DF,Almería,26.0,1997.0,19.9,22,13,13,9,0,9,18,50.0,9,21,9,12,11,33,94,0,Matches,2023-2024,La-Liga
Álvaro Morata,es ESP,FW,Atlético Madrid,30.0,1992.0,21.2,16,10,4,7,5,3,5,60.0,2,18,3,15,1,17,26,0,Matches,2023-2024,La-Liga
Alberto Moreno,es ESP,DF,Villarreal,31.0,1992.0,16.5,31,21,19,10,2,10,30,33.3,20,12,2,10,24,55,33,0,Matches,2023-2024,La-Liga
Gerard Moreno,es ESP,FW,Villarreal,31.0,1992.0,24.6,25,12,10,7,8,11,25,44.0,14,24,7,17,9,34,24,0,Matches,2023-2024,La-Liga
Jorge Moreno,es ESP,DF,Osasuna,22.0,2001.0,0.2,0,0,0,0,0,0,0,,0,1,0,1,0,0,3,0,Matches,2023-2024,La-Liga
Ilaix Moriba,gn GUI,"MF,FW",Getafe,20.0,2003.0,6.7,20,11,3,11,6,4,9,44.4,5,3,1,2,4,24,10,0,Matches,2023-2024,La-Liga
Manu Morlanes,es ESP,MF,Mallorca,24.0,1999.0,17.9,50,29,23,26,1,23,53,43.4,30,13,1,12,20,70,21,0,Matches,2023-2024,La-Liga
Cristhian Mosquera,es ESP,DF,Valencia,19.0,2004.0,34.2,57,34,36,18,3,25,39,64.1,14,42,23,19,36,93,137,2,Matches,2023-2024,La-Liga
Yerson Mosquera,co COL,DF,Villarreal,22.0,2001.0,13.7,27,13,18,7,2,12,15,80.0,3,12,2,10,17,44,65,0,Matches,2023-2024,La-Liga
Abdul Mumin,gh GHA,DF,Rayo Vallecano,25.0,1998.0,18.8,19,10,13,4,2,8,10,80.0,2,27,19,8,22,41,82,1,Matches,2023-2024,La-Liga
Iker Muniain,es ESP,"MF,FW",Athletic Club,30.0,1992.0,6.6,5,1,2,3,0,1,3,33.3,2,4,1,3,0,5,0,0,Matches,2023-2024,La-Liga
Aihen Muñoz,es ESP,DF,Real Sociedad,25.0,1997.0,12.5,36,21,20,10,6,24,35,68.6,11,16,8,8,9,45,33,0,Matches,2023-2024,La-Liga
Iker Muñoz,es ESP,MF,Osasuna,20.0,2002.0,20.6,32,18,13,17,2,15,31,48.4,16,16,5,11,11,43,50,0,Matches,2023-2024,La-Liga
Javier Muñoz,es ESP,MF,Las Palmas,28.0,1995.0,29.3,42,23,14,22,6,16,44,36.4,28,40,4,36,20,62,29,1,Matches,2023-2024,La-Liga
Vedat Muriqi,xk KVX,FW,Mallorca,29.0,1994.0,25.9,11,6,4,3,4,2,14,14.3,12,11,4,7,6,17,26,0,Matches,2023-2024,La-Liga
Nacho,es ESP,DF,Real Madrid,33.0,1990.0,19.4,18,10,9,7,2,6,13,46.2,7,23,13,10,18,36,56,0,Matches,2023-2024,La-Liga
Matija Nastasić,rs SRB,DF,Mallorca,30.0,1993.0,25.1,35,17,26,9,0,24,32,75.0,8,33,20,13,29,64,114,0,Matches,2023-2024,La-Liga
Roberto Navarro,es ESP,"MF,FW",Cádiz,21.0,2002.0,21.0,46,29,20,21,5,22,43,51.2,21,33,0,33,19,65,7,1,Matches,2023-2024,La-Liga
Jesús Navas,es ESP,DF,Sevilla,37.0,1985.0,22.3,37,27,21,14,2,22,40,55.0,18,15,7,8,22,59,48,0,Matches,2023-2024,La-Liga
Álvaro Negredo,es ESP,"FW,MF",Cádiz,37.0,1985.0,0.6,0,0,0,0,0,0,0,,0,1,0,1,1,1,0,0,Matches,2023-2024,La-Liga
Carlos Neva,es ESP,DF,Granada,27.0,1996.0,35.0,32,21,22,9,1,17,40,42.5,23,39,14,25,30,62,108,2,Matches,2023-2024,La-Liga
Tanguy Nianzou,fr FRA,DF,Sevilla,21.0,2002.0,3.5,12,8,9,2,1,8,11,72.7,3,2,0,2,3,15,9,1,Matches,2023-2024,La-Liga
Saúl Ñíguez,es ESP,MF,Atlético Madrid,28.0,1994.0,15.3,64,39,29,29,6,30,49,61.2,19,36,9,27,14,78,56,0,Matches,2023-2024,La-Liga
Peru Nolaskoain,es ESP,"DF,MF",Athletic Club,24.0,1998.0,0.1,1,1,1,0,0,1,1,100.0,0,0,0,0,0,1,1,0,Matches,2023-2024,La-Liga
Randy Nteka,ao ANG,"FW,MF",Rayo Vallecano,25.0,1997.0,6.4,11,4,1,6,4,4,10,40.0,6,6,1,5,2,13,11,1,Matches,2023-2024,La-Liga
Unai Núñez,es ESP,DF,Celta Vigo,26.0,1997.0,31.1,51,28,30,19,2,23,49,46.9,26,38,24,14,52,103,153,3,Matches,2023-2024,La-Liga
Ørjan Nyland,no NOR,GK,Sevilla,32.0,1990.0,24.0,0,0,0,0,0,0,1,0.0,1,0,0,0,0,0,9,1,Matches,2023-2024,La-Liga
Jan Oblak,si SVN,GK,Atlético Madrid,30.0,1993.0,38.0,0,0,0,0,0,0,0,,0,0,0,0,0,0,10,0,Matches,2023-2024,La-Liga
Brian Ocampo,uy URU,"MF,FW",Cádiz,24.0,1999.0,2.8,4,3,1,3,0,2,5,40.0,3,4,0,4,3,7,0,0,Matches,2023-2024,La-Liga
Lucas Ocampos,ar ARG,"FW,MF",Sevilla,29.0,1994.0,31.9,66,47,22,27,17,29,58,50.0,29,34,1,33,21,87,29,0,Matches,2023-2024,La-Liga
Álvaro Odriozola,es ESP,DF,Real Sociedad,27.0,1995.0,4.4,9,7,7,1,1,5,5,100.0,0,2,1,1,8,17,7,0,Matches,2023-2024,La-Liga
Aingeru Olabarrieta,es ESP,FW,Athletic Club,17.0,2005.0,0.1,0,0,0,0,0,0,0,,0,0,0,0,0,0,0,0,Matches,2023-2024,La-Liga
Olasagasti,es ESP,MF,Real Sociedad,22.0,2000.0,4.0,16,13,4,7,5,5,8,62.5,3,2,0,2,3,19,5,1,Matches,2023-2024,La-Liga
Samu Omorodion,es ESP,FW,Alavés,19.0,2004.0,21.3,6,3,1,4,1,0,4,0.0,4,11,2,9,1,7,14,0,Matches,2023-2024,La-Liga
Samu Omorodion,es ESP,FW,Granada,19.0,2004.0,0.9,1,1,0,1,0,1,1,100.0,0,0,0,0,0,1,0,0,Matches,2023-2024,La-Liga
Aimar Oroz,es ESP,MF,Osasuna,21.0,2001.0,26.0,43,26,18,20,5,13,37,35.1,24,27,2,25,16,59,11,0,Matches,2023-2024,La-Liga
Eneko Ortiz,es ESP,DF,Alavés,20.0,2003.0,0.2,0,0,0,0,0,0,0,,0,0,0,0,0,0,0,0,Matches,2023-2024,La-Liga
Asier Osambela,es ESP,MF,Osasuna,19.0,2004.0,0.1,2,1,0,1,1,0,0,,0,0,0,0,0,2,0,0,Matches,2023-2024,La-Liga
Milutin Osmajić,me MNE,MF,Cádiz,24.0,1999.0,0.1,0,0,0,0,0,0,0,,0,0,0,0,0,0,0,0,Matches,2023-2024,La-Liga
Aiham Ousou,sy SYR,DF,Cádiz,23.0,2000.0,4.8,8,5,6,2,0,5,5,100.0,0,1,0,1,7,15,15,0,Matches,2023-2024,La-Liga
Jesús Owono,gq EQG,GK,Alavés,22.0,2001.0,4.0,0,0,0,0,0,0,0,,0,0,0,0,0,0,3,0,Matches,2023-2024,La-Liga
Mikel Oyarzabal,es ESP,"FW,MF",Real Sociedad,26.0,1997.0,24.0,23,18,7,11,5,7,21,33.3,14,25,4,21,4,27,12,0,Matches,2023-2024,La-Liga
Cenk Özkacar,tr TUR,DF,Valencia,22.0,2000.0,17.8,26,15,22,4,0,15,23,65.2,8,18,7,11,18,44,84,1,Matches,2023-2024,La-Liga
Jon Pacheco,es ESP,DF,Real Sociedad,22.0,2001.0,17.0,25,15,21,4,0,14,22,63.6,8,17,6,11,10,35,53,1,Matches,2023-2024,La-Liga
Isaac Palazón Camacho,es ESP,"MF,FW",Rayo Vallecano,28.0,1994.0,31.0,46,25,16,21,9,20,58,34.5,38,29,2,27,16,62,41,0,Matches,2023-2024,La-Liga
Joaquín Panichelli,ar ARG,"FW,MF",Alavés,20.0,2002.0,2.5,3,3,1,1,1,1,2,50.0,1,1,0,1,1,4,4,0,Matches,2023-2024,La-Liga
Sokratis Papastathopoulos,gr GRE,DF,Betis,35.0,1988.0,12.6,21,14,16,5,0,13,17,76.5,4,15,9,6,6,27,60,0,Matches,2023-2024,La-Liga
Victor Parada,es ESP,"FW,MF",Alavés,21.0,2002.0,0.0,1,1,0,1,0,1,1,100.0,0,0,0,0,0,1,0,0,Matches,2023-2024,La-Liga
Aitor Paredes,es ESP,DF,Athletic Club,23.0,2000.0,30.0,20,11,11,9,0,7,14,50.0,7,23,11,12,33,53,104,0,Matches,2023-2024,La-Liga
Daniel Parejo,es ESP,MF,Villarreal,34.0,1989.0,28.7,43,30,16,21,6,20,46,43.5,26,25,9,16,21,64,29,3,Matches,2023-2024,La-Liga
Pascu,es ESP,FW,Villarreal,20.0,2003.0,0.2,0,0,0,0,0,0,0,,0,0,0,0,0,0,0,0,Matches,2023-2024,La-Liga
Gabriel Paulista,br BRA,DF,Atlético Madrid,32.0,1990.0,4.5,7,5,4,3,0,3,4,75.0,1,5,3,2,4,11,27,0,Matches,2023-2024,La-Liga
Gabriel Paulista,br BRA,DF,Valencia,32.0,1990.0,15.5,10,7,8,2,0,6,11,54.5,5,15,7,8,24,34,78,0,Matches,2023-2024,La-Liga
Nicolás Paz,ar ARG,"MF,FW",Real Madrid,18.0,2004.0,0.3,0,0,0,0,0,0,0,,0,2,0,2,1,1,0,0,Matches,2023-2024,La-Liga
Alfonso Pedraza,es ESP,DF,Villarreal,27.0,1996.0,12.4,25,9,18,5,2,9,17,52.9,8,16,7,9,13,38,19,0,Matches,2023-2024,La-Liga
Pedri,es ESP,"MF,FW",Barcelona,20.0,2002.0,16.4,33,24,16,13,4,8,27,29.6,19,27,3,24,14,47,10,0,Matches,2023-2024,La-Liga
Adrià Pedrosa,es ESP,DF,Sevilla,25.0,1998.0,19.5,46,26,28,14,4,23,34,67.6,11,26,6,20,15,61,54,0,Matches,2023-2024,La-Liga
Pejiño,es ESP,FW,Las Palmas,27.0,1996.0,5.6,12,8,3,6,3,6,18,33.3,12,4,0,4,2,14,5,0,Matches,2023-2024,La-Liga
Facundo Pellistri,uy URU,"MF,FW",Granada,21.0,2001.0,13.7,29,19,12,10,7,6,21,28.6,15,18,0,18,4,33,7,0,Matches,2023-2024,La-Liga
Iñaki Peña,es ESP,GK,Barcelona,24.0,1999.0,10.0,0,0,0,0,0,0,1,0.0,1,0,0,0,0,0,5,1,Matches,2023-2024,La-Liga
Marcos Peña,es ESP,MF,Almería,18.0,2005.0,4.9,19,14,12,7,0,6,12,50.0,6,9,3,6,13,32,8,0,Matches,2023-2024,La-Liga
Rubén Peña,es ESP,"DF,FW",Osasuna,32.0,1991.0,23.2,47,25,22,18,7,20,49,40.8,29,37,8,29,30,77,39,3,Matches,2023-2024,La-Liga
Alberto Perea,es ESP,"MF,FW",Granada,32.0,1990.0,0.0,0,0,0,0,0,0,2,0.0,2,0,0,0,0,0,0,0,Matches,2023-2024,La-Liga
Ayoze Pérez,es ESP,FW,Betis,30.0,1993.0,25.5,59,32,16,33,10,21,49,42.9,28,42,4,38,22,81,18,0,Matches,2023-2024,La-Liga
Carles Pérez,es ESP,"MF,DF",Celta Vigo,25.0,1998.0,8.6,13,5,6,5,2,7,18,38.9,11,14,1,13,5,18,8,0,Matches,2023-2024,La-Liga
Francisco Perez,es ESP,"MF,FW",Valencia,20.0,2002.0,22.8,30,17,10,14,6,15,44,34.1,29,19,0,19,14,44,5,0,Matches,2023-2024,La-Liga
Kike Pérez,es ESP,"MF,FW",Rayo Vallecano,26.0,1997.0,9.3,27,11,11,15,1,11,23,47.8,12,11,0,11,8,35,6,0,Matches,2023-2024,La-Liga
Máximo Perrone,ar ARG,MF,Las Palmas,20.0,2003.0,18.0,42,21,17,22,3,19,39,48.7,20,27,4,23,24,66,21,0,Matches,2023-2024,La-Liga
Njegoš Petrović,rs SRB,"MF,FW",Granada,24.0,1999.0,1.7,5,2,4,1,0,2,3,66.7,1,2,0,2,1,6,3,0,Matches,2023-2024,La-Liga
Germán Pezzella,ar ARG,DF,Betis,32.0,1991.0,30.7,34,24,24,10,0,23,38,60.5,15,31,18,13,31,65,150,0,Matches,2023-2024,La-Liga
Kamil Piątkowski,pl POL,DF,Granada,23.0,2000.0,5.6,18,10,16,1,1,10,14,71.4,4,6,5,1,8,26,28,1,Matches,2023-2024,La-Liga
Yeremi Pino,es ESP,"MF,FW",Villarreal,20.0,2002.0,5.3,25,18,12,10,3,9,18,50.0,9,11,1,10,5,30,5,0,Matches,2023-2024,La-Liga
Portu,es ESP,FW,Getafe,31.0,1992.0,1.1,5,3,4,0,1,5,6,83.3,1,0,0,0,0,5,0,0,Matches,2023-2024,La-Liga
Portu,es ESP,"MF,FW",Girona,31.0,1992.0,13.2,18,13,3,10,5,3,18,16.7,15,9,1,8,4,22,6,0,Matches,2023-2024,La-Liga
José Pozo,es ESP,MF,Rayo Vallecano,27.0,1996.0,0.2,1,1,0,1,0,1,1,100.0,0,1,0,1,0,1,0,0,Matches,2023-2024,La-Liga
Alejandro Pozo Pozo,es ESP,"DF,MF",Almería,24.0,1999.0,10.8,19,12,11,6,2,12,20,60.0,8,14,4,10,7,26,21,0,Matches,2023-2024,La-Liga
Beñat Prados,es ESP,"MF,DF",Athletic Club,22.0,2001.0,16.1,45,28,11,23,11,23,42,54.8,19,32,5,27,23,68,27,0,Matches,2023-2024,La-Liga
Abdón Prats,es ESP,"FW,MF",Mallorca,30.0,1992.0,14.1,6,4,2,2,2,3,5,60.0,2,6,3,3,2,8,12,0,Matches,2023-2024,La-Liga
Marc Pubill,es ESP,DF,Almería,20.0,2003.0,20.9,47,23,35,8,4,22,39,56.4,17,20,8,12,15,62,83,1,Matches,2023-2024,La-Liga
Antonio Puertas,es ESP,"MF,FW",Granada,31.0,1992.0,8.1,12,8,6,5,1,6,15,40.0,9,5,0,5,6,18,4,0,Matches,2023-2024,La-Liga
Arnau Puigmal,es ESP,"FW,DF",Almería,22.0,2001.0,2.8,2,1,1,1,0,1,3,33.3,2,3,0,3,3,5,2,0,Matches,2023-2024,La-Liga
Nemanja Radonjić,rs SRB,"MF,DF",Mallorca,27.0,1996.0,3.9,4,2,1,3,0,1,4,25.0,3,2,0,2,3,7,3,0,Matches,2023-2024,La-Liga
Aleksandar Radovanović,rs SRB,DF,Almería,29.0,1993.0,6.3,8,7,7,1,0,6,6,100.0,0,8,8,0,11,19,48,0,Matches,2023-2024,La-Liga
Abdellah Raihani,ma MAR,FW,Atlético Madrid,19.0,2004.0,0.1,0,0,0,0,0,0,1,0.0,1,0,0,0,0,0,0,0,Matches,2023-2024,La-Liga
Antonio Raillo,es ESP,DF,Mallorca,31.0,1991.0,24.4,30,23,18,12,0,17,23,73.9,6,44,30,14,37,67,104,2,Matches,2023-2024,La-Liga
Predrag Rajković,rs SRB,GK,Mallorca,27.0,1995.0,36.0,2,1,2,0,0,2,2,100.0,0,0,0,0,0,2,14,0,Matches,2023-2024,La-Liga
Ivan Rakitić,hr CRO,MF,Sevilla,35.0,1988.0,15.8,30,16,9,12,9,11,19,57.9,8,16,5,11,14,44,12,0,Matches,2023-2024,La-Liga
Largie Ramazani,be BEL,"FW,MF",Almería,22.0,2001.0,17.3,12,7,5,6,1,6,26,23.1,20,16,2,14,34,46,10,0,Matches,2023-2024,La-Liga
Benito Ramírez,es ESP,"FW,MF",Las Palmas,28.0,1995.0,4.3,5,3,2,3,0,3,6,50.0,3,7,1,6,3,8,0,0,Matches,2023-2024,La-Liga
Sandro Ramírez,es ESP,FW,Las Palmas,28.0,1995.0,20.1,12,8,4,6,2,6,15,40.0,9,13,1,12,4,16,14,1,Matches,2023-2024,La-Liga
Chris Ramos,es ESP,"FW,MF",Cádiz,26.0,1997.0,29.0,28,15,9,15,4,8,27,29.6,19,23,7,16,9,37,44,0,Matches,2023-2024,La-Liga
Sergio Ramos,es ESP,DF,Sevilla,37.0,1986.0,28.0,45,30,32,11,2,27,40,67.5,13,35,30,5,41,86,156,0,Matches,2023-2024,La-Liga
Raphinha,br BRA,"FW,MF",Barcelona,26.0,1996.0,15.2,14,8,6,6,2,4,18,22.2,14,17,1,16,13,27,11,0,Matches,2023-2024,La-Liga
Andrei Ratiu,ro ROU,"DF,MF",Rayo Vallecano,25.0,1998.0,7.0,12,4,6,5,1,8,15,53.3,7,4,1,3,0,12,12,0,Matches,2023-2024,La-Liga
Raúl,es ESP,FW,Osasuna,22.0,2000.0,15.1,10,4,4,2,4,2,10,20.0,8,9,1,8,5,15,11,0,Matches,2023-2024,La-Liga
Abderrahman Rebbach,dz ALG,"FW,MF",Alavés,24.0,1998.0,8.0,9,5,4,2,3,5,15,33.3,10,10,1,9,3,12,7,0,Matches,2023-2024,La-Liga
Pepe Reina,es ESP,GK,Villarreal,40.0,1982.0,2.0,0,0,0,0,0,0,0,,0,0,0,0,0,0,1,0,Matches,2023-2024,La-Liga
Álex Remiro,es ESP,GK,Real Sociedad,28.0,1995.0,36.4,0,0,0,0,0,0,0,,0,0,0,0,0,0,24,2,Matches,2023-2024,La-Liga
Chadi Riad,ma MAR,DF,Betis,20.0,2003.0,24.0,35,24,17,18,0,17,27,63.0,10,23,14,9,23,58,108,0,Matches,2023-2024,La-Liga
Diego Rico,es ESP,DF,Getafe,30.0,1993.0,28.2,64,48,32,23,9,41,76,53.9,35,25,8,17,41,105,76,0,Matches,2023-2024,La-Liga
Luis Rioja,es ESP,"FW,MF",Alavés,29.0,1993.0,27.8,27,19,10,12,5,14,43,32.6,29,28,1,27,16,43,28,0,Matches,2023-2024,La-Liga
Rodrigo Riquelme,es ESP,"DF,MF",Atlético Madrid,23.0,2000.0,17.0,30,19,18,4,8,18,46,39.1,28,19,0,19,9,39,20,0,Matches,2023-2024,La-Liga
Alberto Risco,es ESP,MF,Getafe,17.0,2005.0,1.5,2,2,1,1,0,0,4,0.0,4,0,0,0,0,2,1,0,Matches,2023-2024,La-Liga
Mihailo Ristić,rs SRB,"DF,MF",Celta Vigo,27.0,1995.0,9.0,15,9,9,6,0,9,12,75.0,3,9,2,7,10,25,23,0,Matches,2023-2024,La-Liga
Gorka Rivera Alonso,es ESP,DF,Getafe,18.0,2004.0,0.0,0,0,0,0,0,0,0,,0,0,0,0,0,0,0,0,Matches,2023-2024,La-Liga
Sergi Roberto,es ESP,"MF,DF",Barcelona,31.0,1992.0,9.6,15,10,4,10,1,3,11,27.3,8,7,2,5,8,23,7,1,Matches,2023-2024,La-Liga
Lucas Robertone,ar ARG,MF,Almería,26.0,1997.0,26.5,61,33,28,23,10,25,50,50.0,25,43,9,34,51,112,43,0,Matches,2023-2024,La-Liga
Marc Roca,es ESP,MF,Betis,26.0,1996.0,22.0,52,36,17,29,6,30,53,56.6,23,29,6,23,17,69,23,1,Matches,2023-2024,La-Liga
Sergio Rodelas,es ESP,"FW,DF",Granada,18.0,2004.0,1.4,3,2,1,0,2,0,3,0.0,3,0,0,0,0,3,0,0,Matches,2023-2024,La-Liga
Rodri,es ESP,"FW,MF",Betis,23.0,2000.0,11.7,17,10,6,7,4,8,21,38.1,13,11,0,11,8,25,2,0,Matches,2023-2024,La-Liga
Álvaro Rodríguez,uy URU,FW,Real Madrid,19.0,2004.0,0.0,0,0,0,0,0,0,0,,0,0,0,0,0,0,1,0,Matches,2023-2024,La-Liga
Óscar Rodríguez Arnaiz,es ESP,"MF,FW",Getafe,25.0,1998.0,10.7,24,13,2,15,7,9,15,60.0,6,12,1,11,5,29,5,0,Matches,2023-2024,La-Liga
Damián Rodríguez,es ESP,MF,Celta Vigo,20.0,2003.0,2.9,6,3,1,3,2,1,3,33.3,2,4,2,2,1,7,2,0,Matches,2023-2024,La-Liga
Dani Rodríguez,es ESP,MF,Mallorca,35.0,1988.0,29.1,47,24,21,20,6,21,45,46.7,24,34,5,29,15,62,21,0,Matches,2023-2024,La-Liga
Guido Rodríguez,ar ARG,MF,Betis,29.0,1994.0,20.5,53,30,21,24,8,34,55,61.8,21,27,6,21,29,82,44,0,Matches,2023-2024,La-Liga
Kirian Rodríguez,es ESP,MF,Las Palmas,27.0,1996.0,35.7,52,32,22,25,5,24,67,35.8,43,39,3,36,28,80,23,1,Matches,2023-2024,La-Liga
Miguel Rodríguez,es ESP,MF,Celta Vigo,20.0,2003.0,3.3,6,3,3,1,2,3,9,33.3,6,8,0,8,4,10,0,0,Matches,2023-2024,La-Liga
Rodrygo,br BRA,FW,Real Madrid,22.0,2001.0,26.4,16,15,2,9,5,5,19,26.3,14,14,0,14,8,24,6,0,Matches,2023-2024,La-Liga
Carlos Romero,es ESP,DF,Villarreal,21.0,2001.0,2.9,11,5,8,1,2,7,12,58.3,5,3,0,3,1,12,11,0,Matches,2023-2024,La-Liga
Isaac Romero,es ESP,FW,Sevilla,23.0,2000.0,11.5,6,3,2,2,2,5,9,55.6,4,12,0,12,0,6,11,0,Matches,2023-2024,La-Liga
Luka Romero,ar ARG,FW,Almería,18.0,2004.0,4.9,5,1,2,3,0,2,4,50.0,2,12,1,11,1,6,2,1,Matches,2023-2024,La-Liga
Oriol Romeu,es ESP,MF,Barcelona,31.0,1991.0,10.4,34,20,17,14,3,13,24,54.2,11,12,2,10,10,44,18,0,Matches,2023-2024,La-Liga
Unai Ropero,es ESP,MF,Alavés,21.0,2001.0,0.1,0,0,0,0,0,0,0,,0,0,0,0,0,0,0,0,Matches,2023-2024,La-Liga
Vitor Roque,br BRA,FW,Barcelona,18.0,2005.0,3.6,3,2,2,0,1,0,2,0.0,2,3,0,3,0,3,5,0,Matches,2023-2024,La-Liga
Antonio Rüdiger,de GER,DF,Real Madrid,30.0,1993.0,30.1,26,15,18,4,4,16,20,80.0,4,27,20,7,11,37,89,0,Matches,2023-2024,La-Liga
Javier Rueda Garcia,es ESP,"MF,DF",Celta Vigo,21.0,2002.0,0.2,0,0,0,0,0,0,0,,0,0,0,0,0,0,0,0,Matches,2023-2024,La-Liga
Aitor Ruibal,es ESP,"DF,FW",Betis,27.0,1996.0,11.3,46,27,28,13,5,32,59,54.2,27,12,1,11,14,60,33,1,Matches,2023-2024,La-Liga
Sergio Ruiz,es ESP,MF,Granada,28.0,1994.0,27.7,83,46,43,36,4,38,84,45.2,46,24,6,18,28,111,43,1,Matches,2023-2024,La-Liga
Youssouf Sabaly,sn SEN,DF,Betis,30.0,1993.0,11.6,16,11,12,3,1,8,12,66.7,4,6,3,3,11,27,27,0,Matches,2023-2024,La-Liga
Umar Sadiq,ng NGA,FW,Real Sociedad,26.0,1997.0,12.0,15,10,2,8,5,4,8,50.0,4,9,0,9,0,15,10,0,Matches,2023-2024,La-Liga
Pablo Saenz,es ESP,MF,Granada,22.0,2001.0,0.2,3,3,2,0,1,1,3,33.3,2,0,0,0,0,3,0,0,Matches,2023-2024,La-Liga
Kike Salas,es ESP,DF,Sevilla,21.0,2002.0,17.8,41,23,26,12,3,22,36,61.1,14,25,14,11,26,67,91,1,Matches,2023-2024,La-Liga
Salvi,es ESP,MF,Rayo Vallecano,32.0,1991.0,0.3,0,0,0,0,0,0,4,0.0,4,0,0,0,1,1,0,0,Matches,2023-2024,La-Liga
Diadie Samassékou,ml MLI,MF,Cádiz,27.0,1996.0,1.0,5,3,2,2,1,5,6,83.3,1,0,0,0,3,8,1,0,Matches,2023-2024,La-Liga
Fede San Emeterio,es ESP,MF,Cádiz,26.0,1997.0,1.7,3,2,2,1,0,1,4,25.0,3,3,2,1,2,5,1,0,Matches,2023-2024,La-Liga
Oihan Sancet,es ESP,MF,Athletic Club,23.0,2000.0,21.9,19,11,3,10,6,8,21,38.1,13,5,1,4,10,29,5,0,Matches,2023-2024,La-Liga
Ricard Sánchez,es ESP,DF,Granada,23.0,2000.0,25.5,29,18,15,8,6,12,24,50.0,12,32,4,28,13,42,64,0,Matches,2023-2024,La-Liga
Antonio Sánchez,es ESP,MF,Mallorca,26.0,1997.0,16.1,25,11,13,10,2,11,32,34.4,21,24,5,19,13,38,13,0,Matches,2023-2024,La-Liga
Juanlu Sánchez,es ESP,DF,Sevilla,19.0,2003.0,13.1,56,35,34,18,4,34,58,58.6,24,24,7,17,12,68,36,0,Matches,2023-2024,La-Liga
Manu Sánchez,es ESP,"DF,MF",Celta Vigo,22.0,2000.0,19.7,54,28,21,25,8,31,55,56.4,24,23,3,20,19,73,65,0,Matches,2023-2024,La-Liga
Jesús Santiago,es ESP,MF,Getafe,19.0,2004.0,7.3,17,8,8,5,4,4,7,57.1,3,3,0,3,0,17,8,0,Matches,2023-2024,La-Liga
Paco Sanz,es ESP,DF,Almería,18.0,2004.0,0.3,0,0,0,0,0,0,1,0.0,1,0,0,0,0,0,4,0,Matches,2023-2024,La-Liga
Stefan Savić,me MNE,DF,Atlético Madrid,32.0,1991.0,18.1,27,19,16,7,4,15,30,50.0,15,29,15,14,27,54,61,1,Matches,2023-2024,La-Liga
Sávio,br BRA,"FW,MF",Girona,19.0,2004.0,33.1,42,25,14,22,6,16,28,57.1,12,34,0,34,18,60,11,1,Matches,2023-2024,La-Liga
Aleksandar Sedlar,rs SRB,DF,Alavés,31.0,1991.0,10.5,14,10,10,4,0,10,16,62.5,6,8,4,4,13,27,43,0,Matches,2023-2024,La-Liga
André Silva,pt POR,FW,Real Sociedad,27.0,1995.0,8.1,2,2,0,0,2,0,4,0.0,4,3,0,3,1,3,3,0,Matches,2023-2024,La-Liga
Rui Silva,pt POR,GK,Betis,29.0,1994.0,27.5,0,0,0,0,0,0,3,0.0,3,0,0,0,1,1,13,1,Matches,2023-2024,La-Liga
Giuliano Simeone,ar ARG,FW,Alavés,20.0,2002.0,7.0,7,5,2,3,2,5,17,29.4,12,10,0,10,5,12,3,0,Matches,2023-2024,La-Liga
Unai Simón,es ESP,GK,Athletic Club,26.0,1997.0,35.4,2,1,1,1,0,2,3,66.7,1,0,0,0,1,3,9,0,Matches,2023-2024,La-Liga
Daley Sinkgraven,nl NED,DF,Las Palmas,28.0,1995.0,4.2,11,5,6,5,0,2,8,25.0,6,5,3,2,6,17,9,0,Matches,2023-2024,La-Liga
Jailson Siqueira,br BRA,"DF,MF",Celta Vigo,27.0,1995.0,10.0,27,18,22,5,0,13,24,54.2,11,13,5,8,12,39,32,0,Matches,2023-2024,La-Liga
Antonio Sivera,es ESP,GK,Alavés,26.0,1996.0,34.0,0,0,0,0,0,0,1,0.0,1,0,0,0,0,0,17,1,Matches,2023-2024,La-Liga
Rubén Sobrino,es ESP,"MF,FW",Cádiz,31.0,1992.0,18.3,52,28,18,26,8,22,51,43.1,29,26,2,24,16,68,18,0,Matches,2023-2024,La-Liga
Alex Sola,es ESP,"FW,MF",Alavés,24.0,1999.0,14.0,27,15,11,9,7,14,26,53.8,12,18,2,16,11,38,16,0,Matches,2023-2024,La-Liga
Alex Sola,es ESP,"DF,MF",Real Sociedad,24.0,1999.0,0.3,0,0,0,0,0,0,0,,0,0,0,0,1,1,2,0,Matches,2023-2024,La-Liga
Jhon Solis,co COL,MF,Girona,18.0,2004.0,4.3,10,8,4,5,1,4,12,33.3,8,8,3,5,8,18,7,1,Matches,2023-2024,La-Liga
David Soria,es ESP,GK,Getafe,30.0,1993.0,37.9,0,0,0,0,0,0,2,0.0,2,0,0,0,0,0,21,6,Matches,2023-2024,La-Liga
Alberto Soro,es ESP,MF,Granada,24.0,1999.0,0.1,0,0,0,0,0,0,0,,0,0,0,0,0,0,0,0,Matches,2023-2024,La-Liga
Hugo Sotelo,es ESP,MF,Celta Vigo,19.0,2003.0,8.0,19,17,3,13,3,8,20,40.0,12,7,1,6,2,21,5,0,Matches,2023-2024,La-Liga
Boubakary Soumaré,fr FRA,MF,Sevilla,24.0,1999.0,25.4,39,28,24,14,1,14,26,53.8,12,25,7,18,26,65,20,1,Matches,2023-2024,La-Liga
Djibril Sow,ch SUI,MF,Sevilla,26.0,1997.0,16.2,28,21,15,8,5,9,25,36.0,16,20,3,17,17,45,8,1,Matches,2023-2024,La-Liga
Çağlar Söyüncü,tr TUR,DF,Atlético Madrid,27.0,1996.0,1.3,1,1,1,0,0,0,0,,0,1,0,1,1,2,7,0,Matches,2023-2024,La-Liga
Carl Starfelt,se SWE,DF,Celta Vigo,28.0,1995.0,24.6,36,30,30,5,1,19,28,67.9,9,35,28,7,34,70,159,2,Matches,2023-2024,La-Liga
Jørgen Strand Larsen,no NOR,FW,Celta Vigo,23.0,2000.0,31.8,21,11,1,15,5,8,38,21.1,30,15,1,14,5,26,17,0,Matches,2023-2024,La-Liga
Cristhian Stuani,uy URU,FW,Girona,36.0,1986.0,8.9,14,11,4,6,4,4,7,57.1,3,9,2,7,5,19,13,0,Matches,2023-2024,La-Liga
Álex Suárez,es ESP,DF,Las Palmas,30.0,1993.0,28.5,53,36,33,15,5,31,37,83.8,6,33,14,19,18,71,84,0,Matches,2023-2024,La-Liga
Damián Suárez,uy URU,DF,Getafe,35.0,1988.0,14.4,36,21,16,16,4,26,45,57.8,19,13,3,10,10,46,31,0,Matches,2023-2024,La-Liga
Denis Suárez,es ESP,"MF,FW",Villarreal,29.0,1994.0,1.5,0,0,0,0,0,0,2,0.0,2,2,2,0,0,0,4,0,Matches,2023-2024,La-Liga
Suso,es ESP,"MF,FW",Sevilla,29.0,1993.0,16.9,24,17,14,8,2,8,28,28.6,20,9,0,9,5,29,4,0,Matches,2023-2024,La-Liga
Max Svensson,es ESP,FW,Osasuna,,,0.0,1,0,0,0,1,0,0,,0,0,0,0,0,1,0,0,Matches,2023-2024,La-Liga
Williot Swedberg,se SWE,"FW,MF",Celta Vigo,19.0,2004.0,4.9,9,4,3,6,0,5,8,62.5,3,11,1,10,0,9,4,0,Matches,2023-2024,La-Liga
Mamadou Sylla,sn SEN,"FW,MF",Alavés,29.0,1994.0,0.2,0,0,0,0,0,0,0,,0,1,1,0,0,0,1,0,Matches,2023-2024,La-Liga
Alexander Sørloth,no NOR,FW,Villarreal,27.0,1995.0,27.7,6,3,1,2,3,2,6,33.3,4,9,4,5,0,6,26,0,Matches,2023-2024,La-Liga
Yassin Tallal,es ESP,FW,Getafe,18.0,2005.0,0.0,0,0,0,0,0,0,0,,0,0,0,0,0,0,0,0,Matches,2023-2024,La-Liga
Renato Tapia,pe PER,"MF,DF",Celta Vigo,28.0,1995.0,14.9,41,29,19,19,3,14,25,56.0,11,31,7,24,21,62,50,1,Matches,2023-2024,La-Liga
César Tárrega,es ESP,DF,Valencia,21.0,2002.0,0.1,0,0,0,0,0,0,0,,0,0,0,0,0,0,2,0,Matches,2023-2024,La-Liga
Marciano Tchami,gw GNB,"FW,MF",Almería,19.0,2004.0,0.5,0,0,0,0,0,0,0,,0,0,0,0,0,0,0,0,Matches,2023-2024,La-Liga
Aurélien Tchouaméni,fr FRA,"MF,DF",Real Madrid,23.0,2000.0,22.1,38,23,19,17,2,9,18,50.0,9,21,13,8,28,66,52,1,Matches,2023-2024,La-Liga
Nahuel Tenaglia,ar ARG,DF,Alavés,27.0,1996.0,12.7,29,19,22,4,3,16,28,57.1,12,14,8,6,12,41,59,0,Matches,2023-2024,La-Liga
Marc-André ter Stegen,de GER,GK,Barcelona,31.0,1992.0,28.0,0,0,0,0,0,0,0,,0,0,0,0,0,0,3,3,Matches,2023-2024,La-Liga
Ramón Terrats,es ESP,"MF,DF",Villarreal,22.0,2000.0,8.7,17,13,8,8,1,7,15,46.7,8,11,1,10,3,20,9,0,Matches,2023-2024,La-Liga
Kieran Tierney,sct SCO,DF,Real Sociedad,26.0,1997.0,13.8,37,24,16,18,3,18,27,66.7,9,22,8,14,10,47,45,0,Matches,2023-2024,La-Liga
Raúl de Tomás,es ESP,FW,Rayo Vallecano,28.0,1994.0,14.1,9,5,4,3,2,3,6,50.0,3,3,0,3,1,10,8,0,Matches,2023-2024,La-Liga
Pablo Torre,es ESP,"MF,FW",Girona,20.0,2003.0,7.8,5,2,0,5,0,4,10,40.0,6,10,2,8,4,9,6,1,Matches,2023-2024,La-Liga
Raúl Torrente,es ESP,DF,Granada,21.0,2001.0,13.9,29,16,20,9,0,17,22,77.3,5,16,10,6,11,40,68,2,Matches,2023-2024,La-Liga
Ferrán Torres,es ESP,FW,Barcelona,23.0,2000.0,13.5,9,6,1,6,2,5,16,31.3,11,7,1,6,5,14,6,0,Matches,2023-2024,La-Liga
Óliver Torres,es ESP,MF,Sevilla,28.0,1994.0,18.0,37,22,17,15,5,22,57,38.6,35,40,4,36,6,43,6,0,Matches,2023-2024,La-Liga
Lucas Torró,es ESP,MF,Osasuna,29.0,1994.0,19.9,25,15,11,8,6,11,28,39.3,17,10,2,8,33,58,37,0,Matches,2023-2024,La-Liga
Bertrand Traoré,bf BFA,MF,Villarreal,27.0,1995.0,6.3,5,4,2,1,2,1,4,25.0,3,6,0,6,1,6,2,0,Matches,2023-2024,La-Liga
Hamari Traoré,ml MLI,DF,Real Sociedad,31.0,1992.0,25.5,44,19,24,17,3,25,43,58.1,18,27,8,19,24,68,59,2,Matches,2023-2024,La-Liga
Óscar Trejo,ar ARG,"FW,MF",Rayo Vallecano,35.0,1988.0,15.3,27,15,11,9,7,13,21,61.9,8,21,1,20,5,32,9,0,Matches,2023-2024,La-Liga
Manu Trigueros,es ESP,MF,Villarreal,31.0,1991.0,3.4,7,5,6,1,0,4,10,40.0,6,1,1,0,3,10,9,0,Matches,2023-2024,La-Liga
Viktor Tsyhankov,ua UKR,"MF,FW",Girona,25.0,1997.0,22.8,29,20,11,13,5,14,26,53.8,12,18,1,17,12,41,24,0,Matches,2023-2024,La-Liga
Beñat Turrientes,es ESP,MF,Real Sociedad,21.0,2002.0,18.7,31,17,6,20,5,13,30,43.3,17,19,8,11,6,37,17,0,Matches,2023-2024,La-Liga
Enes Ünal,tr TUR,"FW,MF",Getafe,26.0,1997.0,1.6,0,0,0,0,0,0,0,,0,1,0,1,0,0,2,0,Matches,2023-2024,La-Liga
Myrto Uzuni,al ALB,FW,Granada,28.0,1995.0,27.2,18,14,8,7,3,6,27,22.2,21,19,3,16,4,22,7,0,Matches,2023-2024,La-Liga
Óscar Valentín,es ESP,MF,Rayo Vallecano,28.0,1994.0,29.9,107,66,39,62,6,46,101,45.5,55,62,10,52,35,142,52,1,Matches,2023-2024,La-Liga
Martin Valjent,sk SVK,DF,Mallorca,27.0,1995.0,26.1,34,18,19,13,2,18,30,60.0,12,26,11,15,29,63,112,1,Matches,2023-2024,La-Liga
Jesús Vallejo,es ESP,DF,Granada,26.0,1997.0,1.2,3,1,1,2,0,2,2,100.0,0,3,2,1,0,3,1,1,Matches,2023-2024,La-Liga
Álvaro Vallés,es ESP,GK,Las Palmas,26.0,1997.0,36.3,3,2,3,0,0,3,8,37.5,5,0,0,0,0,3,40,1,Matches,2023-2024,La-Liga
Federico Valverde,uy URU,MF,Real Madrid,25.0,1998.0,32.3,47,34,22,13,12,24,42,57.1,18,39,2,37,43,90,40,0,Matches,2023-2024,La-Liga
Siebe Van Der Heyden,be BEL,DF,Mallorca,25.0,1998.0,3.2,9,2,7,2,0,4,6,66.7,2,1,1,0,7,16,12,0,Matches,2023-2024,La-Liga
José Luis García Vayá,es ESP,MF,Valencia,24.0,1998.0,36.7,78,53,36,36,6,37,71,52.1,34,41,10,31,49,127,71,0,Matches,2023-2024,La-Liga
Borja Vázquez,es ESP,FW,Cádiz,18.0,2005.0,0.0,1,0,1,0,0,1,1,100.0,0,0,0,0,0,1,1,0,Matches,2023-2024,La-Liga
Jesus Vazquez,es ESP,"DF,MF",Valencia,20.0,2003.0,8.0,24,12,13,8,3,10,16,62.5,6,17,4,13,3,27,24,0,Matches,2023-2024,La-Liga
Kevin Vázquez,es ESP,DF,Celta Vigo,30.0,1993.0,7.8,15,13,7,7,1,12,21,57.1,9,11,3,8,5,20,25,0,Matches,2023-2024,La-Liga
Lucas Vázquez,es ESP,DF,Real Madrid,32.0,1991.0,15.8,37,25,22,14,1,18,25,72.0,7,27,5,22,12,49,36,0,Matches,2023-2024,La-Liga
Gabriel Veiga,es ESP,FW,Celta Vigo,21.0,2002.0,0.2,0,0,0,0,0,0,0,,0,0,0,0,0,0,0,0,Matches,2023-2024,La-Liga
Alejo Véliz,ar ARG,FW,Sevilla,19.0,2003.0,0.4,1,0,0,1,0,1,2,50.0,1,0,0,0,0,1,1,0,Matches,2023-2024,La-Liga
Arthur Vermeeren,be BEL,MF,Atlético Madrid,18.0,2005.0,1.8,1,0,0,1,0,0,1,0.0,1,5,0,5,6,7,2,0,Matches,2023-2024,La-Liga
Mikel Vesga,es ESP,MF,Athletic Club,30.0,1993.0,17.0,40,20,11,23,6,19,49,38.8,30,19,7,12,32,72,35,1,Matches,2023-2024,La-Liga
Carlos Vicente,es ESP,FW,Alavés,24.0,1999.0,12.4,16,6,7,7,2,10,25,40.0,15,4,0,4,4,20,9,0,Matches,2023-2024,La-Liga
Nacho Vidal,es ESP,"DF,FW",Osasuna,28.0,1995.0,1.1,5,4,2,2,1,2,5,40.0,3,2,0,2,0,5,6,0,Matches,2023-2024,La-Liga
Nacho Vidal,es ESP,DF,Mallorca,28.0,1995.0,4.6,12,5,4,5,3,6,13,46.2,7,5,2,3,3,15,9,0,Matches,2023-2024,La-Liga
Fran Vieites,es ESP,GK,Betis,24.0,1999.0,3.5,1,0,1,0,0,1,1,100.0,0,0,0,0,0,1,2,1,Matches,2023-2024,La-Liga
Jonathan Viera,es ESP,"MF,FW",Las Palmas,33.0,1989.0,6.9,6,3,1,2,3,1,9,11.1,8,0,0,0,0,6,1,0,Matches,2023-2024,La-Liga
Jonathan Viera,es ESP,MF,Almería,33.0,1989.0,10.1,19,9,6,9,4,10,19,52.6,9,4,0,4,4,23,1,0,Matches,2023-2024,La-Liga
Toni Villa,es ESP,FW,Girona,28.0,1995.0,0.1,0,0,0,0,0,0,0,,0,0,0,0,0,0,0,0,Matches,2023-2024,La-Liga
Asier Villalibre,es ESP,FW,Athletic Club,25.0,1997.0,5.7,2,1,0,0,2,2,2,100.0,0,2,1,1,0,2,6,0,Matches,2023-2024,La-Liga
Gonzalo Villar,es ESP,MF,Granada,25.0,1998.0,20.0,51,33,26,20,5,26,41,63.4,15,32,10,22,6,57,26,1,Matches,2023-2024,La-Liga
Iván Villar,es ESP,GK,Celta Vigo,26.0,1997.0,11.3,0,0,0,0,0,0,1,0.0,1,0,0,0,0,0,6,0,Matches,2023-2024,La-Liga
Ricardo Visus,es ESP,DF,Betis,22.0,2001.0,1.8,2,2,1,1,0,2,2,100.0,0,2,2,0,2,4,9,1,Matches,2023-2024,La-Liga
Daniel Vivian,es ESP,DF,Athletic Club,24.0,1999.0,32.0,42,28,29,11,2,28,45,62.2,17,49,25,24,31,73,104,0,Matches,2023-2024,La-Liga
Shon Weissman,il ISR,FW,Granada,27.0,1996.0,0.9,1,1,0,0,1,1,4,25.0,3,3,0,3,0,1,1,0,Matches,2023-2024,La-Liga
Iñaki Williams,gh GHA,FW,Athletic Club,29.0,1994.0,31.6,24,17,6,8,10,13,34,38.2,21,42,8,34,14,38,29,0,Matches,2023-2024,La-Liga
Nico Williams,es ESP,FW,Athletic Club,21.0,2002.0,25.1,31,12,9,15,7,13,36,36.1,23,18,2,16,3,34,4,1,Matches,2023-2024,La-Liga
Axel Witsel,be BEL,DF,Atlético Madrid,34.0,1989.0,30.9,35,21,23,12,0,17,24,70.8,7,40,21,19,16,51,119,0,Matches,2023-2024,La-Liga
Xeber,es ESP,"FW,MF",Alavés,26.0,1997.0,3.4,5,5,3,2,0,3,7,42.9,4,2,1,1,1,6,2,0,Matches,2023-2024,La-Liga
Antal Yaakobishvili,hu HUN,DF,Girona,19.0,2004.0,0.7,2,1,1,1,0,1,1,100.0,0,0,0,0,3,5,3,0,Matches,2023-2024,La-Liga
Lamine Yamal,es ESP,FW,Barcelona,16.0,2007.0,24.5,61,37,32,15,14,18,48,37.5,30,32,0,32,19,80,11,0,Matches,2023-2024,La-Liga
Roman Yaremchuk,ua UKR,FW,Valencia,27.0,1995.0,10.3,5,2,1,2,2,3,6,50.0,3,4,0,4,1,6,9,0,Matches,2023-2024,La-Liga
Arsen Zakharyan,ru RUS,"MF,FW",Real Sociedad,20.0,2003.0,13.6,22,15,8,11,3,9,22,40.9,13,16,0,16,4,26,10,0,Matches,2023-2024,La-Liga
Joseba Zaldúa,es ESP,DF,Cádiz,31.0,1992.0,7.8,20,12,17,2,1,13,21,61.9,8,6,4,2,2,22,20,0,Matches,2023-2024,La-Liga
Bryan Zaragoza,es ESP,"MF,FW",Granada,22.0,2001.0,18.2,18,9,8,6,4,8,23,34.8,15,9,0,9,3,21,3,0,Matches,2023-2024,La-Liga
Igor Zubeldia,es ESP,DF,Real Sociedad,26.0,1997.0,28.0,32,25,20,10,2,19,26,73.1,7,28,19,9,32,64,97,3,Matches,2023-2024,La-Liga
Martín Zubimendi,es ESP,MF,Real Sociedad,24.0,1999.0,29.5,49,27,18,29,2,23,42,54.8,19,33,9,24,37,86,54,0,Matches,2023-2024,La-Liga
David Abraham,ar ARG,DF,Eint Frankfurt,34.0,1986.0,13.6,18,12,13,3,2,11,17,64.7,6,13,4,9,17,35,34,0,Matches,2020-2021,Bundesliga
Amir Abrashi,al ALB,"MF,DF",Freiburg,30.0,1990.0,0.7,1,1,1,0,0,0,0,,0,1,1,0,2,3,1,0,Matches,2020-2021,Bundesliga
Ragnar Ache,de GER,"FW,DF",Eint Frankfurt,22.0,1998.0,1.1,2,0,0,1,1,0,0,,0,1,0,1,1,3,1,0,Matches,2020-2021,Bundesliga
Tyler Adams,us USA,"MF,DF",RB Leipzig,21.0,1999.0,20.6,35,24,12,15,8,17,31,54.8,14,22,5,17,29,64,30,0,Matches,2020-2021,Bundesliga
Sargis Adamyan,am ARM,"FW,MF",Hoffenheim,27.0,1993.0,5.3,9,4,4,3,2,7,14,50.0,7,2,0,2,6,15,1,0,Matches,2020-2021,Bundesliga
Felix Agu,de GER,DF,Werder Bremen,20.0,1999.0,7.8,20,9,10,9,1,10,18,55.6,8,14,3,11,12,32,18,0,Matches,2020-2021,Bundesliga
Naouirou Ahamada,fr FRA,MF,Stuttgart,18.0,2002.0,2.8,4,1,3,1,0,1,1,100.0,0,2,0,2,1,5,1,0,Matches,2020-2021,Bundesliga
Manuel Akanji,ch SUI,DF,Dortmund,25.0,1995.0,26.1,41,22,23,12,6,19,31,61.3,12,23,10,13,49,90,70,1,Matches,2020-2021,Bundesliga
Kevin Akpoguma,ng NGA,DF,Hoffenheim,25.0,1995.0,13.2,18,12,11,6,1,8,14,57.1,6,28,15,13,13,31,32,2,Matches,2020-2021,Bundesliga
David Alaba,at AUT,"DF,MF",Bayern Munich,28.0,1992.0,29.7,37,21,14,19,4,17,32,53.1,15,29,13,16,43,80,60,0,Matches,2020-2021,Bundesliga
Lucas Alario,ar ARG,FW,Leverkusen,27.0,1992.0,13.8,8,2,2,5,1,2,4,50.0,2,9,1,8,2,10,10,0,Matches,2020-2021,Bundesliga
Omar Alderete,py PAR,DF,Hertha BSC,23.0,1996.0,14.4,16,10,11,5,0,7,16,43.8,9,14,10,4,21,37,61,1,Matches,2020-2021,Bundesliga
Nadiem Amiri,de GER,MF,Leverkusen,23.0,1996.0,21.0,12,7,4,8,0,7,33,21.2,26,18,3,15,12,24,7,0,Matches,2020-2021,Bundesliga
Sebastian Andersson,se SWE,FW,Köln,29.0,1991.0,12.5,3,2,0,3,0,1,8,12.5,7,10,3,7,2,5,9,0,Matches,2020-2021,Bundesliga
Robert Andrich,de GER,MF,Union Berlin,25.0,1994.0,28.1,51,24,22,27,2,24,53,45.3,29,40,6,34,51,102,31,2,Matches,2020-2021,Bundesliga
Angeliño,es ESP,"DF,FW",RB Leipzig,23.0,1997.0,24.0,31,19,10,18,3,13,24,54.2,11,22,1,21,30,61,40,0,Matches,2020-2021,Bundesliga
Waldemar Anton,de GER,DF,Stuttgart,24.0,1996.0,30.1,31,20,17,14,0,12,31,38.7,19,28,18,10,47,78,114,0,Matches,2020-2021,Bundesliga
Charles Aránguiz,cl CHI,MF,Leverkusen,31.0,1989.0,18.5,41,23,16,21,4,17,43,39.5,26,32,4,28,33,74,17,0,Matches,2020-2021,Bundesliga
Santiago Arias,co COL,DF,Leverkusen,28.0,1992.0,1.0,2,1,0,1,1,1,1,100.0,0,0,0,0,1,3,4,0,Matches,2020-2021,Bundesliga
Maximilian Arnold,de GER,MF,Wolfsburg,26.0,1994.0,28.7,47,32,20,26,1,18,49,36.7,31,24,3,21,49,96,57,0,Matches,2020-2021,Bundesliga
Tolu Arokodare,ng NGA,"FW,MF",Köln,19.0,2000.0,1.2,1,1,0,0,1,0,0,,0,1,0,1,1,2,0,0,Matches,2020-2021,Bundesliga
Santiago Ascacíbar,ar ARG,MF,Hertha BSC,23.0,1997.0,8.5,30,15,15,14,1,15,28,53.6,13,23,2,21,13,43,14,0,Matches,2020-2021,Bundesliga
Ludwig Augustinsson,se SWE,"DF,FW",Werder Bremen,26.0,1994.0,21.7,37,20,19,14,4,17,29,58.6,12,21,7,14,20,57,62,0,Matches,2020-2021,Bundesliga
Taiwo Awoniyi,ng NGA,FW,Union Berlin,22.0,1997.0,15.1,5,3,2,3,0,1,14,7.1,13,9,0,9,3,8,4,0,Matches,2020-2021,Bundesliga
Mehmet Aydin,de GER,DF,Schalke 04,18.0,2002.0,5.6,15,7,9,6,0,4,10,40.0,6,6,1,5,6,21,16,0,Matches,2020-2021,Bundesliga
Leon Bailey,jm JAM,"FW,MF",Leverkusen,22.0,1997.0,23.8,14,8,3,7,4,4,15,26.7,11,13,0,13,9,23,3,0,Matches,2020-2021,Bundesliga
Ridle Baku,de GER,"FW,DF",Wolfsburg,22.0,1998.0,29.8,50,31,20,20,10,22,53,41.5,31,54,4,50,40,90,33,1,Matches,2020-2021,Bundesliga
Ridle Baku,de GER,DF,Mainz 05,22.0,1998.0,2.0,4,2,3,1,0,2,6,33.3,4,3,1,2,3,7,6,0,Matches,2020-2021,Bundesliga
Philipp Bargfrede,de GER,MF,Werder Bremen,31.0,1989.0,0.3,0,0,0,0,0,0,0,,0,0,0,0,0,0,3,0,Matches,2020-2021,Bundesliga
Aymen Barkok,ma MAR,"MF,DF",Eint Frankfurt,22.0,1998.0,10.9,29,15,11,9,9,10,31,32.3,21,15,1,14,10,39,9,1,Matches,2020-2021,Bundesliga
Leandro Barreiro Martins,lu LUX,MF,Mainz 05,20.0,2000.0,25.6,58,32,19,26,13,20,50,40.0,30,34,9,25,57,115,55,0,Matches,2020-2021,Bundesliga
Jacob Barrett Laursen,dk DEN,DF,Arminia,25.0,1994.0,12.3,23,12,13,8,2,10,16,62.5,6,14,4,10,24,47,37,0,Matches,2020-2021,Bundesliga
Oliver Baumann,de GER,GK,Hoffenheim,30.0,1990.0,31.0,0,0,0,0,0,0,1,0.0,1,0,0,0,2,2,14,0,Matches,2020-2021,Bundesliga
Julian Baumgartlinger,at AUT,MF,Leverkusen,32.0,1988.0,11.9,43,20,14,26,3,16,31,51.6,15,12,0,12,12,55,10,1,Matches,2020-2021,Bundesliga
Christoph Baumgartner,at AUT,"MF,FW",Hoffenheim,20.0,1999.0,26.3,44,31,13,24,7,14,51,27.5,37,40,8,32,24,68,24,0,Matches,2020-2021,Bundesliga
Noah Joel Sarenren Bazee,ng NGA,"FW,MF",Augsburg,23.0,1996.0,0.4,0,0,0,0,0,0,1,0.0,1,0,0,0,1,1,0,0,Matches,2020-2021,Bundesliga
Ihlas Bebou,tg TOG,"FW,MF",Hoffenheim,26.0,1994.0,24.4,24,9,5,10,9,8,14,57.1,6,18,4,14,17,41,16,0,Matches,2020-2021,Bundesliga
Sheraldo Becker,sr SUR,"FW,MF",Union Berlin,25.0,1995.0,12.3,5,4,2,2,1,3,5,60.0,2,4,0,4,6,11,7,0,Matches,2020-2021,Bundesliga
Timo Becker,de GER,DF,Schalke 04,23.0,1997.0,18.2,34,23,28,6,0,16,25,64.0,9,18,4,14,22,56,58,0,Matches,2020-2021,Bundesliga
Brian Behrendt,de GER,DF,Arminia,28.0,1991.0,0.9,0,0,0,0,0,0,1,0.0,1,0,0,0,0,0,1,0,Matches,2020-2021,Bundesliga
Maximilian Beier,de GER,"FW,DF",Hoffenheim,17.0,2002.0,0.1,0,0,0,0,0,0,1,0.0,1,0,0,0,0,0,0,0,Matches,2020-2021,Bundesliga
Ishak Belfodil,dz ALG,"FW,MF",Hoffenheim,28.0,1992.0,6.6,3,2,0,0,3,0,2,0.0,2,1,0,1,1,4,3,0,Matches,2020-2021,Bundesliga
Stefan Bell,de GER,DF,Mainz 05,28.0,1991.0,14.1,24,18,15,9,0,14,23,60.9,9,19,11,8,27,51,76,1,Matches,2020-2021,Bundesliga
Karim Bellarabi,de GER,"FW,MF",Leverkusen,30.0,1990.0,8.9,12,10,3,4,5,4,17,23.5,13,12,0,12,12,24,4,0,Matches,2020-2021,Bundesliga
Jude Bellingham,eng ENG,MF,Dortmund,17.0,2003.0,18.9,49,31,11,29,9,19,46,41.3,27,37,5,32,24,73,13,0,Matches,2020-2021,Bundesliga
Lars Bender,de GER,DF,Leverkusen,31.0,1989.0,10.4,19,13,12,6,1,9,21,42.9,12,19,5,14,16,35,19,0,Matches,2020-2021,Bundesliga
Sven Bender,de GER,DF,Leverkusen,31.0,1989.0,13.0,17,9,8,8,1,7,20,35.0,13,20,9,11,21,38,41,1,Matches,2020-2021,Bundesliga
László Bénes,sk SVK,MF,Augsburg,22.0,1997.0,7.3,8,6,4,4,0,2,8,25.0,6,6,2,4,7,15,1,1,Matches,2020-2021,Bundesliga
László Bénes,sk SVK,MF,Gladbach,22.0,1997.0,1.7,6,2,5,1,0,2,4,50.0,2,0,0,0,2,8,1,0,Matches,2020-2021,Bundesliga
Ramy Bensebaini,dz ALG,DF,Gladbach,25.0,1995.0,20.1,43,24,27,13,3,26,42,61.9,16,39,7,32,47,90,66,0,Matches,2020-2021,Bundesliga
Nabil Bentaleb,dz ALG,MF,Schalke 04,25.0,1994.0,6.1,14,8,7,6,1,4,15,26.7,11,5,2,3,6,20,8,0,Matches,2020-2021,Bundesliga
Jordan Beyer,de GER,DF,Gladbach,20.0,2000.0,2.1,2,1,2,0,0,1,2,50.0,1,5,4,1,5,7,5,0,Matches,2020-2021,Bundesliga
Bartosz Białek,pl POL,"FW,MF",Wolfsburg,18.0,2001.0,3.0,6,5,1,4,1,4,4,100.0,0,5,1,4,3,9,4,0,Matches,2020-2021,Bundesliga
Ermin Bičakčić,ba BIH,DF,Hoffenheim,30.0,1990.0,1.4,1,1,0,1,0,1,1,100.0,0,1,1,0,3,4,9,0,Matches,2020-2021,Bundesliga
Leonardo Bittencourt,de GER,"MF,FW",Werder Bremen,26.0,1993.0,16.8,58,32,24,28,6,16,51,31.4,35,29,2,27,13,71,10,0,Matches,2020-2021,Bundesliga
Jérôme Boateng,de GER,DF,Bayern Munich,31.0,1988.0,26.3,26,16,17,8,1,14,32,43.8,18,24,17,7,40,66,63,1,Matches,2020-2021,Bundesliga
Jean-Paul Boëtius,nl NED,"MF,FW",Mainz 05,26.0,1994.0,22.9,42,28,13,15,14,17,47,36.2,30,37,3,34,33,75,14,0,Matches,2020-2021,Bundesliga
Melayro Bogarde,nl NED,"DF,MF",Hoffenheim,18.0,2002.0,3.1,7,3,3,3,1,5,9,55.6,4,0,0,0,5,12,1,0,Matches,2020-2021,Bundesliga
Elias Bördner,de GER,GK,Eint Frankfurt,18.0,2002.0,1.0,1,0,1,0,0,1,1,100.0,0,0,0,0,2,3,1,0,Matches,2020-2021,Bundesliga
Dennis Borkowski,de GER,"MF,FW",RB Leipzig,18.0,2002.0,0.1,0,0,0,0,0,0,0,,0,1,0,1,0,0,0,0,Matches,2020-2021,Bundesliga
Sebastiaan Bornauw,be BEL,DF,Köln,21.0,1999.0,23.1,29,20,25,4,0,14,25,56.0,11,33,26,7,40,69,104,0,Matches,2020-2021,Bundesliga
Nassim Boujellab,ma MAR,"MF,FW",Schalke 04,21.0,1999.0,6.7,13,9,2,10,1,2,12,16.7,10,10,3,7,7,20,9,0,Matches,2020-2021,Bundesliga
Dedryck Boyata,be BEL,DF,Hertha BSC,29.0,1990.0,17.2,14,7,10,3,1,7,15,46.7,8,23,20,3,26,40,68,1,Matches,2020-2021,Bundesliga
Can Bozdogan,de GER,"MF,FW",Schalke 04,19.0,2001.0,7.2,13,5,6,6,1,4,15,26.7,11,10,2,8,7,20,5,0,Matches,2020-2021,Bundesliga
Julian Brandt,de GER,"FW,MF",Dortmund,24.0,1996.0,16.6,27,14,13,9,5,12,43,27.9,31,25,1,24,17,44,7,1,Matches,2020-2021,Bundesliga
Fabian Bredlow,de GER,GK,Stuttgart,25.0,1995.0,1.0,0,0,0,0,0,0,0,,0,0,0,0,0,0,0,0,Matches,2020-2021,Bundesliga
Josip Brekalo,hr CRO,FW,Wolfsburg,22.0,1998.0,20.2,22,10,10,7,5,8,29,27.6,21,18,0,18,17,39,3,1,Matches,2020-2021,Bundesliga
Joshua Brenet,cw CUW,DF,Hoffenheim,26.0,1994.0,0.0,0,0,0,0,0,0,0,,0,0,0,0,0,0,0,0,Matches,2020-2021,Bundesliga
John Brooks,us USA,DF,Wolfsburg,27.0,1993.0,30.8,47,29,33,14,0,30,54,55.6,24,35,10,25,55,102,134,0,Matches,2020-2021,Bundesliga
Daniel Brosinski,de GER,"DF,FW",Mainz 05,32.0,1988.0,15.9,19,14,10,7,2,12,31,38.7,19,18,1,17,14,33,33,0,Matches,2020-2021,Bundesliga
Cédric Brunner,ch SUI,DF,Arminia,26.0,1994.0,29.5,42,22,24,15,3,27,40,67.5,13,30,10,20,42,84,96,0,Matches,2020-2021,Bundesliga
Jacob Bruun Larsen,dk DEN,"MF,FW",Hoffenheim,21.0,1998.0,1.0,0,0,0,0,0,0,0,,0,0,0,0,0,0,0,0,Matches,2020-2021,Bundesliga
Marius Bülter,de GER,"FW,MF",Union Berlin,27.0,1993.0,10.9,15,8,6,6,3,5,17,29.4,12,17,2,15,12,27,11,0,Matches,2020-2021,Bundesliga
Jonathan Burkardt,de GER,"FW,MF",Mainz 05,20.0,2000.0,15.3,27,13,15,10,2,11,19,57.9,8,20,3,17,8,35,15,0,Matches,2020-2021,Bundesliga
Nishan Burkart,ch SUI,MF,Freiburg,20.0,2000.0,0.2,0,0,0,0,0,0,1,0.0,1,0,0,0,0,0,0,0,Matches,2020-2021,Bundesliga
Roman Bürki,ch SUI,GK,Dortmund,29.0,1990.0,18.5,0,0,0,0,0,0,0,,0,0,0,0,0,0,5,1,Matches,2020-2021,Bundesliga
Kerim Calhanoglu,de GER,DF,Schalke 04,17.0,2002.0,3.3,3,3,1,1,1,0,3,0.0,3,4,0,4,7,10,6,0,Matches,2020-2021,Bundesliga
Daniel Caligiuri,it ITA,"MF,FW",Augsburg,32.0,1988.0,29.6,71,46,29,31,11,29,92,31.5,63,45,6,39,38,109,41,0,Matches,2020-2021,Bundesliga
Emre Can,de GER,"DF,MF",Dortmund,26.0,1994.0,23.7,43,34,20,20,3,20,37,54.1,17,35,10,25,48,91,52,0,Matches,2020-2021,Bundesliga
Koen Casteels,be BEL,GK,Wolfsburg,28.0,1992.0,32.0,0,0,0,0,0,0,1,0.0,1,1,0,1,2,2,9,2,Matches,2020-2021,Bundesliga
Gonzalo Castro,de GER,MF,Stuttgart,33.0,1987.0,19.2,21,7,6,9,6,8,23,34.8,15,16,3,13,8,29,12,0,Matches,2020-2021,Bundesliga
Sava Cestic,rs SRB,DF,Köln,19.0,2001.0,10.0,20,9,12,6,2,8,17,47.1,9,13,4,9,18,38,40,0,Matches,2020-2021,Bundesliga
Timothy Chandler,us USA,DF,Eint Frankfurt,30.0,1990.0,4.8,4,0,2,1,1,1,4,25.0,3,5,2,3,3,7,5,0,Matches,2020-2021,Bundesliga
Kwon Chang-hoon,kr KOR,"MF,FW",Freiburg,26.0,1994.0,2.4,3,1,1,0,2,1,3,33.3,2,3,1,2,7,10,2,1,Matches,2020-2021,Bundesliga
Tahith Chong,nl NED,"MF,FW",Werder Bremen,20.0,1999.0,4.3,11,6,1,9,1,4,8,50.0,4,4,0,4,5,16,1,0,Matches,2020-2021,Bundesliga
Darko Churlinov,mk MKD,"DF,MF",Stuttgart,20.0,2000.0,2.4,2,2,2,0,0,1,3,33.3,2,5,1,4,0,2,2,0,Matches,2020-2021,Bundesliga
Tim Civeja,al ALB,MF,Augsburg,18.0,2002.0,0.4,0,0,0,0,0,0,1,0.0,1,0,0,0,3,3,0,0,Matches,2020-2021,Bundesliga
Kingsley Coman,fr FRA,"FW,MF",Bayern Munich,24.0,1996.0,19.5,14,8,6,7,1,2,21,9.5,19,22,0,22,4,18,3,0,Matches,2020-2021,Bundesliga
Jhon Córdoba,co COL,FW,Hertha BSC,27.0,1993.0,17.1,9,4,1,5,3,2,4,50.0,2,13,2,11,6,15,4,0,Matches,2020-2021,Bundesliga
Sergio Córdova,ve VEN,"FW,MF",Arminia,22.0,1997.0,12.1,16,8,0,10,6,2,15,13.3,13,14,3,11,9,25,9,0,Matches,2020-2021,Bundesliga
Danny da Costa,de GER,"DF,FW",Mainz 05,27.0,1993.0,13.4,22,16,6,9,7,13,27,48.1,14,17,2,15,17,39,27,0,Matches,2020-2021,Bundesliga
Danny da Costa,de GER,DF,Eint Frankfurt,27.0,1993.0,1.2,0,0,0,0,0,0,1,0.0,1,3,1,2,0,0,4,0,Matches,2020-2021,Bundesliga
Douglas Costa,br BRA,"FW,MF",Bayern Munich,29.0,1990.0,3.6,2,1,1,1,0,1,3,33.3,2,7,0,7,2,4,1,0,Matches,2020-2021,Bundesliga
Tanguy Coulibaly,fr FRA,"DF,FW",Stuttgart,19.0,2001.0,16.7,26,15,10,7,9,11,23,47.8,12,20,0,20,10,36,11,0,Matches,2020-2021,Bundesliga
Mickaël Cuisance,fr FRA,FW,Bayern Munich,20.0,1999.0,0.2,0,0,0,0,0,0,0,,0,1,0,1,0,0,0,0,Matches,2020-2021,Bundesliga
Matheus Cunha,br BRA,"FW,MF",Hertha BSC,21.0,1999.0,23.9,36,16,10,19,7,13,49,26.5,36,29,2,27,31,67,9,0,Matches,2020-2021,Bundesliga
Rafael Czichos,de GER,DF,Köln,30.0,1990.0,25.1,48,24,33,13,2,23,42,54.8,19,25,9,16,53,101,109,0,Matches,2020-2021,Bundesliga
Moanes Dabbur,il ISR,"FW,MF",Hoffenheim,28.0,1992.0,11.1,6,3,3,1,2,1,13,7.7,12,6,0,6,9,15,7,0,Matches,2020-2021,Bundesliga
Finn Dahmen,de GER,GK,Mainz 05,22.0,1998.0,3.0,0,0,0,0,0,0,1,0.0,1,0,0,0,0,0,1,0,Matches,2020-2021,Bundesliga
Mahmoud Dahoud,de GER,MF,Dortmund,24.0,1996.0,14.0,30,18,9,20,1,14,38,36.8,24,23,5,18,18,48,11,1,Matches,2020-2021,Bundesliga
Leon Dajaku,de GER,FW,Union Berlin,19.0,2001.0,0.4,0,0,0,0,0,0,0,,0,0,0,0,0,0,0,0,Matches,2020-2021,Bundesliga
Tiago Dantas,pt POR,MF,Bayern Munich,19.0,2000.0,0.8,1,1,0,0,1,0,0,,0,0,0,0,0,1,0,0,Matches,2020-2021,Bundesliga
Márton Dárdai,hu HUN,"DF,MF",Hertha BSC,18.0,2002.0,9.1,17,10,10,6,1,9,16,56.3,7,7,3,4,16,33,31,0,Matches,2020-2021,Bundesliga
Vladimír Darida,cz CZE,MF,Hertha BSC,29.0,1990.0,21.1,34,19,11,19,4,9,31,29.0,22,34,2,32,27,61,18,0,Matches,2020-2021,Bundesliga
Alphonso Davies,ca CAN,DF,Bayern Munich,19.0,2000.0,19.6,39,27,16,17,6,28,40,70.0,12,21,1,20,28,67,33,1,Matches,2020-2021,Bundesliga
Thomas Delaney,dk DEN,MF,Dortmund,28.0,1991.0,14.3,40,30,15,20,5,11,31,35.5,20,28,10,18,22,62,15,1,Matches,2020-2021,Bundesliga
Kerem Demirbay,de GER,MF,Leverkusen,27.0,1993.0,19.4,46,31,15,26,5,19,38,50.0,19,21,4,17,8,54,6,1,Matches,2020-2021,Bundesliga
Ermedin Demirović,ba BIH,FW,Freiburg,22.0,1998.0,16.6,15,9,4,6,5,2,16,12.5,14,29,5,24,0,15,27,0,Matches,2020-2021,Bundesliga
Emmanuel Dennis,ng NGA,FW,Köln,22.0,1997.0,5.3,13,7,6,5,2,1,6,16.7,5,6,0,6,0,13,0,1,Matches,2020-2021,Bundesliga
Mike van der Hoorn,nl NED,DF,Arminia,27.0,1992.0,15.1,8,4,3,5,0,1,3,33.3,2,12,8,4,27,35,73,0,Matches,2020-2021,Bundesliga
Moussa Diaby,fr FRA,"FW,MF",Leverkusen,21.0,1999.0,26.5,10,6,4,5,1,6,20,30.0,14,11,0,11,12,22,5,0,Matches,2020-2021,Bundesliga
Daniel Didavi,de GER,"MF,FW",Stuttgart,30.0,1990.0,10.8,16,6,2,9,5,7,12,58.3,5,10,0,10,3,19,8,0,Matches,2020-2021,Bundesliga
Javairô Dilrosun,nl NED,"FW,MF",Hertha BSC,22.0,1998.0,5.9,5,3,2,2,1,1,6,16.7,5,5,0,5,4,9,3,0,Matches,2020-2021,Bundesliga
Eren Dinkçi,de GER,"MF,FW",Werder Bremen,18.0,2001.0,1.2,1,1,1,0,0,0,1,0.0,1,4,0,4,2,3,1,0,Matches,2020-2021,Bundesliga
Jonas Dirkner,de GER,MF,Hertha BSC,18.0,2002.0,0.2,0,0,0,0,0,0,0,,0,0,0,0,0,0,0,0,Matches,2020-2021,Bundesliga
Ritsu Doan,jp JPN,"MF,FW",Arminia,22.0,1998.0,30.8,53,31,22,19,12,19,52,36.5,33,42,1,41,31,84,11,0,Matches,2020-2021,Bundesliga
Ji Dong-won,kr KOR,FW,Mainz 05,29.0,1991.0,0.7,1,1,1,0,0,0,0,,0,1,0,1,2,3,0,0,Matches,2020-2021,Bundesliga
Bas Dost,nl NED,FW,Eint Frankfurt,31.0,1989.0,9.1,3,2,1,1,1,2,5,40.0,3,5,1,4,2,5,8,0,Matches,2020-2021,Bundesliga
Aleksandar Dragović,at AUT,DF,Leverkusen,29.0,1991.0,12.6,11,7,5,5,1,9,13,69.2,4,17,5,12,13,24,33,0,Matches,2020-2021,Bundesliga
Dominick Drexler,de GER,"MF,FW",Köln,30.0,1990.0,13.7,36,26,15,18,3,12,30,40.0,18,5,1,4,14,50,15,0,Matches,2020-2021,Bundesliga
Ondrej Duda,sk SVK,"FW,MF",Köln,25.0,1994.0,28.2,36,14,13,18,5,8,39,20.5,31,28,2,26,19,55,20,0,Matches,2020-2021,Bundesliga
Erik Durm,de GER,DF,Eint Frankfurt,28.0,1992.0,16.4,17,13,7,9,1,8,21,38.1,13,19,5,14,29,46,26,0,Matches,2020-2021,Bundesliga
Johannes Eggestein,de GER,"FW,MF",Werder Bremen,22.0,1998.0,0.4,0,0,0,0,0,0,1,0.0,1,0,0,0,1,1,2,0,Matches,2020-2021,Bundesliga
Maximilian Eggestein,de GER,MF,Werder Bremen,23.0,1996.0,32.7,57,42,22,29,6,21,46,45.7,25,30,5,25,43,100,36,0,Matches,2020-2021,Bundesliga
Lilian Egloff,de GER,MF,Stuttgart,17.0,2002.0,0.2,0,0,0,0,0,0,0,,0,0,0,0,0,0,0,0,Matches,2020-2021,Bundesliga
Kingsley Ehizibue,nl NED,DF,Köln,25.0,1995.0,12.6,32,19,22,9,1,10,17,58.8,7,19,5,14,18,50,42,0,Matches,2020-2021,Bundesliga
Nico Elvedi,ch SUI,DF,Gladbach,23.0,1996.0,28.2,49,35,36,12,1,25,37,67.6,12,38,22,16,65,114,123,0,Matches,2020-2021,Bundesliga
Breel Embolo,ch SUI,"FW,MF",Gladbach,23.0,1997.0,16.0,15,10,1,13,1,0,6,0.0,6,16,1,15,8,23,8,0,Matches,2020-2021,Bundesliga
Keita Endo,jp JPN,"MF,FW",Union Berlin,22.0,1997.0,5.1,8,3,1,5,2,3,9,33.3,6,5,2,3,6,14,4,0,Matches,2020-2021,Bundesliga
Wataru Endo,jp JPN,MF,Stuttgart,27.0,1993.0,32.8,65,44,25,34,6,29,71,40.8,42,53,14,39,51,116,59,0,Matches,2020-2021,Bundesliga
Patrick Erras,de GER,"FW,MF",Werder Bremen,25.0,1995.0,0.3,0,0,0,0,0,0,1,0.0,1,0,0,0,0,0,0,0,Matches,2020-2021,Bundesliga
Ralf Fährmann,de GER,GK,Schalke 04,31.0,1988.0,20.8,2,1,2,0,0,1,2,50.0,1,0,0,0,1,3,9,3,Matches,2020-2021,Bundesliga
Ohis Felix Uduokhai,de GER,DF,Augsburg,22.0,1997.0,29.0,33,24,19,10,4,18,27,66.7,9,48,25,23,54,87,164,2,Matches,2020-2021,Bundesliga
Edimilson Fernandes,ch SUI,"MF,FW",Mainz 05,24.0,1996.0,9.3,8,4,4,4,0,4,7,57.1,3,12,4,8,29,37,25,0,Matches,2020-2021,Bundesliga
Alfreð Finnbogason,is ISL,FW,Augsburg,31.0,1989.0,6.0,2,1,0,1,1,0,1,0.0,1,7,1,6,1,3,4,0,Matches,2020-2021,Bundesliga
Mark Flekken,nl NED,GK,Freiburg,27.0,1993.0,3.0,0,0,0,0,0,0,0,,0,0,0,0,0,0,1,0,Matches,2020-2021,Bundesliga
Florian Flick,de GER,MF,Schalke 04,20.0,2000.0,4.0,10,7,4,6,0,7,16,43.8,9,4,3,1,7,17,5,1,Matches,2020-2021,Bundesliga
Emil Forsberg,se SWE,"FW,MF",RB Leipzig,28.0,1991.0,17.1,11,6,1,6,4,5,27,18.5,22,10,1,9,11,22,4,0,Matches,2020-2021,Bundesliga
Philipp Förster,de GER,MF,Stuttgart,25.0,1995.0,16.8,22,13,7,12,3,6,25,24.0,19,18,1,17,15,37,2,0,Matches,2020-2021,Bundesliga
Timothy Fosu-Mensah,nl NED,DF,Leverkusen,22.0,1998.0,4.5,4,2,1,2,1,2,4,50.0,2,7,3,4,7,11,4,0,Matches,2020-2021,Bundesliga
Raphael Framberger,de GER,DF,Augsburg,24.0,1995.0,17.1,42,23,26,11,5,19,25,76.0,6,24,2,22,36,78,62,1,Matches,2020-2021,Bundesliga
Marco Friedl,at AUT,DF,Werder Bremen,22.0,1998.0,30.9,50,34,31,17,2,30,62,48.4,32,38,17,21,55,105,118,1,Matches,2020-2021,Bundesliga
Marvin Friedrich,de GER,DF,Union Berlin,24.0,1995.0,34.0,47,29,35,11,1,18,32,56.3,14,38,18,20,52,99,109,0,Matches,2020-2021,Bundesliga
Jeremie Frimpong,nl NED,"DF,FW",Leverkusen,19.0,2000.0,4.8,7,4,4,3,0,4,8,50.0,4,4,0,4,1,8,7,0,Matches,2020-2021,Bundesliga
Niclas Füllkrug,de GER,FW,Werder Bremen,27.0,1993.0,9.7,7,3,2,4,1,1,13,7.7,12,10,4,6,3,10,13,0,Matches,2020-2021,Bundesliga
Mijat Gaćinović,rs SRB,"DF,MF",Hoffenheim,25.0,1995.0,9.1,18,10,6,11,1,9,24,37.5,15,13,0,13,18,36,15,0,Matches,2020-2021,Bundesliga
Christian Gebauer,at AUT,"MF,FW",Arminia,26.0,1993.0,7.6,9,4,2,5,2,4,11,36.4,7,4,1,3,6,15,14,0,Matches,2020-2021,Bundesliga
Theodor Gebre Selassie,cz CZE,DF,Werder Bremen,33.0,1986.0,33.7,61,35,39,17,5,28,64,43.8,36,33,11,22,58,119,98,1,Matches,2020-2021,Bundesliga
Emrehan Gedikli,de GER,FW,Leverkusen,17.0,2003.0,0.3,0,0,0,0,0,0,0,,0,0,0,0,0,0,0,0,Matches,2020-2021,Bundesliga
Dennis Geiger,de GER,MF,Hoffenheim,22.0,1998.0,7.3,13,10,3,8,2,5,8,62.5,3,10,0,10,3,16,0,0,Matches,2020-2021,Bundesliga
Christian Gentner,de GER,MF,Union Berlin,34.0,1985.0,11.5,17,8,9,5,3,5,18,27.8,13,13,1,12,17,34,16,0,Matches,2020-2021,Bundesliga
Yannick Gerhardt,de GER,"MF,FW",Wolfsburg,26.0,1994.0,21.5,52,32,14,32,6,21,52,40.4,31,34,4,30,21,73,30,0,Matches,2020-2021,Bundesliga
Hamadi Al Ghaddioui,ma MAR,FW,Stuttgart,29.0,1990.0,0.5,0,0,0,0,0,0,1,0.0,1,0,0,0,0,0,0,0,Matches,2020-2021,Bundesliga
Niko Gießelmann,de GER,DF,Union Berlin,28.0,1991.0,4.8,12,9,7,4,1,5,8,62.5,3,9,3,6,8,20,13,1,Matches,2020-2021,Bundesliga
Rafał Gikiewicz,pl POL,GK,Augsburg,32.0,1987.0,34.0,0,0,0,0,0,0,3,0.0,3,0,0,0,3,3,9,1,Matches,2020-2021,Bundesliga
Daniel Ginczek,de GER,"FW,MF",Wolfsburg,29.0,1991.0,2.4,2,2,1,1,0,2,8,25.0,6,2,0,2,1,3,2,0,Matches,2020-2021,Bundesliga
Matthias Ginter,de GER,DF,Gladbach,26.0,1994.0,34.0,26,16,15,10,1,14,24,58.3,10,43,32,11,51,77,121,0,Matches,2020-2021,Bundesliga
Robert Glatzel,de GER,FW,Mainz 05,26.0,1994.0,4.0,1,0,1,0,0,0,2,0.0,2,2,0,2,0,1,2,0,Matches,2020-2021,Bundesliga
Serge Gnabry,de GER,"FW,MF",Bayern Munich,25.0,1995.0,18.3,39,19,7,19,13,12,32,37.5,20,17,0,17,26,65,3,0,Matches,2020-2021,Bundesliga
Akaki Gogia,de GER,"FW,MF",Union Berlin,28.0,1992.0,1.6,1,0,0,1,0,0,2,0.0,2,0,0,0,1,2,0,0,Matches,2020-2021,Bundesliga
Nicolás González,ar ARG,"FW,MF",Stuttgart,22.0,1998.0,10.4,5,5,1,2,2,0,6,0.0,6,10,3,7,4,9,6,0,Matches,2020-2021,Bundesliga
Leon Goretzka,de GER,MF,Bayern Munich,25.0,1995.0,18.9,37,23,12,21,4,16,39,41.0,23,30,2,28,44,81,11,0,Matches,2020-2021,Bundesliga
Jeffrey Gouweleeuw,nl NED,DF,Augsburg,29.0,1991.0,31.5,36,20,24,11,1,16,33,48.5,17,37,18,19,69,105,149,2,Matches,2020-2021,Bundesliga
Demarai Gray,jm JAM,FW,Leverkusen,24.0,1996.0,4.9,3,2,1,2,0,1,1,100.0,0,3,0,3,4,7,3,0,Matches,2020-2021,Bundesliga
Michael Gregoritsch,at AUT,"FW,MF",Augsburg,26.0,1994.0,9.3,13,10,6,7,0,3,10,30.0,7,2,0,2,3,16,17,0,Matches,2020-2021,Bundesliga
Sebastian Griesbeck,de GER,MF,Union Berlin,29.0,1990.0,9.9,20,9,8,11,1,8,19,42.1,11,13,3,10,5,25,8,0,Matches,2020-2021,Bundesliga
Vincenzo Grifo,it ITA,"MF,FW",Freiburg,27.0,1993.0,25.7,18,7,6,7,5,14,34,41.2,20,13,0,13,27,45,18,1,Matches,2020-2021,Bundesliga
Lennart Grill,de GER,GK,Leverkusen,21.0,1999.0,4.0,0,0,0,0,0,0,0,,0,0,0,0,0,0,2,0,Matches,2020-2021,Bundesliga
Florian Grillitsch,at AUT,"MF,DF",Hoffenheim,24.0,1995.0,20.9,37,21,21,13,3,19,52,36.5,33,38,7,31,51,88,47,1,Matches,2020-2021,Bundesliga
Christian Groß,de GER,"MF,DF",Werder Bremen,31.0,1989.0,16.3,44,28,17,25,2,15,37,40.5,22,12,2,10,24,68,37,0,Matches,2020-2021,Bundesliga
Ilia Gruev,bg BUL,FW,Werder Bremen,20.0,2000.0,0.0,0,0,0,0,0,0,0,,0,0,0,0,0,0,0,0,Matches,2020-2021,Bundesliga
Carlos Gruezo,ec ECU,MF,Augsburg,25.0,1995.0,23.2,57,32,20,32,5,20,52,38.5,32,32,5,27,35,92,29,1,Matches,2020-2021,Bundesliga
Mattéo Guendouzi,fr FRA,MF,Hertha BSC,21.0,1999.0,20.2,24,13,10,12,2,9,25,36.0,16,15,4,11,21,45,24,1,Matches,2020-2021,Bundesliga
Raphaël Guerreiro,pt POR,DF,Dortmund,26.0,1993.0,24.6,30,13,14,8,8,16,31,51.6,15,21,4,17,28,58,31,1,Matches,2020-2021,Bundesliga
Josuha Guilavogui,fr FRA,"MF,DF",Wolfsburg,29.0,1990.0,8.3,17,9,9,8,0,5,12,41.7,7,12,5,7,29,46,25,0,Matches,2020-2021,Bundesliga
Péter Gulácsi,hu HUN,GK,RB Leipzig,30.0,1990.0,33.0,1,0,1,0,0,1,2,50.0,1,0,0,0,2,3,7,0,Matches,2020-2021,Bundesliga
Manuel Gulde,de GER,DF,Freiburg,29.0,1991.0,21.7,27,15,12,12,3,5,21,23.8,16,25,15,10,37,64,64,0,Matches,2020-2021,Bundesliga
Robert Gumny,pl POL,DF,Augsburg,22.0,1998.0,15.3,24,15,12,9,3,15,23,65.2,8,12,2,10,18,42,31,0,Matches,2020-2021,Bundesliga
Christian Günter,de GER,"DF,MF",Freiburg,27.0,1993.0,34.0,34,19,18,13,3,15,43,34.9,28,38,9,29,29,63,40,0,Matches,2020-2021,Bundesliga
Erling Haaland,no NOR,FW,Dortmund,20.0,2000.0,26.7,7,2,1,3,3,1,4,25.0,3,19,4,15,4,11,16,0,Matches,2020-2021,Bundesliga
Janik Haberer,de GER,"MF,FW",Freiburg,26.0,1994.0,5.4,7,4,4,3,0,3,15,20.0,12,4,1,3,7,14,9,0,Matches,2020-2021,Bundesliga
Alexander Hack,de GER,DF,Mainz 05,26.0,1993.0,15.2,32,21,23,8,1,18,31,58.1,13,26,17,9,41,73,91,2,Matches,2020-2021,Bundesliga
André Hahn,de GER,"FW,MF",Augsburg,29.0,1990.0,22.6,31,17,14,13,4,9,44,20.5,35,35,3,32,14,45,24,0,Matches,2020-2021,Bundesliga
Amadou Haidara,ml MLI,"MF,FW",RB Leipzig,22.0,1998.0,21.2,50,28,20,21,9,11,36,30.6,25,33,1,32,30,80,24,0,Matches,2020-2021,Bundesliga
Marcel Halstenberg,de GER,DF,RB Leipzig,28.0,1991.0,18.3,29,18,20,8,1,19,41,46.3,22,15,3,12,16,45,35,0,Matches,2020-2021,Bundesliga
Amine Harit,ma MAR,"MF,FW",Schalke 04,23.0,1997.0,23.3,22,13,8,11,3,10,23,43.5,13,9,1,8,17,39,7,1,Matches,2020-2021,Bundesliga
Marcel Hartel,de GER,MF,Arminia,24.0,1996.0,18.7,35,19,15,18,2,20,40,50.0,20,17,4,13,26,61,16,1,Matches,2020-2021,Bundesliga
Makoto Hasebe,jp JPN,"DF,MF",Eint Frankfurt,36.0,1984.0,25.4,43,29,21,20,2,25,51,49.0,26,31,12,19,31,74,68,2,Matches,2020-2021,Bundesliga
Thorgan Hazard,be BEL,"MF,FW",Dortmund,27.0,1993.0,7.3,8,2,6,1,1,3,13,23.1,10,4,0,4,10,18,1,0,Matches,2020-2021,Bundesliga
Jonas Hector,de GER,"MF,FW",Köln,30.0,1990.0,14.3,34,22,8,21,5,15,35,42.9,20,24,5,19,19,53,20,1,Matches,2020-2021,Bundesliga
Hwang Hee-chan,kr KOR,"FW,MF",RB Leipzig,24.0,1996.0,5.1,3,2,1,0,2,1,7,14.3,6,4,0,4,1,4,1,0,Matches,2020-2021,Bundesliga
Dominique Heintz,de GER,DF,Freiburg,26.0,1993.0,15.2,22,11,19,3,0,10,19,52.6,9,10,8,2,35,57,49,0,Matches,2020-2021,Bundesliga
Benjamin Henrichs,de GER,"DF,MF",RB Leipzig,23.0,1997.0,6.0,12,7,4,5,3,2,9,22.2,7,9,1,8,8,20,8,0,Matches,2020-2021,Bundesliga
Lucas Hernández,fr FRA,DF,Bayern Munich,24.0,1996.0,17.7,41,31,16,17,8,17,31,54.8,14,24,6,18,19,60,38,0,Matches,2020-2021,Bundesliga
Patrick Herrmann,de GER,"FW,MF",Gladbach,29.0,1991.0,9.7,9,6,4,3,2,2,14,14.3,12,16,0,16,10,19,8,0,Matches,2020-2021,Bundesliga
Martin Hinteregger,at AUT,DF,Eint Frankfurt,27.0,1992.0,28.1,77,49,53,22,2,37,63,58.7,26,31,12,19,44,121,92,0,Matches,2020-2021,Bundesliga
Marwin Hitz,ch SUI,GK,Dortmund,32.0,1987.0,15.5,1,1,1,0,0,1,1,100.0,0,0,0,0,0,1,7,1,Matches,2020-2021,Bundesliga
Nicolas Höfler,de GER,MF,Freiburg,30.0,1990.0,30.3,54,28,16,31,7,23,59,39.0,36,34,10,24,66,120,41,2,Matches,2020-2021,Bundesliga
Jonas Hofmann,de GER,"FW,MF",Gladbach,28.0,1992.0,20.2,26,20,12,12,2,10,53,18.9,43,27,2,25,27,53,9,0,Matches,2020-2021,Bundesliga
Marco Höger,de GER,"DF,MF",Köln,30.0,1989.0,0.6,1,0,0,1,0,1,2,50.0,1,2,0,2,2,3,1,0,Matches,2020-2021,Bundesliga
Lucas Höler,de GER,"FW,MF",Freiburg,26.0,1994.0,23.2,36,24,13,19,4,12,32,37.5,20,19,2,17,16,52,14,0,Matches,2020-2021,Bundesliga
Matthew Hoppe,us USA,FW,Schalke 04,19.0,2001.0,14.5,6,6,1,3,2,2,12,16.7,10,8,2,6,4,10,15,0,Matches,2020-2021,Bundesliga
Jannes Horn,de GER,DF,Köln,23.0,1997.0,19.6,35,19,23,11,1,23,31,74.2,8,19,2,17,10,45,45,0,Matches,2020-2021,Bundesliga
Timo Horn,de GER,GK,Köln,27.0,1993.0,33.4,1,0,1,0,0,1,4,25.0,3,1,0,1,0,1,11,2,Matches,2020-2021,Bundesliga
Lukáš Hrádecký,fi FIN,GK,Leverkusen,30.0,1989.0,28.5,0,0,0,0,0,0,1,0.0,1,0,0,0,1,1,11,3,Matches,2020-2021,Bundesliga
Ajdin Hrustic,au AUS,"MF,DF",Eint Frankfurt,24.0,1996.0,3.0,6,5,2,3,1,3,10,30.0,7,2,0,2,4,10,3,0,Matches,2020-2021,Bundesliga
Florian Hübner,de GER,DF,Union Berlin,29.0,1991.0,5.8,10,5,7,3,0,7,15,46.7,8,7,3,4,13,23,21,0,Matches,2020-2021,Bundesliga
Mats Hummels,de GER,DF,Dortmund,31.0,1988.0,31.3,58,40,34,18,6,26,42,61.9,16,31,22,9,73,131,122,2,Matches,2020-2021,Bundesliga
Klaas-Jan Huntelaar,nl NED,FW,Schalke 04,36.0,1983.0,6.5,4,2,0,2,2,0,2,0.0,2,3,1,2,2,6,3,0,Matches,2020-2021,Bundesliga
Iago,br BRA,DF,Augsburg,23.0,1997.0,17.3,37,27,21,13,3,17,29,58.6,12,17,5,12,22,59,55,0,Matches,2020-2021,Bundesliga
Vedad Ibišević,ba BIH,FW,Schalke 04,35.0,1984.0,1.7,0,0,0,0,0,0,0,,0,1,0,1,1,1,1,0,Matches,2020-2021,Bundesliga
Blendi Idrizi,xk KVX,MF,Schalke 04,22.0,1998.0,2.6,8,4,1,6,1,1,1,100.0,0,6,2,4,3,11,1,0,Matches,2020-2021,Bundesliga
Stefan Ilsanker,at AUT,"MF,DF",Eint Frankfurt,31.0,1989.0,17.5,33,20,17,15,1,21,42,50.0,21,30,8,22,30,63,51,2,Matches,2020-2021,Bundesliga
Marcus Ingvartsen,dk DEN,"MF,FW",Union Berlin,24.0,1996.0,21.8,17,11,5,6,6,8,26,30.8,18,22,0,22,18,35,10,0,Matches,2020-2021,Bundesliga
Abass Issah,gh GHA,"DF,FW",Mainz 05,21.0,1998.0,0.2,0,0,0,0,0,0,0,,0,0,0,0,0,0,0,0,Matches,2020-2021,Bundesliga
Ismail Jakobs,sn SEN,"MF,FW",Köln,20.0,1999.0,19.2,25,10,17,4,4,11,21,52.4,10,18,1,17,16,41,36,0,Matches,2020-2021,Bundesliga
Tony Jantschke,de GER,DF,Gladbach,30.0,1990.0,3.0,2,2,1,1,0,1,3,33.3,2,6,4,2,4,6,7,0,Matches,2020-2021,Bundesliga
Rune Jarstein,no NOR,GK,Hertha BSC,35.0,1984.0,8.0,0,0,0,0,0,0,0,,0,0,0,0,0,0,7,1,Matches,2020-2021,Bundesliga
Tin Jedvaj,hr CRO,DF,Leverkusen,24.0,1995.0,1.7,5,2,2,3,0,1,3,33.3,2,2,1,1,2,7,9,0,Matches,2020-2021,Bundesliga
Fredrik Jensen,fi FIN,"FW,MF",Augsburg,22.0,1997.0,4.2,3,2,1,2,0,3,6,50.0,3,4,1,3,2,5,6,0,Matches,2020-2021,Bundesliga
Marco John,de GER,DF,Hoffenheim,18.0,2002.0,11.1,21,15,9,5,7,10,22,45.5,12,18,1,17,16,37,21,0,Matches,2020-2021,Bundesliga
Luka Jović,rs SRB,FW,Eint Frankfurt,22.0,1997.0,9.9,2,0,0,2,0,0,4,0.0,4,3,0,3,1,3,7,0,Matches,2020-2021,Bundesliga
Ozan Kabak,tr TUR,DF,Schalke 04,20.0,2000.0,13.8,17,9,11,5,1,6,13,46.2,7,20,11,9,13,30,57,0,Matches,2020-2021,Bundesliga
Pavel Kadeřábek,cz CZE,"DF,FW",Hoffenheim,28.0,1992.0,17.6,15,12,7,6,2,6,15,40.0,9,12,3,9,18,33,31,0,Matches,2020-2021,Bundesliga
Florian Kainz,at AUT,"MF,FW",Köln,27.0,1992.0,5.0,4,2,0,4,0,2,8,25.0,6,7,0,7,3,7,3,0,Matches,2020-2021,Bundesliga
Sasa Kalajdzic,at AUT,FW,Stuttgart,23.0,1997.0,23.7,16,12,4,5,7,2,17,11.8,15,10,1,9,9,25,21,0,Matches,2020-2021,Bundesliga
Daichi Kamada,jp JPN,MF,Eint Frankfurt,23.0,1996.0,26.2,48,28,21,16,11,16,49,32.7,33,18,1,17,14,62,22,0,Matches,2020-2021,Bundesliga
Marcin Kamiński,pl POL,DF,Stuttgart,28.0,1992.0,2.4,1,1,0,0,1,0,0,,0,2,1,1,1,2,10,0,Matches,2020-2021,Bundesliga
Kevin Kampl,si SVN,MF,RB Leipzig,29.0,1990.0,21.5,38,26,9,24,5,18,35,51.4,17,20,2,18,29,67,14,0,Matches,2020-2021,Bundesliga
Jimmy Kaparos,de GER,MF,Schalke 04,18.0,2001.0,0.2,0,0,0,0,0,0,1,0.0,1,0,0,0,0,0,0,0,Matches,2020-2021,Bundesliga
Atakan Karazor,,"DF,MF",Stuttgart,23.0,1996.0,11.5,20,12,12,7,1,13,22,59.1,9,18,8,10,21,41,50,2,Matches,2020-2021,Bundesliga
Loris Karius,de GER,GK,Union Berlin,27.0,1993.0,3.2,0,0,0,0,0,0,0,,0,0,0,0,0,0,2,0,Matches,2020-2021,Bundesliga
Silas Katompa,cd COD,"DF,FW",Stuttgart,21.0,1998.0,21.3,48,29,19,19,10,21,44,47.7,23,29,1,28,22,70,11,2,Matches,2020-2021,Bundesliga
Noah Katterbach,de GER,"DF,MF",Köln,19.0,2001.0,12.3,18,11,11,6,1,13,21,61.9,8,7,3,4,23,41,22,0,Matches,2020-2021,Bundesliga
Yannik Keitel,de GER,MF,Freiburg,20.0,2000.0,5.5,12,8,7,4,1,7,9,77.8,2,9,3,6,10,22,8,0,Matches,2020-2021,Bundesliga
Marc-Oliver Kempf,de GER,DF,Stuttgart,25.0,1995.0,30.3,49,26,28,18,3,29,49,59.2,20,40,25,15,68,117,103,1,Matches,2020-2021,Bundesliga
Rani Khedira,de GER,MF,Augsburg,26.0,1994.0,20.2,29,10,13,15,1,10,20,50.0,10,14,5,9,31,60,47,0,Matches,2020-2021,Bundesliga
Sami Khedira,de GER,MF,Hertha BSC,33.0,1987.0,4.4,11,6,3,7,1,6,12,50.0,6,4,0,4,9,20,7,0,Matches,2020-2021,Bundesliga
Luca Kilian,de GER,DF,Mainz 05,20.0,1999.0,4.2,14,7,10,4,0,9,17,52.9,8,3,1,2,13,27,12,0,Matches,2020-2021,Bundesliga
Joshua Kimmich,de GER,MF,Bayern Munich,25.0,1995.0,24.4,40,28,16,19,5,10,53,18.9,43,25,5,20,36,76,19,0,Matches,2020-2021,Bundesliga
Davy Klaassen,nl NED,MF,Werder Bremen,27.0,1993.0,2.5,3,1,0,1,2,0,5,0.0,5,5,1,4,3,6,4,0,Matches,2020-2021,Bundesliga
Felix Klaus,de GER,"DF,MF",Wolfsburg,27.0,1992.0,1.5,7,4,3,4,0,4,5,80.0,1,4,0,4,2,9,4,0,Matches,2020-2021,Bundesliga
Klauss,br BRA,"MF,FW",Hoffenheim,23.0,1997.0,0.6,1,0,0,0,1,0,1,0.0,1,0,0,0,0,1,0,0,Matches,2020-2021,Bundesliga
Philipp Klement,de GER,"MF,FW",Stuttgart,27.0,1992.0,4.7,7,3,6,0,1,3,7,42.9,4,9,2,7,6,13,7,0,Matches,2020-2021,Bundesliga
Mateo Klimowicz,de GER,"MF,FW",Stuttgart,20.0,2000.0,13.3,20,15,6,10,4,5,18,27.8,13,5,1,4,2,22,2,0,Matches,2020-2021,Bundesliga
Fabian Klos,de GER,FW,Arminia,32.0,1987.0,30.1,24,13,9,11,4,7,26,26.9,19,20,6,14,4,28,29,0,Matches,2020-2021,Bundesliga
Lukas Klostermann,de GER,DF,RB Leipzig,24.0,1996.0,16.1,23,19,8,12,3,11,18,61.1,7,16,6,10,18,41,44,1,Matches,2020-2021,Bundesliga
Justin Kluivert,nl NED,"FW,MF",RB Leipzig,21.0,1999.0,9.0,2,1,1,1,0,0,2,0.0,2,4,0,4,5,7,3,0,Matches,2020-2021,Bundesliga
Lukas Klünter,de GER,DF,Hertha BSC,24.0,1996.0,11.0,10,5,6,4,0,5,10,50.0,5,3,1,2,11,21,29,1,Matches,2020-2021,Bundesliga
Ansgar Knauff,de GER,"MF,FW",Dortmund,18.0,2002.0,0.8,0,0,0,0,0,0,1,0.0,1,3,1,2,0,0,0,0,Matches,2020-2021,Bundesliga
Robin Knoche,de GER,DF,Union Berlin,28.0,1992.0,33.8,44,29,30,12,2,23,39,59.0,16,43,27,16,49,93,118,2,Matches,2020-2021,Bundesliga
Gregor Kobel,ch SUI,GK,Stuttgart,22.0,1997.0,33.0,2,2,2,0,0,2,2,100.0,0,0,0,0,2,4,8,1,Matches,2020-2021,Bundesliga
Dominik Kohr,de GER,MF,Mainz 05,26.0,1994.0,14.1,47,31,14,26,7,20,39,51.3,19,18,5,13,27,74,15,0,Matches,2020-2021,Bundesliga
Dominik Kohr,de GER,"MF,DF",Eint Frankfurt,26.0,1994.0,2.9,11,7,0,7,4,4,9,44.4,5,5,1,4,9,20,9,0,Matches,2020-2021,Bundesliga
Sead Kolašinac,ba BIH,"DF,MF",Schalke 04,27.0,1993.0,15.8,20,17,10,7,3,8,18,44.4,10,17,5,12,20,40,17,0,Matches,2020-2021,Bundesliga
Ibrahima Konaté,fr FRA,DF,RB Leipzig,21.0,1999.0,7.7,6,4,2,3,1,2,8,25.0,6,6,3,3,8,14,24,0,Matches,2020-2021,Bundesliga
Filip Kostić,rs SRB,DF,Eint Frankfurt,27.0,1992.0,28.2,54,31,22,23,9,22,54,40.7,32,43,6,37,26,80,28,2,Matches,2020-2021,Bundesliga
Andrej Kramarić,hr CRO,"FW,MF",Hoffenheim,29.0,1991.0,26.4,7,4,4,0,3,3,8,37.5,5,8,1,7,7,14,5,1,Matches,2020-2021,Bundesliga
Christoph Kramer,de GER,MF,Gladbach,29.0,1991.0,22.6,55,37,22,28,5,28,58,48.3,30,32,11,21,34,89,39,0,Matches,2020-2021,Bundesliga
Max Kruse,de GER,"FW,MF",Union Berlin,32.0,1988.0,18.1,7,3,1,5,1,2,9,22.2,7,11,0,11,3,10,3,0,Matches,2020-2021,Bundesliga
Lukas Kübler,de GER,"DF,MF",Freiburg,27.0,1992.0,9.8,15,8,9,5,1,9,14,64.3,5,9,3,6,21,36,31,0,Matches,2020-2021,Bundesliga
Pierre Kunde,cm CMR,MF,Mainz 05,25.0,1995.0,5.7,8,4,1,5,2,2,9,22.2,7,6,0,6,10,18,9,0,Matches,2020-2021,Bundesliga
Fabian Kunze,de GER,MF,Arminia,22.0,1998.0,14.1,38,26,19,15,4,19,42,45.2,23,19,3,16,18,56,22,1,Matches,2020-2021,Bundesliga
Ahmed Kutucu,tr TUR,"FW,MF",Schalke 04,20.0,2000.0,1.2,1,0,0,0,1,1,2,50.0,1,1,0,1,0,1,0,0,Matches,2020-2021,Bundesliga
Maxence Lacroix,fr FRA,DF,Wolfsburg,20.0,2000.0,28.8,49,29,37,12,0,24,45,53.3,21,51,21,30,65,114,140,1,Matches,2020-2021,Bundesliga
Konrad Laimer,at AUT,"DF,MF",RB Leipzig,23.0,1997.0,0.9,2,0,0,1,1,0,4,0.0,4,2,0,2,1,3,0,0,Matches,2020-2021,Bundesliga
Stefan Lainer,at AUT,DF,Gladbach,27.0,1992.0,30.8,62,37,30,22,10,27,60,45.0,33,34,5,29,35,97,85,1,Matches,2020-2021,Bundesliga
Michael Langer,at AUT,GK,Schalke 04,35.0,1985.0,2.7,0,0,0,0,0,0,0,,0,0,0,0,0,0,3,0,Matches,2020-2021,Bundesliga
Danny Latza,de GER,MF,Mainz 05,30.0,1989.0,20.0,43,26,12,19,12,23,70,32.9,47,39,3,36,27,70,23,0,Matches,2020-2021,Bundesliga
Valentino Lazaro,at AUT,"DF,FW",Gladbach,24.0,1996.0,13.8,17,11,7,5,5,12,19,63.2,7,18,1,17,15,32,20,0,Matches,2020-2021,Bundesliga
Mathew Leckie,au AUS,"FW,DF",Hertha BSC,29.0,1991.0,5.6,12,3,5,5,2,4,11,36.4,7,8,0,8,13,25,9,0,Matches,2020-2021,Bundesliga
Christopher Lenz,de GER,"DF,FW",Union Berlin,25.0,1994.0,25.0,74,41,39,30,5,35,71,49.3,36,34,5,29,35,109,50,0,Matches,2020-2021,Bundesliga
Robert Lewandowski,pl POL,FW,Bayern Munich,31.0,1988.0,27.3,15,9,0,7,8,2,13,15.4,11,9,1,8,3,18,11,0,Matches,2020-2021,Bundesliga
Philipp Lienhart,at AUT,DF,Freiburg,24.0,1996.0,33.3,21,13,12,7,2,9,20,45.0,11,30,21,9,42,63,100,0,Matches,2020-2021,Bundesliga
Dimitris Limnios,gr GRE,"MF,FW",Köln,22.0,1998.0,4.2,9,6,3,5,1,5,6,83.3,1,5,0,5,2,11,1,0,Matches,2020-2021,Bundesliga
Niklas Lomb,de GER,GK,Leverkusen,27.0,1993.0,1.5,0,0,0,0,0,0,0,,0,0,0,0,0,0,0,2,Matches,2020-2021,Bundesliga
Eduard Löwen,de GER,"MF,DF",Hertha BSC,23.0,1997.0,0.9,5,1,3,1,1,2,5,40.0,3,1,0,1,1,6,1,0,Matches,2020-2021,Bundesliga
Jan Luca Schuler,de GER,FW,Schalke 04,21.0,1999.0,0.4,2,2,1,1,0,0,1,0.0,1,1,0,1,0,2,0,0,Matches,2020-2021,Bundesliga
Anderson Lucoqui,ao ANG,DF,Arminia,23.0,1997.0,17.8,40,25,23,17,0,20,40,50.0,20,30,7,23,27,67,53,0,Matches,2020-2021,Bundesliga
Kilian Ludewig,de GER,"DF,FW",Schalke 04,20.0,2000.0,5.8,16,6,10,5,1,8,25,32.0,17,7,0,7,3,19,14,0,Matches,2020-2021,Bundesliga
Dodi Lukebakio,be BEL,"FW,MF",Hertha BSC,22.0,1997.0,20.6,21,14,13,5,3,9,20,45.0,11,14,1,13,12,33,8,0,Matches,2020-2021,Bundesliga
Andreas Luthe,de GER,GK,Union Berlin,33.0,1987.0,30.8,1,1,1,0,0,1,3,33.3,2,1,0,1,0,1,8,3,Matches,2020-2021,Bundesliga
Tim Maciejewski,de GER,FW,Union Berlin,19.0,2001.0,0.1,0,0,0,0,0,0,0,,0,0,0,0,0,0,0,0,Matches,2020-2021,Bundesliga
Luca Mack,de GER,MF,Stuttgart,20.0,2000.0,0.1,0,0,0,0,0,0,0,,0,0,0,0,0,0,1,0,Matches,2020-2021,Bundesliga
Mikail Maden,no NOR,FW,Schalke 04,18.0,2002.0,0.1,0,0,0,0,0,0,0,,0,0,0,0,0,0,0,0,Matches,2020-2021,Bundesliga
Arne Maier,de GER,MF,Arminia,21.0,1999.0,11.5,13,9,5,7,1,4,11,36.4,7,10,3,7,8,21,11,1,Matches,2020-2021,Bundesliga
Arne Maier,de GER,MF,Hertha BSC,21.0,1999.0,0.3,1,1,0,1,0,0,1,0.0,1,0,0,0,0,1,0,0,Matches,2020-2021,Bundesliga
Yunus Mallı,tr TUR,MF,Wolfsburg,28.0,1992.0,0.6,1,0,0,1,0,1,1,100.0,0,0,0,0,0,1,0,0,Matches,2020-2021,Bundesliga
Orel Mangala,be BEL,MF,Stuttgart,22.0,1998.0,23.4,27,15,13,11,3,17,28,60.7,11,27,10,17,26,53,30,0,Matches,2020-2021,Bundesliga
Omar Marmoush,eg EGY,FW,Wolfsburg,21.0,1999.0,0.0,0,0,0,0,0,0,0,,0,0,0,0,0,0,0,0,Matches,2020-2021,Bundesliga
Aarón Martín,es ESP,"DF,FW",Mainz 05,23.0,1997.0,2.9,3,2,2,1,0,2,4,50.0,2,1,0,1,2,5,2,0,Matches,2020-2021,Bundesliga
Javi Martínez,es ESP,"DF,MF",Bayern Munich,31.0,1988.0,5.2,10,5,4,4,2,7,9,77.8,2,8,4,4,13,23,19,0,Matches,2020-2021,Bundesliga
Josep Martinez,es ESP,GK,RB Leipzig,22.0,1998.0,1.0,0,0,0,0,0,0,0,,0,0,0,0,0,0,0,0,Matches,2020-2021,Bundesliga
Omar Mascarell,gq EQG,MF,Schalke 04,27.0,1993.0,19.6,41,24,15,19,7,21,54,38.9,33,40,14,26,37,78,32,1,Matches,2020-2021,Bundesliga
Roberto Massimo,de GER,"DF,FW",Stuttgart,19.0,2000.0,8.4,21,11,13,5,3,11,24,45.8,13,5,1,4,11,32,13,0,Matches,2020-2021,Bundesliga
Jean-Philippe Mateta,fr FRA,FW,Mainz 05,23.0,1997.0,11.1,6,3,1,3,2,0,3,0.0,3,3,1,2,4,10,6,0,Matches,2020-2021,Bundesliga
Rabbi Matondo,wls WAL,"FW,MF",Schalke 04,19.0,2000.0,2.4,3,2,0,3,0,2,3,66.7,1,1,0,1,1,4,1,0,Matches,2020-2021,Bundesliga
Henning Matriciani,de GER,DF,Schalke 04,20.0,2000.0,0.3,1,1,1,0,0,1,1,100.0,0,1,0,1,0,1,1,0,Matches,2020-2021,Bundesliga
Konstantinos Mavropanos,gr GRE,DF,Stuttgart,22.0,1997.0,16.3,42,29,29,12,1,27,46,58.7,19,25,10,15,59,101,66,1,Matches,2020-2021,Bundesliga
Eric Maxim Choupo-Moting,cm CMR,"FW,MF",Bayern Munich,31.0,1989.0,9.1,8,2,0,5,3,1,4,25.0,3,6,0,6,2,10,7,0,Matches,2020-2021,Bundesliga
Kevin Mbabu,ch SUI,DF,Wolfsburg,25.0,1995.0,18.2,51,33,27,17,7,24,35,68.6,11,28,7,21,22,73,59,1,Matches,2020-2021,Bundesliga
Jean-Manuel Mbom,de GER,"MF,DF",Werder Bremen,20.0,2000.0,12.9,19,13,14,3,2,8,27,29.6,19,17,6,11,13,32,27,0,Matches,2020-2021,Bundesliga
Nathan de Medina,be BEL,DF,Arminia,22.0,1997.0,7.1,16,10,9,6,1,3,10,30.0,7,12,2,10,11,27,22,0,Matches,2020-2021,Bundesliga
Joshua Mees,de GER,FW,Union Berlin,24.0,1996.0,0.1,0,0,0,0,0,0,0,,0,0,0,0,0,0,0,0,Matches,2020-2021,Bundesliga
Admir Mehmedi,ch SUI,"MF,FW",Wolfsburg,29.0,1991.0,9.1,17,9,6,7,4,6,16,37.5,10,7,0,7,5,22,1,0,Matches,2020-2021,Bundesliga
Hamza Mendyl,ma MAR,"FW,DF",Schalke 04,22.0,1997.0,1.1,2,2,2,0,0,0,2,0.0,2,2,0,2,0,2,2,0,Matches,2020-2021,Bundesliga
Levent Mercan,de GER,FW,Schalke 04,19.0,2000.0,0.1,0,0,0,0,0,0,0,,0,0,0,0,0,0,0,0,Matches,2020-2021,Bundesliga
Jorge Meré,es ESP,DF,Köln,23.0,1997.0,14.4,13,6,9,3,1,6,13,46.2,7,14,11,3,15,28,63,0,Matches,2020-2021,Bundesliga
Thomas Meunier,be BEL,DF,Dortmund,28.0,1991.0,16.4,30,21,19,6,5,20,29,69.0,9,16,6,10,18,48,29,2,Matches,2020-2021,Bundesliga
Max Meyer,de GER,MF,Köln,24.0,1995.0,3.9,7,4,3,3,1,4,8,50.0,4,4,1,3,3,10,1,0,Matches,2020-2021,Bundesliga
Jonas Michelbrink,de GER,MF,Hertha BSC,19.0,2001.0,0.4,0,0,0,0,0,0,0,,0,0,0,0,0,0,0,0,Matches,2020-2021,Bundesliga
Maximilian Mittelstädt,de GER,"DF,FW",Hertha BSC,23.0,1997.0,20.0,66,39,42,21,3,35,72,48.6,37,34,5,29,55,121,61,1,Matches,2020-2021,Bundesliga
Anthony Modeste,fr FRA,FW,Köln,32.0,1988.0,2.5,2,0,0,2,0,0,1,0.0,1,0,0,0,0,2,2,0,Matches,2020-2021,Bundesliga
Kevin Möhwald,de GER,MF,Werder Bremen,27.0,1993.0,17.3,15,9,9,5,1,4,18,22.2,14,10,3,7,32,47,19,2,Matches,2020-2021,Bundesliga
Niklas Moisander,fi FIN,DF,Werder Bremen,34.0,1985.0,13.6,14,11,11,3,0,8,14,57.1,6,15,8,7,22,36,61,0,Matches,2020-2021,Bundesliga
Alkhaly Momo Cissé,gn GUI,"FW,DF",Stuttgart,17.0,2002.0,0.4,1,1,1,0,0,0,0,,0,1,0,1,0,1,0,0,Matches,2020-2021,Bundesliga
Jan Morávek,cz CZE,MF,Augsburg,30.0,1989.0,3.0,5,3,4,1,0,1,8,12.5,7,3,0,3,7,12,2,0,Matches,2020-2021,Bundesliga
Mateu Morey,es ESP,DF,Dortmund,20.0,2000.0,9.2,13,7,4,7,2,9,12,75.0,3,6,1,5,18,31,7,1,Matches,2020-2021,Bundesliga
Youssoufa Moukoko,de GER,"FW,MF",Dortmund,15.0,2004.0,4.7,3,2,1,1,1,0,0,,0,3,0,3,0,3,2,0,Matches,2020-2021,Bundesliga
Nordi Mukiele,fr FRA,DF,RB Leipzig,22.0,1997.0,18.6,44,30,14,28,2,21,37,56.8,16,33,1,32,23,67,33,2,Matches,2020-2021,Bundesliga
Florian Müller,de GER,GK,Freiburg,22.0,1997.0,31.0,0,0,0,0,0,0,3,0.0,3,1,0,1,2,2,10,1,Matches,2020-2021,Bundesliga
Sebastian Müller,de GER,"MF,DF",Arminia,19.0,2001.0,0.0,0,0,0,0,0,0,0,,0,0,0,0,0,0,0,0,Matches,2020-2021,Bundesliga
Thomas Müller,de GER,MF,Bayern Munich,30.0,1989.0,29.7,49,22,11,23,15,24,73,32.9,49,43,3,40,21,70,18,1,Matches,2020-2021,Bundesliga
Petar Musa,hr CRO,FW,Union Berlin,22.0,1998.0,7.9,12,8,3,6,3,4,8,50.0,4,10,0,10,4,16,5,0,Matches,2020-2021,Bundesliga
Jamal Musiala,de GER,"FW,MF",Bayern Munich,17.0,2003.0,9.8,20,12,5,7,8,7,22,31.8,15,17,2,15,14,34,3,0,Matches,2020-2021,Bundesliga
Shkodran Mustafi,de GER,DF,Schalke 04,28.0,1992.0,11.5,16,5,15,1,0,3,12,25.0,9,20,15,5,32,48,76,1,Matches,2020-2021,Bundesliga
Phillipp Mwene,at AUT,"DF,MF",Mainz 05,26.0,1994.0,18.6,36,23,21,11,4,19,38,50.0,19,26,3,23,24,60,33,0,Matches,2020-2021,Bundesliga
Obite N'Dicka,ci CIV,DF,Eint Frankfurt,20.0,1999.0,22.7,31,23,16,15,0,16,28,57.1,12,27,6,21,47,78,85,0,Matches,2020-2021,Bundesliga
Matija Nastasić,rs SRB,DF,Schalke 04,27.0,1993.0,13.6,11,7,9,2,0,9,16,56.3,7,22,18,4,26,37,51,1,Matches,2020-2021,Bundesliga
Paul Nebel,de GER,"MF,FW",Mainz 05,17.0,2002.0,0.6,1,1,0,1,0,0,1,0.0,1,0,0,0,2,3,0,0,Matches,2020-2021,Bundesliga
Luca Netz,de GER,"DF,FW",Hertha BSC,17.0,2003.0,3.4,14,8,12,2,0,6,17,35.3,11,3,0,3,6,20,8,0,Matches,2020-2021,Bundesliga
Manuel Neuer,de GER,GK,Bayern Munich,34.0,1986.0,33.0,0,0,0,0,0,0,1,0.0,1,0,0,0,2,2,12,3,Matches,2020-2021,Bundesliga
Florian Neuhaus,de GER,MF,Gladbach,23.0,1997.0,29.1,48,28,19,26,3,19,63,30.2,44,35,7,28,50,98,20,1,Matches,2020-2021,Bundesliga
Jessic Ngankam,de GER,FW,Hertha BSC,20.0,2000.0,3.3,5,2,1,2,2,1,3,33.3,2,6,1,5,0,5,1,0,Matches,2020-2021,Bundesliga
Moussa Niakhate,sn SEN,DF,Mainz 05,24.0,1996.0,31.8,42,22,28,13,1,14,29,48.3,15,31,15,16,49,91,79,0,Matches,2020-2021,Bundesliga
Tanguy Nianzou,fr FRA,"DF,FW",Bayern Munich,18.0,2002.0,1.3,3,1,3,0,0,1,1,100.0,0,0,0,0,3,6,1,0,Matches,2020-2021,Bundesliga
Florian Niederlechner,de GER,FW,Augsburg,29.0,1990.0,19.3,7,5,1,4,2,0,10,0.0,10,8,3,5,10,17,18,0,Matches,2020-2021,Bundesliga
Joakim Nilsson,se SWE,DF,Arminia,26.0,1994.0,24.0,36,24,23,12,1,14,23,60.9,9,29,22,7,39,75,111,0,Matches,2020-2021,Bundesliga
Christopher Nkunku,fr FRA,"FW,MF",RB Leipzig,22.0,1997.0,21.0,16,11,3,7,6,8,18,44.4,10,27,1,26,9,25,14,0,Matches,2020-2021,Bundesliga
Håvard Nordtveit,no NOR,DF,Hoffenheim,30.0,1990.0,7.8,6,2,5,1,0,6,8,75.0,2,4,2,2,13,19,42,0,Matches,2020-2021,Bundesliga
Alexander Nübel,de GER,GK,Bayern Munich,23.0,1996.0,1.0,0,0,0,0,0,0,0,,0,0,0,0,0,0,1,0,Matches,2020-2021,Bundesliga
Kasim Nuhu,gh GHA,DF,Hoffenheim,25.0,1995.0,11.0,13,7,9,4,0,6,10,60.0,4,8,3,5,15,28,38,0,Matches,2020-2021,Bundesliga
Bastian Oczipka,de GER,"DF,FW",Schalke 04,31.0,1989.0,21.4,33,20,22,10,1,7,21,33.3,14,22,4,18,24,57,41,0,Matches,2020-2021,Bundesliga
Masaya Okugawa,jp JPN,MF,Arminia,24.0,1996.0,10.2,17,8,5,11,1,6,14,42.9,8,17,2,15,8,25,5,0,Matches,2020-2021,Bundesliga
Dani Olmo,es ESP,MF,RB Leipzig,22.0,1998.0,24.4,23,14,6,13,4,4,23,17.4,19,15,0,15,13,36,21,0,Matches,2020-2021,Bundesliga
Karim Onisiwo,at AUT,"FW,MF",Mainz 05,28.0,1992.0,20.5,31,20,7,15,9,14,23,60.9,9,20,1,19,5,36,12,0,Matches,2020-2021,Bundesliga
Willi Orban,hu HUN,DF,RB Leipzig,27.0,1992.0,26.3,40,26,19,15,6,23,37,62.2,14,29,20,9,40,80,74,0,Matches,2020-2021,Bundesliga
Stefan Ortega,de GER,GK,Arminia,27.0,1992.0,34.0,2,1,2,0,0,2,6,33.3,4,0,0,0,0,2,12,3,Matches,2020-2021,Bundesliga
Yuya Osako,jp JPN,"MF,FW",Werder Bremen,30.0,1990.0,8.5,12,8,2,5,5,2,9,22.2,7,6,1,5,5,17,7,0,Matches,2020-2021,Bundesliga
Paulo Otávio,br BRA,DF,Wolfsburg,25.0,1994.0,19.3,60,40,32,22,6,34,62,54.8,28,51,7,44,42,102,59,0,Matches,2020-2021,Bundesliga
Reece Oxford,eng ENG,DF,Augsburg,21.0,1998.0,15.1,26,18,15,11,0,10,17,58.8,7,28,22,6,29,55,89,0,Matches,2020-2021,Bundesliga
Salih Özcan,tr TUR,MF,Köln,22.0,1998.0,15.2,21,13,11,10,0,12,33,36.4,21,11,2,9,20,41,14,1,Matches,2020-2021,Bundesliga
Levin Öztunalı,de GER,"DF,FW",Mainz 05,24.0,1996.0,8.4,24,18,14,8,2,8,17,47.1,9,15,0,15,15,39,16,0,Matches,2020-2021,Bundesliga
Gonçalo Paciência,pt POR,FW,Schalke 04,25.0,1994.0,8.3,8,3,4,1,3,4,16,25.0,12,4,1,3,1,9,3,0,Matches,2020-2021,Bundesliga
Exequiel Palacios,ar ARG,MF,Leverkusen,21.0,1998.0,6.4,31,17,12,16,3,17,30,56.7,13,13,0,13,12,43,7,0,Matches,2020-2021,Bundesliga
Merveille Papela,de GER,DF,Mainz 05,19.0,2001.0,0.0,0,0,0,0,0,0,1,0.0,1,0,0,0,0,0,0,0,Matches,2020-2021,Bundesliga
Felix Passlack,de GER,DF,Dortmund,22.0,1998.0,4.0,9,6,4,2,3,4,8,50.0,4,11,1,10,3,12,2,0,Matches,2020-2021,Bundesliga
Paulinho,br BRA,FW,Leverkusen,20.0,2000.0,0.7,0,0,0,0,0,0,0,,0,0,0,0,0,0,0,0,Matches,2020-2021,Bundesliga
Benjamin Pavard,fr FRA,DF,Bayern Munich,24.0,1996.0,21.6,44,27,20,16,8,23,40,57.5,17,29,5,24,48,92,31,1,Matches,2020-2021,Bundesliga
Jiří Pavlenka,cz CZE,GK,Werder Bremen,28.0,1992.0,34.0,2,0,2,0,0,2,2,100.0,0,0,0,0,1,3,17,4,Matches,2020-2021,Bundesliga
Vasileios Pavlidis,gr GRE,FW,Schalke 04,17.0,2002.0,0.0,0,0,0,0,0,0,0,,0,0,0,0,0,0,0,0,Matches,2020-2021,Bundesliga
Mads Pedersen,dk DEN,DF,Augsburg,23.0,1996.0,9.9,25,16,20,3,2,10,22,45.5,12,13,3,10,15,40,32,0,Matches,2020-2021,Bundesliga
Peter Pekarík,sk SVK,DF,Hertha BSC,33.0,1986.0,18.8,24,18,17,7,0,17,31,54.8,14,19,8,11,27,51,41,0,Matches,2020-2021,Bundesliga
Philipp Pentke,de GER,GK,Hoffenheim,35.0,1985.0,3.0,0,0,0,0,0,0,0,,0,0,0,0,0,0,0,0,Matches,2020-2021,Bundesliga
Pavao Pervan,at AUT,GK,Wolfsburg,32.0,1987.0,2.0,0,0,0,0,0,0,0,,0,0,0,0,0,0,1,0,Matches,2020-2021,Bundesliga
Nils Petersen,de GER,FW,Freiburg,31.0,1988.0,14.5,11,7,2,6,3,3,21,14.3,18,25,1,24,9,20,28,0,Matches,2020-2021,Bundesliga
Lukas Petkov,bg BUL,MF,Augsburg,19.0,2000.0,0.0,0,0,0,0,0,0,0,,0,0,0,0,0,0,0,0,Matches,2020-2021,Bundesliga
Maximilian Philipp,de GER,MF,Wolfsburg,26.0,1994.0,12.3,15,6,3,6,6,5,21,23.8,16,17,0,17,6,21,3,0,Matches,2020-2021,Bundesliga
Krzysztof Piątek,pl POL,FW,Hertha BSC,25.0,1995.0,18.1,9,4,1,7,1,3,22,13.6,19,11,0,11,6,15,14,0,Matches,2020-2021,Bundesliga
Amos Pieper,de GER,DF,Arminia,22.0,1998.0,29.8,58,32,39,17,2,20,33,60.6,13,48,35,13,66,124,160,3,Matches,2020-2021,Bundesliga
Łukasz Piszczek,pl POL,DF,Dortmund,35.0,1985.0,5.1,10,7,6,4,0,5,12,41.7,7,5,1,4,5,15,12,0,Matches,2020-2021,Bundesliga
Marvin Plattenhardt,de GER,DF,Hertha BSC,28.0,1992.0,11.9,15,10,6,7,2,5,9,55.6,4,9,1,8,1,16,19,1,Matches,2020-2021,Bundesliga
Alassane Pléa,fr FRA,FW,Gladbach,27.0,1993.0,20.0,19,9,4,10,5,5,20,25.0,15,1,0,1,5,24,7,0,Matches,2020-2021,Bundesliga
Joel Pohjanpalo,fi FIN,FW,Union Berlin,25.0,1994.0,9.5,5,1,0,3,2,1,6,16.7,5,1,0,1,1,6,12,0,Matches,2020-2021,Bundesliga
Joel Pohjanpalo,fi FIN,MF,Leverkusen,25.0,1994.0,0.1,0,0,0,0,0,0,0,,0,0,0,0,0,0,0,0,Matches,2020-2021,Bundesliga
Marin Pongračić,hr CRO,DF,Wolfsburg,22.0,1997.0,6.4,13,9,9,3,1,6,8,75.0,2,12,5,7,11,24,27,0,Matches,2020-2021,Bundesliga
Stefan Posch,at AUT,DF,Hoffenheim,23.0,1997.0,23.5,52,24,29,17,6,27,47,57.4,20,27,8,19,37,89,73,1,Matches,2020-2021,Bundesliga
Yussuf Poulsen,dk DEN,FW,RB Leipzig,26.0,1994.0,15.0,10,6,1,6,3,1,17,5.9,16,16,0,16,6,16,13,0,Matches,2020-2021,Bundesliga
Manuel Prietl,at AUT,MF,Arminia,28.0,1991.0,28.0,65,44,33,28,4,12,73,16.4,61,34,7,27,45,110,24,0,Matches,2020-2021,Bundesliga
Grischa Prömel,de GER,MF,Union Berlin,25.0,1995.0,20.2,39,23,14,23,2,18,34,52.9,16,20,2,18,24,63,22,0,Matches,2020-2021,Bundesliga
Robin Quaison,se SWE,"FW,MF",Mainz 05,26.0,1993.0,16.4,14,6,3,6,5,7,14,50.0,7,10,0,10,13,27,10,0,Matches,2020-2021,Bundesliga
Nemanja Radonjić,rs SRB,"FW,MF",Hertha BSC,24.0,1996.0,6.8,5,3,2,2,1,1,5,20.0,4,1,0,1,2,7,1,0,Matches,2020-2021,Bundesliga
Benito Raman,be BEL,"FW,MF",Schalke 04,25.0,1994.0,13.8,19,13,11,6,2,6,29,20.7,23,11,0,11,5,24,5,0,Matches,2020-2021,Bundesliga
Milot Rashica,xk KVX,"FW,MF",Werder Bremen,24.0,1996.0,16.2,24,12,11,11,2,12,23,52.2,11,7,0,7,4,28,6,0,Matches,2020-2021,Bundesliga
Daishawn Redan,nl NED,"FW,MF",Hertha BSC,19.0,2001.0,1.1,0,0,0,0,0,0,0,,0,1,0,1,0,0,0,0,Matches,2020-2021,Bundesliga
Reinier,br BRA,"MF,FW",Dortmund,18.0,2002.0,2.9,9,4,6,1,2,2,4,50.0,2,4,1,3,2,11,0,0,Matches,2020-2021,Bundesliga
Rocco Reitz,de GER,MF,Gladbach,18.0,2002.0,0.7,3,2,0,3,0,2,2,100.0,0,3,1,2,1,4,1,0,Matches,2020-2021,Bundesliga
Marco Reus,de GER,"MF,FW",Dortmund,31.0,1989.0,25.3,33,16,9,16,8,9,33,27.3,24,22,2,20,14,47,13,0,Matches,2020-2021,Bundesliga
Elvis Rexhbeçaj,xk KVX,"MF,FW",Köln,22.0,1997.0,20.4,53,32,17,27,9,19,53,35.8,34,32,7,25,26,79,18,0,Matches,2020-2021,Bundesliga
Gio Reyna,us USA,"MF,FW",Dortmund,17.0,2002.0,22.0,24,13,9,8,7,9,25,36.0,16,14,1,13,10,34,11,0,Matches,2020-2021,Bundesliga
Chris Richards,us USA,DF,Hoffenheim,20.0,2000.0,10.5,19,8,12,6,1,10,16,62.5,6,13,4,9,21,40,40,1,Matches,2020-2021,Bundesliga
Chris Richards,us USA,DF,Bayern Munich,20.0,2000.0,1.0,0,0,0,0,0,0,0,,0,0,0,0,1,1,1,0,Matches,2020-2021,Bundesliga
Marco Richter,de GER,"FW,MF",Augsburg,22.0,1997.0,15.7,17,9,3,12,2,7,23,30.4,16,10,0,10,6,23,9,0,Matches,2020-2021,Bundesliga
Marc Roca,es ESP,MF,Bayern Munich,23.0,1996.0,2.0,2,2,0,0,2,0,4,0.0,4,4,1,3,2,4,1,0,Matches,2020-2021,Bundesliga
Sebastian Rode,de GER,MF,Eint Frankfurt,29.0,1990.0,18.1,44,25,21,16,7,14,46,30.4,32,30,3,27,47,91,18,0,Matches,2020-2021,Bundesliga
Jérôme Roussillon,fr FRA,DF,Wolfsburg,27.0,1993.0,13.7,24,12,14,8,2,11,20,55.0,9,10,1,9,19,43,28,0,Matches,2020-2021,Bundesliga
Sebastian Rudy,de GER,"MF,FW",Hoffenheim,30.0,1990.0,18.6,35,26,15,15,5,16,45,35.6,29,24,4,20,13,48,21,1,Matches,2020-2021,Bundesliga
Sebastian Rudy,de GER,DF,Schalke 04,30.0,1990.0,2.0,4,2,2,0,2,4,7,57.1,3,6,4,2,1,5,4,0,Matches,2020-2021,Bundesliga
Georginio Rutter,fr FRA,FW,Hoffenheim,18.0,2002.0,2.7,4,4,2,2,0,1,2,50.0,1,2,0,2,0,4,2,0,Matches,2020-2021,Bundesliga
Julian Ryerson,no NOR,"DF,MF",Union Berlin,22.0,1997.0,11.9,22,15,4,14,4,12,15,80.0,3,13,0,13,11,33,17,0,Matches,2020-2021,Bundesliga
Frederik Rønnow,dk DEN,GK,Schalke 04,27.0,1992.0,10.5,0,0,0,0,0,0,0,,0,0,0,0,1,1,9,1,Matches,2020-2021,Bundesliga
Victor Sá,br BRA,FW,Wolfsburg,26.0,1994.0,5.2,9,6,2,6,1,6,11,54.5,5,11,0,11,8,17,2,0,Matches,2020-2021,Bundesliga
Marcel Sabitzer,at AUT,MF,RB Leipzig,26.0,1994.0,22.5,29,21,12,16,1,12,37,32.4,25,7,2,5,35,64,27,0,Matches,2020-2021,Bundesliga
Roland Sallai,hu HUN,"MF,FW",Freiburg,23.0,1997.0,18.5,18,14,7,9,2,5,13,38.5,8,11,1,10,11,29,8,0,Matches,2020-2021,Bundesliga
Lazar Samardzic,rs SRB,MF,RB Leipzig,18.0,2002.0,2.2,10,7,4,6,0,5,13,38.5,8,6,0,6,2,12,1,0,Matches,2020-2021,Bundesliga
Diadie Samassékou,ml MLI,MF,Hoffenheim,24.0,1996.0,28.5,71,41,22,42,7,33,90,36.7,57,41,12,29,78,149,50,0,Matches,2020-2021,Bundesliga
Jadon Sancho,eng ENG,"FW,MF",Dortmund,20.0,2000.0,22.9,18,11,4,10,4,7,16,43.8,9,20,1,19,16,34,9,0,Matches,2020-2021,Bundesliga
Leroy Sané,de GER,"FW,MF",Bayern Munich,24.0,1996.0,20.1,18,10,2,10,6,13,30,43.3,17,23,1,22,9,27,8,1,Matches,2020-2021,Bundesliga
Salif Sané,sn SEN,DF,Schalke 04,29.0,1990.0,11.9,17,9,9,7,1,13,23,56.5,10,25,13,12,25,42,66,0,Matches,2020-2021,Bundesliga
Mohamed Sankoh,nl NED,MF,Stuttgart,16.0,2003.0,0.2,0,0,0,0,0,0,0,,0,1,0,1,0,0,0,0,Matches,2020-2021,Bundesliga
Baptiste Santamaria,fr FRA,MF,Freiburg,25.0,1995.0,24.5,51,38,19,24,8,20,54,37.0,34,36,7,29,52,103,34,1,Matches,2020-2021,Bundesliga
Josh Sargent,us USA,"FW,MF",Werder Bremen,20.0,2000.0,27.8,32,19,13,13,6,13,27,48.1,14,39,4,35,17,49,36,0,Matches,2020-2021,Bundesliga
Bouna Sarr,sn SEN,DF,Bayern Munich,28.0,1992.0,5.0,9,8,4,3,2,3,6,50.0,3,7,0,7,10,19,7,1,Matches,2020-2021,Bundesliga
Patrik Schick,cz CZE,FW,Leverkusen,24.0,1996.0,20.7,7,2,0,5,2,1,4,25.0,3,5,2,3,3,10,20,0,Matches,2020-2021,Bundesliga
Sven Schipplock,de GER,"FW,MF",Arminia,31.0,1988.0,8.3,15,8,7,6,2,6,27,22.2,21,13,2,11,6,21,8,0,Matches,2020-2021,Bundesliga
Xaver Schlager,at AUT,MF,Wolfsburg,22.0,1997.0,29.2,66,40,20,38,8,22,68,32.4,46,50,6,44,54,120,38,0,Matches,2020-2021,Bundesliga
Keven Schlotterbeck,de GER,DF,Freiburg,23.0,1997.0,18.4,31,10,16,15,0,10,23,43.5,13,26,18,8,36,67,89,2,Matches,2020-2021,Bundesliga
Nico Schlotterbeck,de GER,DF,Union Berlin,20.0,1999.0,14.3,34,19,14,19,1,18,28,64.3,10,13,6,7,31,65,29,1,Matches,2020-2021,Bundesliga
Jonathan Schmid,fr FRA,"MF,DF",Freiburg,30.0,1990.0,26.6,37,19,17,13,7,16,30,53.3,14,26,10,16,28,65,38,0,Matches,2020-2021,Bundesliga
Romano Schmid,at AUT,"MF,FW",Werder Bremen,20.0,2000.0,13.1,22,16,8,10,4,8,35,22.9,27,21,0,21,8,30,6,0,Matches,2020-2021,Bundesliga
Benno Schmitz,de GER,DF,Köln,25.0,1994.0,4.6,14,7,6,7,1,7,13,53.8,6,8,2,6,6,20,7,0,Matches,2020-2021,Bundesliga
Alessandro Schöpf,at AUT,"FW,MF",Schalke 04,26.0,1994.0,10.5,11,9,3,7,1,1,6,16.7,5,15,1,14,6,17,6,0,Matches,2020-2021,Bundesliga
Nico Schulz,de GER,DF,Dortmund,27.0,1993.0,6.8,9,6,4,3,2,2,11,18.2,9,12,4,8,6,15,10,0,Matches,2020-2021,Bundesliga
Alexander Schwolow,de GER,GK,Hertha BSC,28.0,1992.0,26.0,0,0,0,0,0,0,0,,0,1,0,1,0,0,6,0,Matches,2020-2021,Bundesliga
Christopher Scott,de GER,"MF,FW",Bayern Munich,18.0,2002.0,0.4,2,1,0,1,1,2,2,100.0,0,0,0,0,0,2,1,0,Matches,2020-2021,Bundesliga
Davie Selke,de GER,FW,Werder Bremen,25.0,1995.0,9.0,3,2,1,1,1,0,6,0.0,6,3,2,1,1,4,7,0,Matches,2020-2021,Bundesliga
Suat Serdar,de GER,MF,Schalke 04,23.0,1997.0,21.7,55,35,18,33,4,17,52,32.7,35,29,4,25,23,78,21,0,Matches,2020-2021,Bundesliga
Ryan Sessegnon,eng ENG,"DF,FW",Hoffenheim,20.0,2000.0,17.5,47,25,26,13,8,15,34,44.1,19,26,3,23,30,77,46,0,Matches,2020-2021,Bundesliga
Nils Seufert,de GER,"MF,FW",Arminia,23.0,1997.0,3.8,12,9,2,5,5,2,8,25.0,6,3,1,2,5,17,6,0,Matches,2020-2021,Bundesliga
Tim Siersleben,de GER,DF,Wolfsburg,20.0,2000.0,0.4,2,2,2,0,0,1,1,100.0,0,1,0,1,0,2,0,0,Matches,2020-2021,Bundesliga
André Silva,pt POR,FW,Eint Frankfurt,24.0,1995.0,30.7,11,2,0,7,4,6,13,46.2,7,11,1,10,3,14,15,0,Matches,2020-2021,Bundesliga
Jóan Símun Edmundsson,fo FRO,"FW,MF",Arminia,29.0,1991.0,0.6,0,0,0,0,0,0,0,,0,1,0,1,1,1,0,0,Matches,2020-2021,Bundesliga
Daley Sinkgraven,nl NED,DF,Leverkusen,25.0,1995.0,17.4,32,17,13,16,3,18,35,51.4,17,22,5,17,23,55,23,0,Matches,2020-2021,Bundesliga
Tobias Sippel,de GER,GK,Gladbach,32.0,1988.0,3.8,0,0,0,0,0,0,0,,0,0,0,0,1,1,4,0,Matches,2020-2021,Bundesliga
Ellyes Skhiri,tn TUN,MF,Köln,25.0,1995.0,30.9,83,48,44,31,8,33,65,50.8,32,49,13,36,82,165,38,2,Matches,2020-2021,Bundesliga
Robert Skov,dk DEN,"FW,MF",Hoffenheim,24.0,1996.0,12.9,19,10,9,7,3,7,16,43.8,9,9,2,7,15,34,10,1,Matches,2020-2021,Bundesliga
Steven Skrzybski,de GER,"FW,DF",Schalke 04,27.0,1992.0,4.7,5,4,0,5,0,1,7,14.3,6,13,1,12,5,10,1,1,Matches,2020-2021,Bundesliga
Yann Sommer,ch SUI,GK,Gladbach,31.0,1988.0,30.1,1,1,1,0,0,1,1,100.0,0,0,0,0,2,3,9,2,Matches,2020-2021,Bundesliga
Borna Sosa,hr CRO,"DF,FW",Stuttgart,22.0,1998.0,22.7,14,10,6,6,2,8,25,32.0,17,23,4,19,31,45,74,0,Matches,2020-2021,Bundesliga
Cebio Soukou,bj BEN,"FW,MF",Arminia,27.0,1992.0,5.1,12,8,5,5,2,6,11,54.5,5,3,0,3,3,15,4,0,Matches,2020-2021,Bundesliga
Djibril Sow,ch SUI,MF,Eint Frankfurt,23.0,1997.0,24.2,58,33,19,32,7,18,41,43.9,23,31,8,23,51,109,17,0,Matches,2020-2021,Bundesliga
Jerry St. Juste,nl NED,DF,Mainz 05,23.0,1996.0,32.0,65,38,37,26,2,20,36,55.6,16,46,27,19,64,129,82,1,Matches,2020-2021,Bundesliga
Benjamin Stambouli,fr FRA,"DF,MF",Schalke 04,29.0,1990.0,21.7,45,29,24,18,3,15,37,40.5,22,42,14,28,49,94,45,1,Matches,2020-2021,Bundesliga
Josip Stanišić,hr CRO,DF,Bayern Munich,20.0,2000.0,1.0,2,2,1,1,0,1,1,100.0,0,3,0,3,2,4,2,0,Matches,2020-2021,Bundesliga
Niklas Stark,de GER,"DF,MF",Hertha BSC,25.0,1995.0,31.0,49,28,20,27,2,13,31,41.9,18,43,16,27,42,91,101,0,Matches,2020-2021,Bundesliga
Renato Steffen,ch SUI,"FW,MF",Wolfsburg,28.0,1991.0,17.4,24,15,6,12,6,13,24,54.2,11,21,2,19,22,46,15,0,Matches,2020-2021,Bundesliga
Pascal Stenzel,de GER,DF,Stuttgart,24.0,1996.0,14.2,33,14,15,17,1,22,50,44.0,28,19,4,15,26,59,39,1,Matches,2020-2021,Bundesliga
Lars Stindl,de GER,"MF,FW",Gladbach,31.0,1988.0,21.8,24,17,3,16,5,7,32,21.9,25,26,3,23,13,37,14,0,Matches,2020-2021,Bundesliga
Kevin Stöger,at AUT,"MF,FW",Mainz 05,26.0,1993.0,6.0,12,6,2,9,1,5,16,31.3,11,5,0,5,6,18,4,0,Matches,2020-2021,Bundesliga
Tobias Strobl,de GER,MF,Augsburg,30.0,1990.0,20.5,21,10,12,9,0,10,30,33.3,20,21,8,13,28,49,27,0,Matches,2020-2021,Bundesliga
Marek Suchý,cz CZE,DF,Augsburg,32.0,1988.0,3.4,4,2,1,3,0,1,2,50.0,1,3,3,0,4,8,9,0,Matches,2020-2021,Bundesliga
Niklas Süle,de GER,DF,Bayern Munich,24.0,1995.0,16.7,32,21,15,14,3,13,21,61.9,8,24,12,12,21,53,36,1,Matches,2020-2021,Bundesliga
Ádám Szalai,hu HUN,FW,Mainz 05,32.0,1987.0,8.1,7,6,3,2,2,2,8,25.0,6,4,1,3,2,9,4,0,Matches,2020-2021,Bundesliga
Frederik Sørensen,dk DEN,DF,Köln,28.0,1992.0,1.1,2,1,0,2,0,1,1,100.0,0,2,0,2,0,2,0,0,Matches,2020-2021,Bundesliga
Alexander Sørloth,no NOR,FW,RB Leipzig,24.0,1995.0,16.0,7,5,0,5,2,2,14,14.3,12,13,2,11,3,10,13,0,Matches,2020-2021,Bundesliga
Jonathan Tah,de GER,DF,Leverkusen,24.0,1996.0,24.7,30,17,19,9,2,11,21,52.4,10,19,12,7,33,63,89,1,Matches,2020-2021,Bundesliga
Edmond Tapsoba,bf BFA,DF,Leverkusen,21.0,1999.0,29.5,54,28,35,18,1,21,45,46.7,24,55,29,26,48,102,96,0,Matches,2020-2021,Bundesliga
Niklas Tauer,de GER,"MF,DF",Mainz 05,19.0,2001.0,0.8,1,1,0,1,0,1,2,50.0,1,3,1,2,3,4,1,0,Matches,2020-2021,Bundesliga
Lino Tempelmann,de GER,MF,Freiburg,21.0,1999.0,3.0,5,3,2,2,1,0,4,0.0,4,6,1,5,2,7,6,0,Matches,2020-2021,Bundesliga
Cedric Teuchert,de GER,"FW,MF",Union Berlin,23.0,1997.0,8.4,7,5,2,4,1,3,16,18.8,13,12,0,12,5,12,6,0,Matches,2020-2021,Bundesliga
Malick Thiaw,de GER,DF,Schalke 04,18.0,2001.0,16.1,42,27,24,17,1,15,26,57.7,11,17,12,5,33,75,70,0,Matches,2020-2021,Bundesliga
Jan Thielmann,de GER,"FW,MF",Köln,18.0,2002.0,11.4,11,6,1,8,2,5,9,55.6,4,10,1,9,9,20,2,0,Matches,2020-2021,Bundesliga
Erik Thommy,de GER,"MF,DF",Stuttgart,25.0,1994.0,3.5,3,1,0,3,0,0,3,0.0,3,3,0,3,3,6,4,0,Matches,2020-2021,Bundesliga
Marcus Thuram,fr FRA,"FW,MF",Gladbach,22.0,1997.0,19.2,24,14,9,10,5,10,23,43.5,13,27,4,23,15,39,13,1,Matches,2020-2021,Bundesliga
Steffen Tigges,de GER,"FW,DF",Dortmund,22.0,1998.0,0.6,4,4,0,1,3,2,3,66.7,1,1,0,1,0,4,1,0,Matches,2020-2021,Bundesliga
Guus Til,nl NED,FW,Freiburg,22.0,1997.0,1.4,4,3,2,1,1,2,3,66.7,1,2,0,2,2,6,2,0,Matches,2020-2021,Bundesliga
Corentin Tolisso,fr FRA,MF,Bayern Munich,25.0,1994.0,8.7,19,19,4,11,4,9,29,31.0,20,15,2,13,6,25,8,0,Matches,2020-2021,Bundesliga
Ömer Toprak,tr TUR,DF,Werder Bremen,31.0,1989.0,21.6,23,16,15,6,2,12,24,50.0,12,27,16,11,36,59,115,1,Matches,2020-2021,Bundesliga
Jordan Torunarigha,de GER,DF,Hertha BSC,22.0,1997.0,10.8,7,4,7,0,0,5,8,62.5,3,8,2,6,15,22,54,1,Matches,2020-2021,Bundesliga
Almamy Touré,ml MLI,DF,Eint Frankfurt,24.0,1996.0,7.8,18,12,8,7,3,10,14,71.4,4,5,1,4,8,26,22,0,Matches,2020-2021,Bundesliga
Lucas Tousart,fr FRA,MF,Hertha BSC,23.0,1997.0,23.2,33,18,16,15,2,13,27,48.1,14,33,6,27,40,73,52,0,Matches,2020-2021,Bundesliga
Ibrahima Traoré,gn GUI,"FW,DF",Gladbach,32.0,1988.0,1.1,4,1,1,2,1,0,0,,0,2,0,2,0,4,0,0,Matches,2020-2021,Bundesliga
Kevin Trapp,de GER,GK,Eint Frankfurt,30.0,1990.0,33.0,0,0,0,0,0,0,1,0.0,1,1,0,1,3,3,11,3,Matches,2020-2021,Bundesliga
Christopher Trimmel,at AUT,"DF,FW",Union Berlin,33.0,1987.0,28.6,50,25,28,18,4,28,54,51.9,26,32,7,25,50,100,99,0,Matches,2020-2021,Bundesliga
Tuta,br BRA,DF,Eint Frankfurt,21.0,1999.0,16.2,35,20,22,13,0,24,43,55.8,19,19,2,17,29,64,53,0,Matches,2020-2021,Bundesliga
Dayot Upamecano,fr FRA,DF,RB Leipzig,21.0,1998.0,25.9,37,30,18,19,0,14,20,70.0,6,25,14,11,33,70,74,2,Matches,2020-2021,Bundesliga
Mark Uth,de GER,"FW,MF",Schalke 04,28.0,1991.0,16.6,25,13,13,10,2,5,23,21.7,18,21,0,21,5,30,10,0,Matches,2020-2021,Bundesliga
Ruben Vargas,ch SUI,"MF,FW",Augsburg,21.0,1998.0,17.9,18,12,6,9,3,1,16,6.3,15,26,2,24,18,36,27,0,Matches,2020-2021,Bundesliga
Miloš Veljković,rs SRB,DF,Werder Bremen,24.0,1995.0,19.1,24,14,17,6,1,15,31,48.4,16,22,9,13,29,53,94,1,Matches,2020-2021,Bundesliga
Michel Vlap,nl NED,"MF,FW",Arminia,23.0,1997.0,4.1,1,1,0,1,0,0,8,0.0,8,4,0,4,5,6,3,0,Matches,2020-2021,Bundesliga
Andreas Voglsammer,de GER,"FW,MF",Arminia,28.0,1992.0,11.1,12,8,6,6,0,8,17,47.1,9,11,0,11,3,15,11,0,Matches,2020-2021,Bundesliga
Kevin Vogt,de GER,DF,Hoffenheim,28.0,1991.0,20.5,18,12,11,6,1,12,21,57.1,9,21,12,9,16,34,71,0,Matches,2020-2021,Bundesliga
Wout Weghorst,nl NED,FW,Wolfsburg,27.0,1992.0,32.7,13,8,2,8,3,4,20,20.0,16,17,3,14,4,17,26,0,Matches,2020-2021,Bundesliga
Mitchell Weiser,de GER,DF,Leverkusen,26.0,1994.0,2.5,4,1,1,2,1,2,4,50.0,2,1,0,1,3,7,4,0,Matches,2020-2021,Bundesliga
Wendell,br BRA,DF,Leverkusen,27.0,1993.0,16.2,53,35,27,18,8,23,49,46.9,26,26,3,23,25,78,39,1,Matches,2020-2021,Bundesliga
Oscar Wendt,se SWE,DF,Gladbach,34.0,1985.0,13.9,12,6,2,9,1,4,12,33.3,8,18,4,14,14,26,23,0,Matches,2020-2021,Bundesliga
William,br BRA,"MF,FW",Wolfsburg,25.0,1995.0,0.0,0,0,0,0,0,0,0,,0,0,0,0,0,0,0,0,Matches,2020-2021,Bundesliga
William,br BRA,"DF,FW",Schalke 04,25.0,1995.0,5.3,14,10,10,4,0,5,15,33.3,10,16,5,11,11,25,15,1,Matches,2020-2021,Bundesliga
Marten Winkler,de GER,FW,Hertha BSC,17.0,2002.0,0.0,0,0,0,0,0,0,0,,0,0,0,0,0,0,0,0,Matches,2020-2021,Bundesliga
Florian Wirtz,de GER,MF,Leverkusen,17.0,2003.0,24.7,35,18,8,22,5,11,37,29.7,26,27,1,26,9,44,8,0,Matches,2020-2021,Bundesliga
Axel Witsel,be BEL,MF,Dortmund,31.0,1989.0,12.6,18,12,6,11,1,8,16,50.0,8,13,3,10,22,40,13,0,Matches,2020-2021,Bundesliga
Hannes Wolf,at AUT,"MF,FW",Gladbach,21.0,1999.0,15.3,26,13,8,10,8,8,36,22.2,28,18,1,17,9,35,4,0,Matches,2020-2021,Bundesliga
Marius Wolf,de GER,"MF,DF",Köln,25.0,1995.0,28.3,35,19,19,13,3,13,38,34.2,25,29,3,26,28,63,47,1,Matches,2020-2021,Bundesliga
Nick Woltemade,de GER,"MF,FW",Werder Bremen,18.0,2002.0,1.6,3,2,1,1,1,2,4,50.0,2,1,0,1,0,3,0,0,Matches,2020-2021,Bundesliga
Jeong Woo-yeong,kr KOR,"FW,MF",Freiburg,20.0,1999.0,9.1,9,5,1,6,2,2,11,18.2,9,8,1,7,11,20,11,0,Matches,2020-2021,Bundesliga
Joscha Wosz,de GER,DF,RB Leipzig,18.0,2002.0,0.4,1,1,1,0,0,0,0,,0,1,0,1,1,2,0,0,Matches,2020-2021,Bundesliga
Reinhold Yabo,de GER,"MF,FW",Arminia,28.0,1992.0,7.2,5,2,2,2,1,2,9,22.2,7,6,1,5,4,9,1,0,Matches,2020-2021,Bundesliga
Amin Younes,de GER,MF,Eint Frankfurt,26.0,1993.0,15.5,25,14,8,10,7,6,32,18.8,26,19,1,18,13,38,4,0,Matches,2020-2021,Bundesliga
Dan-Axel Zagadou,fr FRA,DF,Dortmund,21.0,1999.0,3.1,2,2,2,0,0,0,0,,0,3,2,1,6,8,13,0,Matches,2020-2021,Bundesliga
Denis Zakaria,ch SUI,"MF,DF",Gladbach,23.0,1996.0,15.8,30,15,12,15,3,11,20,55.0,9,20,7,13,23,53,29,1,Matches,2020-2021,Bundesliga
Deyovaisio Zeefuik,nl NED,"DF,FW",Hertha BSC,22.0,1998.0,10.1,13,9,8,3,2,8,19,42.1,11,15,3,12,12,25,36,0,Matches,2020-2021,Bundesliga
Robin Zentner,de GER,GK,Mainz 05,25.0,1994.0,31.0,1,1,1,0,0,1,3,33.3,2,0,0,0,3,4,9,2,Matches,2020-2021,Bundesliga
Ron-Robert Zieler,de GER,GK,Köln,31.0,1989.0,0.6,0,0,0,0,0,0,0,,0,0,0,0,0,0,0,0,Matches,2020-2021,Bundesliga
Joshua Zirkzee,nl NED,FW,Bayern Munich,19.0,2001.0,1.0,1,0,0,1,0,1,2,50.0,1,0,0,0,0,1,0,0,Matches,2020-2021,Bundesliga
Steven Zuber,ch SUI,"DF,MF",Eint Frankfurt,28.0,1991.0,6.5,24,12,8,13,3,8,16,50.0,8,4,1,3,4,28,1,0,Matches,2020-2021,Bundesliga
Dickson Abiama,ng NGA,FW,Greuther Fürth,22.0,1998.0,8.1,11,7,4,5,2,2,10,20.0,8,12,1,11,4,15,8,0,Matches,2021-2022,Bundesliga
Ragnar Ache,de GER,"MF,FW",Eint Frankfurt,23.0,1998.0,2.9,2,0,0,1,1,1,4,25.0,3,3,0,3,0,2,1,0,Matches,2021-2022,Bundesliga
Tyler Adams,us USA,MF,RB Leipzig,22.0,1999.0,15.0,23,7,5,16,2,7,25,28.0,18,24,1,23,16,39,19,2,Matches,2021-2022,Bundesliga
Sargis Adamyan,am ARM,"FW,MF",Hoffenheim,28.0,1993.0,3.7,8,6,3,4,1,3,11,27.3,8,4,0,4,1,9,2,0,Matches,2021-2022,Bundesliga
Amine Adli,ma MAR,"FW,MF",Leverkusen,21.0,2000.0,14.0,27,14,10,14,3,8,15,53.3,7,26,2,24,11,38,12,0,Matches,2021-2022,Bundesliga
Naouirou Ahamada,fr FRA,"MF,DF",Stuttgart,19.0,2002.0,0.7,1,0,1,0,0,1,3,33.3,2,0,0,0,0,1,0,0,Matches,2021-2022,Bundesliga
Manuel Akanji,ch SUI,DF,Dortmund,26.0,1995.0,25.1,33,23,20,11,2,22,32,68.8,10,26,15,11,35,68,58,0,Matches,2021-2022,Bundesliga
Kevin Akpoguma,ng NGA,"DF,FW",Hoffenheim,26.0,1995.0,17.0,33,19,16,11,6,16,28,57.1,12,32,2,30,20,53,29,2,Matches,2021-2022,Bundesliga
Lucas Alario,ar ARG,FW,Leverkusen,28.0,1992.0,7.3,6,5,0,2,4,2,5,40.0,3,5,0,5,1,7,6,0,Matches,2021-2022,Bundesliga
Nadiem Amiri,de GER,"MF,FW",Leverkusen,24.0,1996.0,4.1,8,4,3,2,3,4,8,50.0,4,4,2,2,5,13,0,0,Matches,2021-2022,Bundesliga
Sebastian Andersson,se SWE,FW,Köln,30.0,1991.0,14.0,11,7,0,3,8,3,9,33.3,6,8,0,8,3,14,14,0,Matches,2021-2022,Bundesliga
Andrés Andrade Cedeño,pa PAN,DF,Arminia,22.0,1998.0,11.6,27,16,18,8,1,17,35,48.6,18,16,7,9,19,46,44,0,Matches,2021-2022,Bundesliga
Fredrik André Bjørkan,no NOR,DF,Hertha BSC,22.0,1998.0,3.9,12,10,7,4,1,7,9,77.8,2,6,2,4,6,18,8,0,Matches,2021-2022,Bundesliga
Robert Andrich,de GER,MF,Leverkusen,26.0,1994.0,20.2,33,17,18,14,1,14,28,50.0,14,19,7,12,31,64,46,0,Matches,2021-2022,Bundesliga
Angeliño,es ESP,DF,RB Leipzig,24.0,1997.0,25.5,28,21,14,13,1,14,30,46.7,16,24,3,21,29,57,40,0,Matches,2021-2022,Bundesliga
Waldemar Anton,de GER,DF,Stuttgart,25.0,1996.0,28.8,40,26,22,15,3,19,32,59.4,13,27,16,11,32,72,116,1,Matches,2021-2022,Bundesliga
Christopher Antwi-Adjei,gh GHA,"FW,MF",Bochum,27.0,1994.0,12.6,21,18,7,8,6,6,26,23.1,20,12,0,12,1,22,8,0,Matches,2021-2022,Bundesliga
Charles Aránguiz,cl CHI,MF,Leverkusen,32.0,1989.0,17.5,45,25,18,21,6,22,52,42.3,30,24,4,20,33,78,21,0,Matches,2021-2022,Bundesliga
Maximilian Arnold,de GER,MF,Wolfsburg,27.0,1994.0,33.3,37,20,19,16,2,20,50,40.0,30,43,15,28,37,74,55,0,Matches,2021-2022,Bundesliga
Takuma Asano,jp JPN,"FW,MF",Bochum,26.0,1994.0,17.9,11,6,3,6,2,5,19,26.3,14,14,1,13,7,18,7,0,Matches,2021-2022,Bundesliga
Santiago Ascacíbar,ar ARG,MF,Hertha BSC,24.0,1997.0,26.4,93,54,50,37,6,38,89,42.7,51,31,6,25,41,134,42,0,Matches,2021-2022,Bundesliga
Fisnik Asllani,xk KVX,"MF,FW",Hoffenheim,18.0,2002.0,0.1,0,0,0,0,0,0,1,0.0,1,0,0,0,0,0,0,0,Matches,2021-2022,Bundesliga
Simon Asta,de GER,DF,Greuther Fürth,20.0,2001.0,8.7,13,6,4,5,4,4,8,50.0,4,14,2,12,8,21,16,0,Matches,2021-2022,Bundesliga
Taiwo Awoniyi,ng NGA,FW,Union Berlin,23.0,1997.0,24.2,11,7,3,6,2,1,9,11.1,8,11,2,9,2,13,29,0,Matches,2021-2022,Bundesliga
Sardar Azmoun,ir IRN,"FW,MF",Leverkusen,26.0,1995.0,4.0,3,1,0,2,1,0,5,0.0,5,2,0,2,0,3,8,0,Matches,2021-2022,Bundesliga
Mitchel Bakker,nl NED,DF,Leverkusen,21.0,2000.0,20.2,33,22,16,12,5,20,34,58.8,14,13,2,11,23,56,42,3,Matches,2021-2022,Bundesliga
Ridle Baku,de GER,"DF,FW",Wolfsburg,23.0,1998.0,27.2,62,37,30,24,8,25,65,38.5,40,43,1,42,21,83,52,1,Matches,2021-2022,Bundesliga
Aymen Barkok,ma MAR,"MF,DF",Eint Frankfurt,23.0,1998.0,1.8,6,2,2,3,1,2,7,28.6,5,4,1,3,5,11,6,0,Matches,2021-2022,Bundesliga
Leandro Barreiro Martins,lu LUX,MF,Mainz 05,21.0,2000.0,19.9,63,32,23,27,13,29,50,58.0,21,23,6,17,32,95,23,0,Matches,2021-2022,Bundesliga
Jacob Barrett Laursen,dk DEN,DF,Arminia,26.0,1994.0,18.1,16,12,10,6,0,8,21,38.1,13,19,7,12,28,44,43,0,Matches,2021-2022,Bundesliga
Abdourahmane Barry,gn GUI,DF,Greuther Fürth,21.0,2000.0,2.3,6,4,3,3,0,5,7,71.4,2,5,2,3,4,10,1,0,Matches,2021-2022,Bundesliga
Maximilian Bauer,de GER,DF,Greuther Fürth,21.0,2000.0,18.8,28,15,17,10,1,11,28,39.3,17,24,14,10,29,57,99,0,Matches,2021-2022,Bundesliga
Oliver Baumann,de GER,GK,Hoffenheim,31.0,1990.0,33.0,0,0,0,0,0,0,3,0.0,3,0,0,0,0,0,19,1,Matches,2021-2022,Bundesliga
Timo Baumgartl,de GER,DF,Union Berlin,25.0,1996.0,24.1,59,28,34,21,4,31,47,66.0,16,27,11,16,37,96,58,0,Matches,2021-2022,Bundesliga
Julian Baumgartlinger,at AUT,"MF,FW",Leverkusen,33.0,1988.0,1.0,3,1,2,1,0,1,2,50.0,1,1,0,1,2,5,0,0,Matches,2021-2022,Bundesliga
Christoph Baumgartner,at AUT,"MF,FW",Hoffenheim,21.0,1999.0,21.0,28,15,14,7,7,13,32,40.6,19,24,3,21,8,36,16,0,Matches,2021-2022,Bundesliga
Noah Joel Sarenren Bazee,ng NGA,"MF,FW",Augsburg,24.0,1996.0,2.7,5,2,2,2,1,3,4,75.0,1,8,2,6,1,6,4,0,Matches,2021-2022,Bundesliga
Ihlas Bebou,tg TOG,"FW,DF",Hoffenheim,27.0,1994.0,23.2,22,14,5,12,5,7,21,33.3,14,20,3,17,12,34,25,0,Matches,2021-2022,Bundesliga
Sheraldo Becker,sr SUR,"FW,MF",Union Berlin,26.0,1995.0,19.5,9,6,3,4,2,6,18,33.3,12,11,0,11,2,11,4,0,Matches,2021-2022,Bundesliga
Kevin Behrens,de GER,FW,Union Berlin,30.0,1991.0,5.5,3,2,1,1,1,0,4,0.0,4,3,0,3,3,6,7,0,Matches,2021-2022,Bundesliga
Ishak Belfodil,dz ALG,FW,Hertha BSC,29.0,1992.0,18.2,9,6,4,4,1,4,8,50.0,4,9,1,8,5,14,16,0,Matches,2021-2022,Bundesliga
Stefan Bell,de GER,DF,Mainz 05,29.0,1991.0,31.8,54,23,37,16,1,30,63,47.6,33,26,15,11,41,95,112,1,Matches,2021-2022,Bundesliga
Armel Bella Kotchap,de GER,DF,Bochum,19.0,2001.0,19.6,34,20,25,9,0,18,28,64.3,10,21,16,5,42,76,84,2,Matches,2021-2022,Bundesliga
Karim Bellarabi,de GER,"FW,MF",Leverkusen,31.0,1990.0,7.6,9,4,4,4,1,3,13,23.1,10,5,0,5,9,18,4,0,Matches,2021-2022,Bundesliga
Jude Bellingham,eng ENG,MF,Dortmund,18.0,2003.0,31.0,52,34,15,31,6,21,53,39.6,32,50,4,46,42,94,32,0,Matches,2021-2022,Bundesliga
George Bello,us USA,DF,Arminia,19.0,2002.0,4.8,7,7,7,0,0,4,4,100.0,0,5,4,1,6,13,11,0,Matches,2021-2022,Bundesliga
László Bénes,sk SVK,MF,Gladbach,23.0,1997.0,2.7,5,3,1,3,1,1,6,16.7,5,5,2,3,2,7,5,0,Matches,2021-2022,Bundesliga
Keanan Bennetts,eng ENG,"FW,DF",Gladbach,22.0,1999.0,0.6,2,0,1,1,0,1,1,100.0,0,1,0,1,0,2,0,0,Matches,2021-2022,Bundesliga
Ramy Bensebaini,dz ALG,DF,Gladbach,26.0,1995.0,22.4,42,30,24,15,3,27,44,61.4,17,33,7,26,39,81,77,1,Matches,2021-2022,Bundesliga
Jordan Beyer,de GER,DF,Gladbach,21.0,2000.0,15.4,46,27,32,13,1,23,39,59.0,16,18,5,13,15,61,52,2,Matches,2021-2022,Bundesliga
Bartosz Białek,pl POL,"FW,DF",Wolfsburg,19.0,2001.0,2.0,0,0,0,0,0,0,1,0.0,1,1,0,1,0,0,2,0,Matches,2021-2022,Bundesliga
Ermin Bičakčić,ba BIH,DF,Hoffenheim,31.0,1990.0,0.1,0,0,0,0,0,0,0,,0,0,0,0,0,0,0,0,Matches,2021-2022,Bundesliga
Tom Bischof,de GER,MF,Hoffenheim,16.0,2005.0,0.2,0,0,0,0,0,0,0,,0,1,0,1,0,0,1,0,Matches,2021-2022,Bundesliga
Danny Blum,de GER,FW,Bochum,30.0,1991.0,3.8,2,1,0,0,2,0,2,0.0,2,4,0,4,2,4,1,0,Matches,2021-2022,Bundesliga
Kevin-Prince Boateng,gh GHA,"MF,FW",Hertha BSC,34.0,1987.0,7.7,6,5,1,4,1,3,9,33.3,6,7,2,5,6,12,11,0,Matches,2021-2022,Bundesliga
Herbert Bockhorn,de GER,DF,Bochum,26.0,1995.0,9.4,20,14,13,4,3,12,20,60.0,8,10,1,9,14,34,18,0,Matches,2021-2022,Bundesliga
Jean-Paul Boëtius,nl NED,MF,Mainz 05,27.0,1994.0,20.0,40,23,18,17,5,22,53,41.5,31,41,3,38,25,65,11,0,Matches,2021-2022,Bundesliga
Tarsis Bonga,de GER,"MF,FW",Bochum,24.0,1997.0,0.2,0,0,0,0,0,0,0,,0,0,0,0,0,0,0,0,Matches,2021-2022,Bundesliga
Solomon Bonnah,nl NED,DF,RB Leipzig,17.0,2003.0,0.1,0,0,0,0,0,0,0,,0,1,0,1,1,1,0,0,Matches,2021-2022,Bundesliga
Sebastiaan Bornauw,be BEL,DF,Wolfsburg,22.0,1999.0,22.3,30,19,23,5,2,16,25,64.0,9,29,8,21,42,72,97,1,Matches,2021-2022,Bundesliga
Rafael Borré,co COL,FW,Eint Frankfurt,25.0,1995.0,26.4,31,22,4,13,14,7,33,21.2,26,24,4,20,5,36,9,0,Matches,2021-2022,Bundesliga
Dedryck Boyata,be BEL,DF,Hertha BSC,30.0,1990.0,21.1,15,13,11,3,1,8,11,72.7,3,17,13,4,17,32,134,1,Matches,2021-2022,Bundesliga
Julian Brandt,de GER,"MF,FW",Dortmund,25.0,1996.0,23.1,37,19,13,20,4,17,54,31.5,37,19,2,17,24,61,14,1,Matches,2021-2022,Bundesliga
Iker Bravo,es ESP,FW,Leverkusen,16.0,2005.0,0.1,1,1,0,1,0,0,0,,0,0,0,0,0,1,0,0,Matches,2021-2022,Bundesliga
Fabian Bredlow,de GER,GK,Stuttgart,26.0,1995.0,4.0,0,0,0,0,0,0,0,,0,0,0,0,0,0,1,0,Matches,2021-2022,Bundesliga
Josip Brekalo,hr CRO,FW,Wolfsburg,23.0,1998.0,0.2,0,0,0,0,0,0,0,,0,0,0,0,0,0,0,0,Matches,2021-2022,Bundesliga
Brian Brobbey,nl NED,"FW,MF",RB Leipzig,19.0,2002.0,1.5,1,0,0,1,0,1,1,100.0,0,1,0,1,0,1,0,0,Matches,2021-2022,Bundesliga
John Brooks,us USA,DF,Wolfsburg,28.0,1993.0,29.1,47,25,25,18,4,36,60,60.0,24,33,19,14,41,88,125,1,Matches,2021-2022,Bundesliga
Daniel Brosinski,de GER,DF,Mainz 05,33.0,1988.0,4.3,2,1,1,1,0,1,1,100.0,0,6,0,6,3,5,9,0,Matches,2021-2022,Bundesliga
Cédric Brunner,ch SUI,DF,Arminia,27.0,1994.0,24.3,51,35,29,20,2,25,49,51.0,24,27,10,17,43,94,84,0,Matches,2021-2022,Bundesliga
Jacob Bruun Larsen,dk DEN,"FW,MF",Hoffenheim,22.0,1998.0,9.0,2,1,1,1,0,0,5,0.0,5,14,3,11,5,7,5,2,Matches,2021-2022,Bundesliga
Sascha Burchert,de GER,GK,Greuther Fürth,31.0,1989.0,14.0,1,1,1,0,0,1,2,50.0,1,0,0,0,0,1,11,1,Matches,2021-2022,Bundesliga
Delano Burgzorg,sr SUR,MF,Mainz 05,22.0,1998.0,0.3,1,1,1,0,0,0,1,0.0,1,0,0,0,0,1,0,0,Matches,2021-2022,Bundesliga
Jonathan Burkardt,de GER,"FW,MF",Mainz 05,21.0,2000.0,29.0,17,8,0,10,7,6,25,24.0,19,31,5,26,8,25,16,0,Matches,2021-2022,Bundesliga
Roman Bürki,ch SUI,GK,Dortmund,30.0,1990.0,1.0,0,0,0,0,0,0,0,,0,0,0,0,0,0,0,0,Matches,2021-2022,Bundesliga
Daniel Caligiuri,it ITA,"DF,MF",Augsburg,33.0,1988.0,22.3,46,30,17,26,3,27,72,37.5,45,36,5,31,18,64,33,0,Matches,2021-2022,Bundesliga
Emre Can,de GER,"DF,MF",Dortmund,27.0,1994.0,18.8,36,22,20,16,0,15,30,50.0,15,26,10,16,36,72,40,2,Matches,2021-2022,Bundesliga
Koen Casteels,be BEL,GK,Wolfsburg,29.0,1992.0,28.0,0,0,0,0,0,0,1,0.0,1,0,0,0,0,0,9,2,Matches,2021-2022,Bundesliga
Gonzalo Castro,de GER,"MF,FW",Arminia,34.0,1987.0,4.8,8,3,4,4,0,1,5,20.0,4,3,0,3,3,11,3,0,Matches,2021-2022,Bundesliga
Julian Chabot,de GER,DF,Köln,23.0,1998.0,2.3,8,3,4,4,0,2,5,40.0,3,4,2,2,3,11,5,1,Matches,2021-2022,Bundesliga
Timothy Chandler,us USA,DF,Eint Frankfurt,31.0,1990.0,13.5,18,12,10,8,0,11,24,45.8,13,10,3,7,19,37,28,1,Matches,2021-2022,Bundesliga
Justin Che,us USA,"FW,DF",Hoffenheim,17.0,2003.0,0.5,2,0,1,0,1,1,2,50.0,1,0,0,0,1,3,0,0,Matches,2021-2022,Bundesliga
Max Christiansen,de GER,MF,Greuther Fürth,24.0,1996.0,22.8,46,25,19,22,5,18,43,41.9,25,52,16,36,68,114,56,0,Matches,2021-2022,Bundesliga
Kingsley Coman,fr FRA,"FW,DF",Bayern Munich,25.0,1996.0,15.1,14,8,1,9,4,5,16,31.3,11,14,0,14,8,22,5,0,Matches,2021-2022,Bundesliga
Lucas Copado,de GER,FW,Bayern Munich,17.0,2004.0,0.2,1,0,1,0,0,1,1,100.0,0,0,0,0,0,1,0,0,Matches,2021-2022,Bundesliga
Sergio Córdova,ve VEN,"FW,MF",Augsburg,23.0,1997.0,3.6,4,3,2,2,0,1,2,50.0,1,4,0,4,0,4,4,0,Matches,2021-2022,Bundesliga
Danny da Costa,de GER,"DF,MF",Eint Frankfurt,28.0,1993.0,8.1,15,4,6,7,2,6,18,33.3,12,14,1,13,11,26,18,1,Matches,2021-2022,Bundesliga
Tanguy Coulibaly,fr FRA,"FW,MF",Stuttgart,20.0,2001.0,12.0,27,15,14,11,2,9,19,47.4,10,14,2,12,4,31,10,0,Matches,2021-2022,Bundesliga
Mickaël Cuisance,fr FRA,MF,Bayern Munich,21.0,1999.0,0.1,1,1,0,1,0,0,0,,0,0,0,0,0,1,0,0,Matches,2021-2022,Bundesliga
Matheus Cunha,br BRA,FW,Hertha BSC,22.0,1999.0,0.7,0,0,0,0,0,0,0,,0,0,0,0,0,0,0,0,Matches,2021-2022,Bundesliga
Rafael Czichos,de GER,DF,Köln,31.0,1990.0,15.6,29,18,18,9,2,14,28,50.0,14,23,13,10,19,48,53,2,Matches,2021-2022,Bundesliga
Lennart-Marten Czyborra,de GER,DF,Arminia,22.0,1999.0,1.5,0,0,0,0,0,0,2,0.0,2,0,0,0,3,3,3,1,Matches,2021-2022,Bundesliga
Moanes Dabbur,il ISR,"FW,MF",Hoffenheim,29.0,1992.0,14.6,18,10,3,5,10,4,17,23.5,13,10,0,10,5,23,4,0,Matches,2021-2022,Bundesliga
Finn Dahmen,de GER,GK,Mainz 05,23.0,1998.0,2.0,0,0,0,0,0,0,0,,0,0,0,0,0,0,2,0,Matches,2021-2022,Bundesliga
Mahmoud Dahoud,de GER,MF,Dortmund,25.0,1996.0,18.4,42,19,10,24,8,20,46,43.5,26,18,3,15,17,59,16,0,Matches,2021-2022,Bundesliga
Márton Dárdai,hu HUN,DF,Hertha BSC,19.0,2002.0,8.4,10,4,8,2,0,8,18,44.4,10,16,6,10,20,30,33,2,Matches,2021-2022,Bundesliga
Vladimír Darida,cz CZE,MF,Hertha BSC,30.0,1990.0,19.8,32,18,15,13,4,13,32,40.6,19,22,3,19,20,52,17,2,Matches,2021-2022,Bundesliga
Alphonso Davies,ca CAN,DF,Bayern Munich,20.0,2000.0,19.3,34,17,17,8,9,13,31,41.9,18,27,1,26,23,57,26,1,Matches,2021-2022,Bundesliga
Saulo Decarli,ch SUI,DF,Bochum,29.0,1992.0,0.1,0,0,0,0,0,0,0,,0,0,0,0,0,0,0,0,Matches,2021-2022,Bundesliga
Thomas Delaney,dk DEN,MF,Dortmund,29.0,1991.0,0.2,0,0,0,0,0,0,0,,0,0,0,0,0,0,0,0,Matches,2021-2022,Bundesliga
Kerem Demirbay,de GER,MF,Leverkusen,28.0,1993.0,22.8,52,31,19,30,3,16,41,39.0,25,32,9,23,33,85,21,0,Matches,2021-2022,Bundesliga
Ermedin Demirović,ba BIH,FW,Freiburg,23.0,1998.0,9.7,12,6,4,4,4,1,10,10.0,9,14,1,13,1,13,7,0,Matches,2021-2022,Bundesliga
Mike van der Hoorn,nl NED,DF,Arminia,28.0,1992.0,0.2,1,0,1,0,0,0,0,,0,0,0,0,1,2,2,0,Matches,2021-2022,Bundesliga
Moussa Diaby,fr FRA,"FW,MF",Leverkusen,22.0,1999.0,30.7,20,11,8,9,3,5,38,13.2,33,11,0,11,8,28,2,0,Matches,2021-2022,Bundesliga
Daniel Didavi,de GER,"MF,FW",Stuttgart,31.0,1990.0,3.1,6,2,0,4,2,4,7,57.1,3,4,1,3,1,7,1,0,Matches,2021-2022,Bundesliga
Javairô Dilrosun,nl NED,FW,Hertha BSC,23.0,1998.0,1.5,3,1,1,2,0,1,1,100.0,0,1,0,1,0,3,0,0,Matches,2021-2022,Bundesliga
Lee Dongjun,kr KOR,"MF,FW",Hertha BSC,24.0,1997.0,1.3,2,1,0,2,0,1,3,33.3,2,2,0,2,2,4,1,0,Matches,2021-2022,Bundesliga
Niklas Dorsch,de GER,MF,Augsburg,23.0,1998.0,25.8,76,47,47,23,6,30,60,50.0,30,34,12,22,35,111,36,3,Matches,2021-2022,Bundesliga
Ondrej Duda,sk SVK,"MF,FW",Köln,26.0,1994.0,17.9,23,16,4,12,7,6,23,26.1,17,14,2,12,17,40,9,0,Matches,2021-2022,Bundesliga
Jeremy Dudziak,tn TUN,"MF,FW",Greuther Fürth,25.0,1995.0,12.6,17,6,5,8,4,3,14,21.4,11,8,0,8,10,27,4,0,Matches,2021-2022,Bundesliga
Erik Durm,de GER,DF,Eint Frankfurt,29.0,1992.0,5.3,13,7,6,5,2,10,13,76.9,3,8,1,7,10,23,7,0,Matches,2021-2022,Bundesliga
Maximilian Eggestein,de GER,MF,Freiburg,24.0,1996.0,24.4,48,28,17,25,6,22,50,44.0,28,35,11,24,30,78,32,1,Matches,2021-2022,Bundesliga
Lilian Egloff,de GER,"MF,DF",Stuttgart,18.0,2002.0,0.3,1,0,0,1,0,0,0,,0,1,0,1,0,1,0,0,Matches,2021-2022,Bundesliga
Kingsley Ehizibue,nl NED,DF,Köln,26.0,1995.0,7.6,32,18,27,5,0,15,24,62.5,9,13,4,9,9,41,26,0,Matches,2021-2022,Bundesliga
Julian Eitschberger,de GER,DF,Hertha BSC,17.0,2004.0,0.5,0,0,0,0,0,0,1,0.0,1,1,1,0,2,2,2,0,Matches,2021-2022,Bundesliga
Jurgen Ekkelenkamp,nl NED,"MF,FW",Hertha BSC,21.0,2000.0,8.0,8,3,2,6,0,2,7,28.6,5,9,2,7,4,12,5,0,Matches,2021-2022,Bundesliga
Nico Elvedi,ch SUI,DF,Gladbach,24.0,1996.0,27.0,40,24,23,17,0,22,36,61.1,14,33,22,11,34,74,83,1,Matches,2021-2022,Bundesliga
Breel Embolo,ch SUI,FW,Gladbach,24.0,1997.0,24.1,16,11,1,12,3,3,8,37.5,5,14,2,12,6,22,7,0,Matches,2021-2022,Bundesliga
Keita Endo,jp JPN,MF,Union Berlin,23.0,1997.0,0.6,1,1,1,0,0,0,0,,0,1,0,1,0,1,0,0,Matches,2021-2022,Bundesliga
Wataru Endo,jp JPN,MF,Stuttgart,28.0,1993.0,32.2,73,41,34,34,5,31,72,43.1,41,43,12,31,30,103,64,0,Matches,2021-2022,Bundesliga
Michael Esser,de GER,GK,Bochum,33.0,1987.0,3.0,0,0,0,0,0,0,1,0.0,1,0,0,0,0,0,2,0,Matches,2021-2022,Bundesliga
Wahid Faghir,dk DEN,FW,Stuttgart,18.0,2003.0,1.4,0,0,0,0,0,0,1,0.0,1,2,0,2,0,0,0,0,Matches,2021-2022,Bundesliga
Ömer Faruk Beyaz,tr TUR,"DF,MF",Stuttgart,17.0,2003.0,0.8,4,3,1,3,0,1,5,20.0,4,0,0,0,2,6,0,0,Matches,2021-2022,Bundesliga
Adrian Fein,de GER,MF,Greuther Fürth,22.0,1999.0,0.4,0,0,0,0,0,0,1,0.0,1,0,0,0,2,2,0,0,Matches,2021-2022,Bundesliga
Ohis Felix Uduokhai,de GER,DF,Augsburg,23.0,1997.0,8.7,9,6,6,3,0,6,11,54.5,5,13,8,5,9,18,33,0,Matches,2021-2022,Bundesliga
Edimilson Fernandes,ch SUI,"MF,FW",Arminia,25.0,1996.0,3.1,2,0,1,1,0,1,4,25.0,3,2,2,0,2,4,6,0,Matches,2021-2022,Bundesliga
Alfreð Finnbogason,is ISL,FW,Augsburg,32.0,1989.0,3.2,3,1,0,2,1,2,4,50.0,2,5,1,4,2,5,8,0,Matches,2021-2022,Bundesliga
Mark Flekken,nl NED,GK,Freiburg,28.0,1993.0,32.0,0,0,0,0,0,0,2,0.0,2,1,0,1,2,2,10,1,Matches,2021-2022,Bundesliga
Emil Forsberg,se SWE,MF,RB Leipzig,29.0,1991.0,19.0,21,12,2,11,8,7,22,31.8,15,18,0,18,2,23,2,1,Matches,2021-2022,Bundesliga
Philipp Förster,de GER,"MF,FW",Stuttgart,26.0,1995.0,10.7,20,13,4,12,4,11,26,42.3,15,12,1,11,3,23,2,0,Matches,2021-2022,Bundesliga
Timothy Fosu-Mensah,nl NED,DF,Leverkusen,23.0,1998.0,1.6,5,3,3,1,1,4,4,100.0,0,1,0,1,2,7,2,0,Matches,2021-2022,Bundesliga
Raphael Framberger,de GER,DF,Augsburg,25.0,1995.0,9.4,26,19,12,10,4,13,27,48.1,14,8,2,6,9,35,25,0,Matches,2021-2022,Bundesliga
Marvin Friedrich,de GER,DF,Gladbach,25.0,1995.0,6.7,14,8,10,4,0,9,11,81.8,2,5,3,2,5,19,26,0,Matches,2021-2022,Bundesliga
Marvin Friedrich,de GER,DF,Union Berlin,25.0,1995.0,13.0,17,5,14,3,0,10,16,62.5,6,13,7,6,23,40,47,0,Matches,2021-2022,Bundesliga
Jeremie Frimpong,nl NED,DF,Leverkusen,20.0,2000.0,22.8,32,18,19,12,1,12,23,52.2,11,24,6,18,17,49,40,2,Matches,2021-2022,Bundesliga
Christian Früchtl,de GER,GK,Bayern Munich,21.0,2000.0,0.1,0,0,0,0,0,0,0,,0,0,0,0,0,0,0,0,Matches,2021-2022,Bundesliga
Chris Führich,de GER,"FW,MF",Stuttgart,23.0,1998.0,19.0,28,16,10,10,8,18,39,46.2,21,31,2,29,8,36,9,0,Matches,2021-2022,Bundesliga
Marius Funk,de GER,GK,Greuther Fürth,25.0,1996.0,8.0,0,0,0,0,0,0,0,,0,0,0,0,0,0,8,1,Matches,2021-2022,Bundesliga
Stephan Fürstner,de GER,MF,Mainz 05,33.0,1987.0,0.1,0,0,0,0,0,0,2,0.0,2,0,0,0,0,0,1,0,Matches,2021-2022,Bundesliga
Mijat Gaćinović,rs SRB,"FW,MF",Hoffenheim,26.0,1995.0,1.2,3,3,1,1,1,3,3,100.0,0,1,0,1,1,4,2,0,Matches,2021-2022,Bundesliga
Cristian Gamboa,cr CRC,DF,Bochum,31.0,1989.0,19.1,59,36,40,16,3,30,61,49.2,31,22,7,15,32,91,35,1,Matches,2021-2022,Bundesliga
Silvère Ganvoula M'Boussy,cg CGO,FW,Bochum,25.0,1996.0,1.7,0,0,0,0,0,0,1,0.0,1,0,0,0,0,0,1,0,Matches,2021-2022,Bundesliga
Linus Gechter,de GER,DF,Hertha BSC,17.0,2004.0,8.0,15,8,13,2,0,7,14,50.0,7,12,7,5,11,26,29,0,Matches,2021-2022,Bundesliga
Dennis Geiger,de GER,MF,Hoffenheim,23.0,1998.0,15.3,34,23,9,20,5,17,30,56.7,13,15,1,14,14,48,7,1,Matches,2021-2022,Bundesliga
Yannick Gerhardt,de GER,"MF,DF",Wolfsburg,27.0,1994.0,17.5,42,20,18,17,7,22,36,61.1,14,24,1,23,25,67,25,1,Matches,2021-2022,Bundesliga
Hamadi Al Ghaddioui,ma MAR,FW,Stuttgart,30.0,1990.0,5.5,5,4,2,1,2,0,4,0.0,4,3,1,2,0,5,4,0,Matches,2021-2022,Bundesliga
Niko Gießelmann,de GER,"DF,FW",Union Berlin,29.0,1991.0,23.1,24,17,10,11,3,15,38,39.5,23,26,4,22,18,42,29,1,Matches,2021-2022,Bundesliga
Rafał Gikiewicz,pl POL,GK,Augsburg,33.0,1987.0,34.0,2,0,2,0,0,2,7,28.6,5,0,0,0,3,5,11,5,Matches,2021-2022,Bundesliga
Daniel Ginczek,de GER,"MF,FW",Wolfsburg,30.0,1991.0,0.1,0,0,0,0,0,0,0,,0,0,0,0,0,0,0,0,Matches,2021-2022,Bundesliga
Matthias Ginter,de GER,DF,Gladbach,27.0,1994.0,26.2,36,22,20,13,3,27,40,67.5,13,21,10,11,33,69,76,0,Matches,2021-2022,Bundesliga
Jamie Gittens,eng ENG,FW,Dortmund,16.0,2004.0,1.5,3,2,0,2,1,2,5,40.0,3,4,1,3,1,4,1,0,Matches,2021-2022,Bundesliga
Serge Gnabry,de GER,"FW,DF",Bayern Munich,26.0,1995.0,24.3,47,31,16,20,11,22,57,38.6,35,26,0,26,14,61,3,0,Matches,2021-2022,Bundesliga
Leon Goretzka,de GER,MF,Bayern Munich,26.0,1995.0,15.5,25,15,12,9,4,11,26,42.3,15,11,1,10,17,42,23,2,Matches,2021-2022,Bundesliga
Jeffrey Gouweleeuw,nl NED,DF,Augsburg,30.0,1991.0,28.6,50,27,33,17,0,22,36,61.1,14,35,18,17,49,99,116,0,Matches,2021-2022,Bundesliga
Jens Grahl,de GER,GK,Eint Frankfurt,32.0,1988.0,1.0,0,0,0,0,0,0,0,,0,0,0,0,0,0,1,0,Matches,2021-2022,Bundesliga
Julian Green,us USA,MF,Greuther Fürth,26.0,1995.0,11.7,9,5,0,8,1,2,8,25.0,6,10,2,8,7,16,10,0,Matches,2021-2022,Bundesliga
Michael Gregoritsch,at AUT,"FW,MF",Augsburg,27.0,1994.0,15.5,19,8,4,10,5,2,15,13.3,13,18,2,16,6,25,29,0,Matches,2021-2022,Bundesliga
Sebastian Griesbeck,de GER,"DF,MF",Greuther Fürth,30.0,1990.0,27.1,60,31,38,19,3,39,62,62.9,23,38,13,25,43,103,100,1,Matches,2021-2022,Bundesliga
Sebastian Griesbeck,de GER,MF,Union Berlin,30.0,1990.0,0.1,1,1,0,1,0,1,1,100.0,0,0,0,0,0,1,0,0,Matches,2021-2022,Bundesliga
Vincenzo Grifo,it ITA,"MF,FW",Freiburg,28.0,1993.0,30.8,27,15,9,13,5,9,26,34.6,17,12,2,10,13,40,28,0,Matches,2021-2022,Bundesliga
Lennart Grill,de GER,GK,Leverkusen,22.0,1999.0,1.0,0,0,0,0,0,0,0,,0,0,0,0,0,0,0,0,Matches,2021-2022,Bundesliga
Florian Grillitsch,at AUT,"DF,MF",Hoffenheim,25.0,1995.0,16.6,37,19,15,21,1,17,31,54.8,14,18,7,11,29,66,36,1,Matches,2021-2022,Bundesliga
Carlos Gruezo,ec ECU,MF,Augsburg,26.0,1995.0,10.8,22,11,10,10,2,8,21,38.1,13,11,2,9,9,31,15,0,Matches,2021-2022,Bundesliga
Raphaël Guerreiro,pt POR,DF,Dortmund,27.0,1993.0,19.9,35,19,19,12,4,16,31,51.6,15,18,2,16,25,60,14,1,Matches,2021-2022,Bundesliga
Josuha Guilavogui,fr FRA,"MF,DF",Wolfsburg,30.0,1990.0,10.5,23,14,13,9,1,7,18,38.9,11,11,6,5,25,48,42,0,Matches,2021-2022,Bundesliga
Péter Gulácsi,hu HUN,GK,RB Leipzig,31.0,1990.0,33.0,0,0,0,0,0,0,0,,0,0,0,0,1,1,15,1,Matches,2021-2022,Bundesliga
Manuel Gulde,de GER,DF,Freiburg,30.0,1991.0,13.6,18,10,14,3,1,8,11,72.7,3,16,8,8,17,35,37,0,Matches,2021-2022,Bundesliga
Robert Gumny,pl POL,DF,Augsburg,23.0,1998.0,25.2,48,29,25,20,3,25,43,58.1,18,24,7,17,28,76,57,3,Matches,2021-2022,Bundesliga
Christian Günter,de GER,"DF,MF",Freiburg,28.0,1993.0,34.0,34,20,16,15,3,18,50,36.0,32,23,6,17,17,51,49,2,Matches,2021-2022,Bundesliga
Lasse Günther,de GER,DF,Augsburg,18.0,2003.0,1.8,8,5,4,3,1,5,9,55.6,4,0,0,0,2,10,2,0,Matches,2021-2022,Bundesliga
Joško Gvardiol,hr CRO,DF,RB Leipzig,19.0,2002.0,26.8,47,31,28,17,2,22,39,56.4,17,30,11,19,51,98,62,2,Matches,2021-2022,Bundesliga
Erling Haaland,no NOR,FW,Dortmund,21.0,2000.0,21.2,2,1,0,1,1,0,1,0.0,1,8,1,7,1,3,31,0,Matches,2021-2022,Bundesliga
Janik Haberer,de GER,MF,Freiburg,27.0,1994.0,9.1,14,8,5,6,3,7,19,36.8,12,11,4,7,16,30,11,0,Matches,2021-2022,Bundesliga
Alexander Hack,de GER,DF,Mainz 05,27.0,1993.0,23.0,52,26,35,17,0,29,46,63.0,17,31,14,17,51,103,95,1,Matches,2021-2022,Bundesliga
Robin Hack,de GER,"FW,MF",Arminia,22.0,1998.0,15.2,14,8,6,5,3,3,21,14.3,18,18,1,17,5,19,4,0,Matches,2021-2022,Bundesliga
André Hahn,de GER,"MF,FW",Augsburg,30.0,1990.0,23.3,36,20,9,15,12,17,50,34.0,33,38,5,33,15,51,43,0,Matches,2021-2022,Bundesliga
Amadou Haidara,ml MLI,MF,RB Leipzig,23.0,1998.0,14.7,30,14,11,19,0,17,37,45.9,20,22,6,16,16,46,8,1,Matches,2021-2022,Bundesliga
Marcel Halstenberg,de GER,DF,RB Leipzig,29.0,1991.0,5.6,10,7,6,4,0,6,11,54.5,5,6,0,6,7,17,11,0,Matches,2021-2022,Bundesliga
Genki Haraguchi,jp JPN,MF,Union Berlin,30.0,1991.0,19.5,37,20,12,22,3,15,48,31.3,33,25,3,22,26,63,15,0,Matches,2021-2022,Bundesliga
Luis Hartwig,de GER,FW,Bochum,18.0,2002.0,0.0,0,0,0,0,0,0,0,,0,0,0,0,0,0,0,0,Matches,2021-2022,Bundesliga
Makoto Hasebe,jp JPN,DF,Eint Frankfurt,37.0,1984.0,13.2,27,12,15,11,1,13,29,44.8,16,24,8,16,22,49,36,0,Matches,2021-2022,Bundesliga
Thorgan Hazard,be BEL,"FW,DF",Dortmund,28.0,1993.0,14.9,23,13,8,10,5,15,40,37.5,25,23,1,22,6,29,4,0,Matches,2021-2022,Bundesliga
Jonas Hector,de GER,DF,Köln,31.0,1990.0,28.4,76,39,36,26,14,29,74,39.2,45,59,8,51,50,126,68,1,Matches,2021-2022,Bundesliga
Hwang Hee-chan,kr KOR,FW,RB Leipzig,25.0,1996.0,0.5,0,0,0,0,0,0,0,,0,0,0,0,1,1,0,0,Matches,2021-2022,Bundesliga
Dominique Heintz,de GER,DF,Union Berlin,27.0,1993.0,5.2,8,5,5,3,0,3,6,50.0,3,7,4,3,7,15,14,0,Matches,2021-2022,Bundesliga
Dominique Heintz,de GER,DF,Freiburg,27.0,1993.0,0.3,0,0,0,0,0,0,0,,0,0,0,0,1,1,0,0,Matches,2021-2022,Bundesliga
Benjamin Henrichs,de GER,DF,RB Leipzig,24.0,1997.0,12.7,30,21,18,6,6,12,22,54.5,10,16,1,15,19,49,14,0,Matches,2021-2022,Bundesliga
Lucas Hernández,fr FRA,DF,Bayern Munich,25.0,1996.0,22.6,50,31,20,24,6,26,42,61.9,16,22,11,11,28,78,54,1,Matches,2021-2022,Bundesliga
Patrick Herrmann,de GER,"DF,FW",Gladbach,30.0,1991.0,8.4,15,7,5,6,4,9,24,37.5,15,10,1,9,6,21,8,0,Matches,2021-2022,Bundesliga
Piero Hincapié,ec ECU,DF,Leverkusen,19.0,2002.0,19.5,33,23,23,8,2,19,25,76.0,6,34,15,19,33,66,56,2,Matches,2021-2022,Bundesliga
Martin Hinteregger,at AUT,DF,Eint Frankfurt,28.0,1992.0,24.7,45,28,28,16,1,28,43,65.1,15,36,16,20,42,87,78,3,Matches,2021-2022,Bundesliga
Marwin Hitz,ch SUI,GK,Dortmund,33.0,1987.0,4.5,0,0,0,0,0,0,0,,0,0,0,0,0,0,2,0,Matches,2021-2022,Bundesliga
Nicolas Höfler,de GER,MF,Freiburg,31.0,1990.0,28.9,73,42,37,29,7,28,62,45.2,34,50,21,29,46,119,42,0,Matches,2021-2022,Bundesliga
Jonas Hofmann,de GER,"MF,FW",Gladbach,29.0,1992.0,23.1,30,20,6,17,7,17,42,40.5,25,23,0,23,12,42,10,0,Matches,2021-2022,Bundesliga
Lucas Höler,de GER,FW,Freiburg,27.0,1994.0,28.7,41,25,10,17,14,13,28,46.4,15,25,4,21,17,58,39,2,Matches,2021-2022,Bundesliga
Gerrit Holtmann,ph PHI,"FW,MF",Bochum,26.0,1995.0,20.4,15,9,5,3,7,6,22,27.3,16,26,2,24,8,23,6,0,Matches,2021-2022,Bundesliga
Justin Hoogma,nl NED,DF,Greuther Fürth,23.0,1998.0,3.0,6,5,4,2,0,4,6,66.7,2,5,5,0,4,10,4,0,Matches,2021-2022,Bundesliga
Jannes Horn,de GER,DF,Köln,24.0,1997.0,5.3,6,4,4,2,0,4,8,50.0,4,1,1,0,3,9,9,0,Matches,2021-2022,Bundesliga
Timo Horn,de GER,GK,Köln,28.0,1993.0,13.0,0,0,0,0,0,0,1,0.0,1,0,0,0,0,0,5,0,Matches,2021-2022,Bundesliga
Lukáš Hrádecký,fi FIN,GK,Leverkusen,31.0,1989.0,32.0,1,1,1,0,0,1,1,100.0,0,0,0,0,0,1,10,1,Matches,2021-2022,Bundesliga
Branimir Hrgota,se SWE,FW,Greuther Fürth,28.0,1993.0,30.9,46,29,10,31,5,21,72,29.2,51,27,1,26,11,57,3,1,Matches,2021-2022,Bundesliga
Ajdin Hrustic,au AUS,MF,Eint Frankfurt,25.0,1996.0,10.7,16,11,5,7,4,11,32,34.4,21,18,1,17,10,26,7,0,Matches,2021-2022,Bundesliga
Timo Hübers,de GER,DF,Köln,25.0,1996.0,19.3,45,27,28,17,0,27,45,60.0,18,31,19,12,52,97,95,0,Matches,2021-2022,Bundesliga
Benjamin Hübner,de GER,DF,Hoffenheim,32.0,1989.0,4.2,9,5,0,7,2,3,5,60.0,2,2,2,0,9,18,7,0,Matches,2021-2022,Bundesliga
Mats Hummels,de GER,DF,Dortmund,32.0,1988.0,19.6,34,22,20,13,1,20,36,55.6,16,18,13,5,32,66,66,1,Matches,2021-2022,Bundesliga
Iago,br BRA,DF,Augsburg,24.0,1997.0,24.2,49,29,25,19,5,15,34,44.1,19,28,6,22,27,76,62,0,Matches,2021-2022,Bundesliga
Stefan Ilsanker,at AUT,"DF,MF",Eint Frankfurt,32.0,1989.0,3.0,14,8,7,6,1,5,10,50.0,5,6,2,4,6,20,15,1,Matches,2021-2022,Bundesliga
Burak İnce,tr TUR,FW,Arminia,17.0,2004.0,1.5,1,1,1,0,0,1,2,50.0,1,1,0,1,0,1,0,0,Matches,2021-2022,Bundesliga
Marcus Ingvartsen,dk DEN,MF,Union Berlin,25.0,1996.0,1.4,0,0,0,0,0,0,2,0.0,2,0,0,0,2,2,1,0,Matches,2021-2022,Bundesliga
Marcus Ingvartsen,dk DEN,"FW,MF",Mainz 05,25.0,1996.0,7.6,3,2,2,0,1,3,9,33.3,6,6,0,6,6,9,7,1,Matches,2021-2022,Bundesliga
Hiroki Ito,jp JPN,DF,Stuttgart,22.0,1999.0,26.1,43,31,21,19,3,25,43,58.1,18,40,19,21,53,96,95,0,Matches,2021-2022,Bundesliga
Cedric Itten,ch SUI,FW,Greuther Fürth,24.0,1996.0,7.1,5,2,1,2,2,1,6,16.7,5,3,0,3,2,7,4,0,Matches,2021-2022,Bundesliga
Gian-Luca Itter,de GER,DF,Greuther Fürth,22.0,1999.0,16.2,44,26,30,11,3,21,38,55.3,17,24,9,15,13,57,51,0,Matches,2021-2022,Bundesliga
Lee Jae-sung,kr KOR,"MF,FW",Mainz 05,28.0,1992.0,16.0,30,12,8,14,8,6,27,22.2,21,20,2,18,18,48,18,0,Matches,2021-2022,Bundesliga
Paul Jaeckel,de GER,DF,Union Berlin,23.0,1998.0,22.7,51,29,27,24,0,29,51,56.9,22,34,10,24,57,108,81,0,Matches,2021-2022,Bundesliga
Kristijan Jakić,hr CRO,MF,Eint Frankfurt,24.0,1997.0,20.9,37,22,10,21,6,15,62,24.2,47,33,3,30,21,58,25,1,Matches,2021-2022,Bundesliga
Tony Jantschke,de GER,DF,Gladbach,31.0,1990.0,2.5,6,5,2,4,0,3,6,50.0,3,3,2,1,5,11,8,0,Matches,2021-2022,Bundesliga
Dennis Jastrzembski,pl POL,"DF,FW",Hertha BSC,21.0,2000.0,2.5,2,1,1,1,0,2,8,25.0,6,1,0,1,5,7,3,0,Matches,2021-2022,Bundesliga
Fredrik Jensen,fi FIN,"MF,FW",Augsburg,23.0,1997.0,4.6,5,4,1,3,1,4,7,57.1,3,5,1,4,2,7,4,0,Matches,2021-2022,Bundesliga
Marco John,de GER,DF,Hoffenheim,19.0,2002.0,0.5,0,0,0,0,0,0,1,0.0,1,1,0,1,1,1,1,0,Matches,2021-2022,Bundesliga
Stevan Jovetić,me MNE,"FW,MF",Hertha BSC,31.0,1989.0,11.3,5,2,0,2,3,1,6,16.7,5,3,0,3,1,6,6,0,Matches,2021-2022,Bundesliga
Gideon Jung,de GER,DF,Greuther Fürth,26.0,1994.0,1.6,3,1,1,2,0,2,4,50.0,2,1,1,0,2,5,5,0,Matches,2021-2022,Bundesliga
Anton Kade,de GER,"FW,MF",Hertha BSC,17.0,2004.0,0.9,4,2,3,1,0,2,8,25.0,6,3,0,3,3,7,1,0,Matches,2021-2022,Bundesliga
Pavel Kadeřábek,cz CZE,"DF,MF",Hoffenheim,29.0,1992.0,13.3,11,10,6,3,2,5,16,31.3,11,18,6,12,13,24,22,0,Matches,2021-2022,Bundesliga
Florian Kainz,at AUT,"MF,FW",Köln,28.0,1992.0,25.8,41,26,9,25,7,23,51,45.1,28,27,3,24,32,73,24,0,Matches,2021-2022,Bundesliga
Sasa Kalajdzic,at AUT,FW,Stuttgart,24.0,1997.0,13.6,10,6,2,5,3,3,11,27.3,8,5,0,5,2,12,14,0,Matches,2021-2022,Bundesliga
Daichi Kamada,jp JPN,MF,Eint Frankfurt,24.0,1996.0,23.8,40,21,7,26,7,11,40,27.5,29,18,0,18,8,48,10,0,Matches,2021-2022,Bundesliga
Kevin Kampl,si SVN,MF,RB Leipzig,30.0,1990.0,21.1,41,19,16,20,5,10,42,23.8,32,24,5,19,24,65,17,0,Matches,2021-2022,Bundesliga
Stefanos Kapino,gr GRE,GK,Arminia,27.0,1994.0,1.0,0,0,0,0,0,0,0,,0,0,0,0,0,0,0,0,Matches,2021-2022,Bundesliga
Atakan Karazor,,MF,Stuttgart,24.0,1996.0,21.1,48,24,18,27,3,18,36,50.0,18,37,14,23,34,82,47,0,Matches,2021-2022,Bundesliga
Silas Katompa,cd COD,"FW,MF",Stuttgart,22.0,1998.0,3.1,5,4,4,0,1,3,7,42.9,4,5,0,5,2,7,1,0,Matches,2021-2022,Bundesliga
Noah Katterbach,de GER,DF,Köln,20.0,2001.0,0.2,1,1,1,0,0,1,1,100.0,0,0,0,0,0,1,1,0,Matches,2021-2022,Bundesliga
Yannik Keitel,de GER,MF,Freiburg,21.0,2000.0,5.6,11,4,5,4,2,5,15,33.3,10,7,1,6,1,12,8,0,Matches,2021-2022,Bundesliga
Marc-Oliver Kempf,de GER,DF,Hertha BSC,26.0,1995.0,11.7,10,9,9,1,0,5,14,35.7,9,14,7,7,25,35,49,1,Matches,2021-2022,Bundesliga
Marc-Oliver Kempf,de GER,DF,Stuttgart,26.0,1995.0,9.3,13,8,7,4,2,3,10,30.0,7,16,14,2,16,29,26,2,Matches,2021-2022,Bundesliga
Rani Khedira,de GER,MF,Union Berlin,27.0,1994.0,30.6,75,38,25,42,8,32,66,48.5,34,21,8,13,50,125,27,1,Matches,2021-2022,Bundesliga
Luca Kilian,de GER,FW,Mainz 05,21.0,1999.0,0.0,0,0,0,0,0,0,0,,0,0,0,0,0,0,0,0,Matches,2021-2022,Bundesliga
Luca Kilian,de GER,DF,Köln,21.0,1999.0,25.3,42,24,30,9,3,21,41,51.2,20,31,13,18,46,88,109,3,Matches,2021-2022,Bundesliga
Joshua Kimmich,de GER,MF,Bayern Munich,26.0,1995.0,27.5,39,20,14,17,8,18,58,31.0,40,34,8,26,52,91,29,1,Matches,2021-2022,Bundesliga
Philipp Klement,de GER,MF,Stuttgart,28.0,1992.0,3.8,7,3,1,4,2,3,3,100.0,0,6,1,5,1,8,0,0,Matches,2021-2022,Bundesliga
Mateo Klimowicz,de GER,"MF,FW",Stuttgart,21.0,2000.0,6.7,13,6,6,7,0,5,16,31.3,11,2,0,2,4,17,3,0,Matches,2021-2022,Bundesliga
Fabian Klos,de GER,FW,Arminia,33.0,1987.0,15.8,7,5,0,5,2,2,10,20.0,8,17,4,13,0,7,31,0,Matches,2021-2022,Bundesliga
Lukas Klostermann,de GER,DF,RB Leipzig,25.0,1996.0,18.3,29,16,11,15,3,13,19,68.4,6,16,3,13,26,55,58,0,Matches,2021-2022,Bundesliga
Lukas Klünter,de GER,DF,Hertha BSC,25.0,1996.0,2.2,1,1,1,0,0,1,5,20.0,4,1,0,1,2,3,2,0,Matches,2021-2022,Bundesliga
Ansgar Knauff,de GER,"FW,MF",Dortmund,19.0,2002.0,1.3,3,1,1,1,1,0,4,0.0,4,2,0,2,0,3,4,0,Matches,2021-2022,Bundesliga
Ansgar Knauff,de GER,"DF,MF",Eint Frankfurt,19.0,2002.0,8.4,18,14,8,5,5,8,15,53.3,7,11,1,10,8,26,6,0,Matches,2021-2022,Bundesliga
Robin Knoche,de GER,DF,Union Berlin,29.0,1992.0,33.0,50,24,38,12,0,30,53,56.6,23,45,26,19,49,99,151,1,Matches,2021-2022,Bundesliga
Gregor Kobel,ch SUI,GK,Dortmund,23.0,1997.0,28.5,0,0,0,0,0,0,2,0.0,2,0,0,0,1,1,20,0,Matches,2021-2022,Bundesliga
Dominik Kohr,de GER,MF,Mainz 05,27.0,1994.0,17.9,40,20,18,19,3,16,42,38.1,26,21,2,19,35,75,22,0,Matches,2021-2022,Bundesliga
Manu Koné,fr FRA,MF,Gladbach,20.0,2001.0,24.3,60,37,29,28,3,25,42,59.5,17,27,4,23,34,94,12,0,Matches,2021-2022,Bundesliga
Odilon Kossounou,ci CIV,DF,Leverkusen,20.0,2001.0,19.9,23,17,16,6,1,15,25,60.0,10,36,14,22,26,49,66,0,Matches,2021-2022,Bundesliga
Filip Kostić,rs SRB,"DF,FW",Eint Frankfurt,28.0,1992.0,28.0,44,17,26,9,9,20,53,37.7,33,24,1,23,15,59,24,0,Matches,2021-2022,Bundesliga
Andrej Kramarić,hr CRO,"FW,MF",Hoffenheim,30.0,1991.0,30.1,8,4,1,5,2,7,17,41.2,10,10,0,10,9,17,7,1,Matches,2021-2022,Bundesliga
Christoph Kramer,de GER,MF,Gladbach,30.0,1991.0,8.3,28,11,15,10,3,12,28,42.9,16,18,5,13,12,40,9,0,Matches,2021-2022,Bundesliga
Florian Krüger,de GER,"FW,MF",Arminia,22.0,1999.0,12.5,3,1,0,3,0,2,10,20.0,8,12,1,11,2,5,13,0,Matches,2021-2022,Bundesliga
Max Kruse,de GER,"MF,FW",Wolfsburg,33.0,1988.0,12.5,9,3,4,4,1,5,12,41.7,7,2,0,2,3,12,4,0,Matches,2021-2022,Bundesliga
Max Kruse,de GER,"FW,MF",Union Berlin,33.0,1988.0,14.1,4,1,0,3,1,2,16,12.5,14,12,0,12,3,7,2,0,Matches,2021-2022,Bundesliga
Lukas Kübler,de GER,"DF,MF",Freiburg,28.0,1992.0,25.9,62,35,38,16,8,28,49,57.1,21,24,8,16,44,106,70,0,Matches,2021-2022,Bundesliga
Fabian Kunze,de GER,MF,Arminia,23.0,1998.0,14.0,35,21,14,20,1,15,32,46.9,17,17,2,15,19,54,27,1,Matches,2021-2022,Bundesliga
Maxence Lacroix,fr FRA,DF,Wolfsburg,21.0,2000.0,27.7,59,33,41,16,2,29,40,72.5,11,35,16,19,60,119,144,0,Matches,2021-2022,Bundesliga
Konrad Laimer,at AUT,MF,RB Leipzig,24.0,1997.0,13.8,38,24,11,22,5,24,53,45.3,29,29,3,26,4,42,9,0,Matches,2021-2022,Bundesliga
Stefan Lainer,at AUT,DF,Gladbach,28.0,1992.0,16.3,19,11,9,7,3,12,28,42.9,16,24,5,19,14,33,31,0,Matches,2021-2022,Bundesliga
Vassilis Lambropoulos,gr GRE,DF,Bochum,31.0,1990.0,13.0,18,12,13,3,2,11,25,44.0,14,21,10,11,17,35,56,0,Matches,2021-2022,Bundesliga
Sam Lammers,nl NED,"FW,MF",Eint Frankfurt,24.0,1997.0,5.7,4,4,0,2,2,2,6,33.3,4,9,2,7,2,6,4,0,Matches,2021-2022,Bundesliga
Bryan Lasme,fr FRA,FW,Arminia,22.0,1998.0,9.7,6,6,1,2,3,0,3,0.0,3,7,0,7,1,7,9,0,Matches,2021-2022,Bundesliga
Maxim Leitsch,de GER,DF,Bochum,23.0,1998.0,17.1,18,10,9,7,2,10,15,66.7,5,31,19,12,31,49,74,1,Matches,2021-2022,Bundesliga
Tim Lemperle,de GER,"FW,MF",Köln,19.0,2002.0,1.7,4,1,2,1,1,1,3,33.3,2,1,0,1,2,6,2,0,Matches,2021-2022,Bundesliga
Christopher Lenz,de GER,DF,Eint Frankfurt,26.0,1994.0,7.4,29,15,22,6,1,12,21,57.1,9,9,4,5,7,36,21,0,Matches,2021-2022,Bundesliga
Robert Lewandowski,pl POL,FW,Bayern Munich,32.0,1988.0,32.7,10,3,0,6,4,5,17,29.4,12,17,2,15,6,16,8,0,Matches,2021-2022,Bundesliga
Jamie Leweling,de GER,"FW,MF",Greuther Fürth,20.0,2001.0,21.8,13,8,3,7,3,3,16,18.8,13,9,0,9,13,26,5,0,Matches,2021-2022,Bundesliga
Philipp Lienhart,at AUT,DF,Freiburg,25.0,1996.0,31.9,24,13,17,6,1,13,24,54.2,11,33,23,10,50,74,158,1,Matches,2021-2022,Bundesliga
Andreas Linde,se SWE,GK,Greuther Fürth,28.0,1993.0,12.0,0,0,0,0,0,0,0,,0,0,0,0,1,1,1,1,Matches,2021-2022,Bundesliga
Jesper Lindstrøm,dk DEN,"MF,FW",Eint Frankfurt,21.0,2000.0,22.0,28,13,6,13,9,12,36,33.3,24,30,0,30,24,52,11,1,Matches,2021-2022,Bundesliga
Dejan Ljubicic,at AUT,"MF,FW",Köln,23.0,1997.0,21.9,33,19,12,13,8,13,49,26.5,36,19,1,18,15,48,11,0,Matches,2021-2022,Bundesliga
Jürgen Locadia,cw CUW,"FW,MF",Bochum,27.0,1993.0,4.9,4,2,1,0,3,1,1,100.0,0,1,0,1,1,5,2,0,Matches,2021-2022,Bundesliga
Anthony Losilla,fr FRA,MF,Bochum,35.0,1986.0,32.6,65,39,29,30,6,34,69,49.3,35,32,9,23,70,135,53,1,Matches,2021-2022,Bundesliga
Marcel Lotka,pl POL,GK,Hertha BSC,20.0,2001.0,9.8,1,0,1,0,0,1,1,100.0,0,0,0,0,1,2,3,3,Matches,2021-2022,Bundesliga
Eduard Löwen,de GER,MF,Bochum,24.0,1997.0,15.7,28,22,12,11,5,10,43,23.3,33,17,2,15,9,37,15,1,Matches,2021-2022,Bundesliga
Anderson Lucoqui,ao ANG,DF,Mainz 05,24.0,1997.0,8.3,22,10,11,6,5,11,22,50.0,11,15,3,12,11,33,10,0,Matches,2021-2022,Bundesliga
Dodi Lukebakio,be BEL,FW,Hertha BSC,23.0,1997.0,2.0,2,1,2,0,0,1,3,33.3,2,2,0,2,2,4,0,0,Matches,2021-2022,Bundesliga
Dodi Lukebakio,be BEL,"FW,MF",Wolfsburg,23.0,1997.0,9.8,7,4,3,2,2,1,10,10.0,9,5,0,5,13,20,4,0,Matches,2021-2022,Bundesliga
Andrey Lunyov,ru RUS,GK,Leverkusen,29.0,1991.0,1.0,0,0,0,0,0,0,0,,0,0,0,0,0,0,0,0,Matches,2021-2022,Bundesliga
Andreas Luthe,de GER,GK,Union Berlin,34.0,1987.0,27.0,0,0,0,0,0,0,1,0.0,1,0,0,0,0,0,11,4,Matches,2021-2022,Bundesliga
Matej Maglica,hr CRO,MF,Stuttgart,22.0,1998.0,0.1,0,0,0,0,0,0,1,0.0,1,0,0,0,0,0,0,0,Matches,2021-2022,Bundesliga
Arne Maier,de GER,MF,Augsburg,22.0,1999.0,20.7,20,13,6,10,4,8,26,30.8,18,18,1,17,15,35,13,0,Matches,2021-2022,Bundesliga
Donyell Malen,nl NED,FW,Dortmund,22.0,1999.0,18.7,13,10,4,5,4,7,13,53.8,6,10,0,10,10,23,11,0,Matches,2021-2022,Bundesliga
Lennard Maloney,us USA,DF,Dortmund,21.0,1999.0,0.1,1,0,1,0,0,1,1,100.0,0,0,0,0,0,1,0,0,Matches,2021-2022,Bundesliga
Orel Mangala,be BEL,MF,Stuttgart,23.0,1998.0,20.6,17,10,5,7,5,11,22,50.0,11,11,4,7,12,29,19,1,Matches,2021-2022,Bundesliga
Myziane Maolida,km COM,"FW,MF",Hertha BSC,22.0,1999.0,8.6,7,4,5,1,1,3,9,33.3,6,5,0,5,1,8,6,0,Matches,2021-2022,Bundesliga
Omar Marmoush,eg EGY,FW,Wolfsburg,22.0,1999.0,0.3,0,0,0,0,0,0,0,,0,0,0,0,0,0,0,0,Matches,2021-2022,Bundesliga
Omar Marmoush,eg EGY,FW,Stuttgart,22.0,1999.0,17.5,26,17,6,14,6,4,20,20.0,16,9,1,8,7,33,6,0,Matches,2021-2022,Bundesliga
Aarón Martín,es ESP,DF,Mainz 05,24.0,1997.0,25.5,54,33,32,18,4,24,55,43.6,31,24,4,20,20,74,35,0,Matches,2021-2022,Bundesliga
Josep Martinez,es ESP,GK,RB Leipzig,23.0,1998.0,1.0,0,0,0,0,0,0,0,,0,0,0,0,0,0,0,0,Matches,2021-2022,Bundesliga
Erhan Mašović,rs SRB,DF,Bochum,22.0,1998.0,17.2,35,20,21,13,1,21,33,63.6,12,28,19,9,34,69,64,1,Matches,2021-2022,Bundesliga
Roberto Massimo,de GER,"DF,FW",Stuttgart,20.0,2000.0,9.7,14,5,6,7,1,4,16,25.0,12,9,0,9,3,17,6,0,Matches,2021-2022,Bundesliga
Konstantinos Mavropanos,gr GRE,DF,Stuttgart,23.0,1997.0,30.1,57,39,35,21,1,30,51,58.8,21,46,23,23,69,126,174,2,Matches,2021-2022,Bundesliga
Eric Maxim Choupo-Moting,cm CMR,"FW,MF",Bayern Munich,32.0,1989.0,4.2,10,9,3,6,1,3,10,30.0,7,1,0,1,5,15,2,0,Matches,2021-2022,Bundesliga
Kevin Mbabu,ch SUI,DF,Wolfsburg,26.0,1995.0,15.5,31,20,21,5,5,12,23,52.2,11,25,8,17,35,66,35,0,Matches,2021-2022,Bundesliga
Nathan de Medina,be BEL,DF,Arminia,23.0,1997.0,8.6,17,10,11,6,0,6,10,60.0,4,14,3,11,10,27,28,0,Matches,2021-2022,Bundesliga
Admir Mehmedi,ch SUI,DF,Wolfsburg,30.0,1991.0,0.0,0,0,0,0,0,0,0,,0,0,0,0,0,0,0,0,Matches,2021-2022,Bundesliga
Jorge Meré,es ESP,DF,Köln,24.0,1997.0,5.4,9,6,3,6,0,4,7,57.1,3,6,4,2,10,19,19,0,Matches,2021-2022,Bundesliga
Thomas Meunier,be BEL,DF,Dortmund,29.0,1991.0,15.6,29,19,13,12,4,16,33,48.5,17,10,2,8,12,41,25,1,Matches,2021-2022,Bundesliga
Marco Meyerhöfer,de GER,DF,Greuther Fürth,25.0,1995.0,25.3,53,35,22,22,9,24,37,64.9,13,38,19,19,47,100,64,1,Matches,2021-2022,Bundesliga
Sven Michel,de GER,FW,Union Berlin,31.0,1990.0,3.8,10,6,5,3,2,2,8,25.0,6,3,0,3,1,11,1,0,Matches,2021-2022,Bundesliga
Enzo Millot,fr FRA,MF,Stuttgart,19.0,2002.0,0.6,2,0,0,2,0,0,1,0.0,1,0,0,0,1,3,1,0,Matches,2021-2022,Bundesliga
Maximilian Mittelstädt,de GER,"DF,FW",Hertha BSC,24.0,1997.0,16.6,52,33,30,12,10,26,50,52.0,24,28,5,23,46,98,37,0,Matches,2021-2022,Bundesliga
Anthony Modeste,fr FRA,FW,Köln,33.0,1988.0,29.0,10,6,4,5,1,3,18,16.7,15,11,2,9,4,14,29,0,Matches,2021-2022,Bundesliga
Kevin Möhwald,de GER,MF,Union Berlin,28.0,1993.0,3.9,7,1,3,3,1,1,7,14.3,6,3,0,3,3,10,6,0,Matches,2021-2022,Bundesliga
Clinton Mola,eng ENG,DF,Stuttgart,20.0,2001.0,1.3,3,1,2,1,0,2,4,50.0,2,5,5,0,3,6,2,0,Matches,2021-2022,Bundesliga
Jan Morávek,cz CZE,MF,Augsburg,31.0,1989.0,5.2,11,6,3,7,1,6,18,33.3,12,11,2,9,6,17,8,0,Matches,2021-2022,Bundesliga
Ilaix Moriba,gn GUI,MF,RB Leipzig,18.0,2003.0,0.4,0,0,0,0,0,0,4,0.0,4,2,0,2,1,1,0,0,Matches,2021-2022,Bundesliga
Youssoufa Moukoko,de GER,"FW,MF",Dortmund,16.0,2004.0,2.5,1,0,0,1,0,0,1,0.0,1,5,0,5,3,4,0,0,Matches,2021-2022,Bundesliga
Nordi Mukiele,fr FRA,"DF,FW",RB Leipzig,23.0,1997.0,20.5,35,22,23,9,3,14,27,51.9,13,31,5,26,31,66,44,2,Matches,2021-2022,Bundesliga
Florian Müller,de GER,GK,Stuttgart,23.0,1997.0,30.0,0,0,0,0,0,0,1,0.0,1,1,0,1,0,0,13,2,Matches,2021-2022,Bundesliga
Thomas Müller,de GER,MF,Bayern Munich,31.0,1989.0,28.4,35,20,7,16,12,16,54,29.6,38,32,1,31,15,50,12,0,Matches,2021-2022,Bundesliga
Torben Müsel,de GER,MF,Gladbach,22.0,1999.0,0.1,0,0,0,0,0,0,0,,0,0,0,0,0,0,0,0,Matches,2021-2022,Bundesliga
Jamal Musiala,de GER,"MF,FW",Bayern Munich,18.0,2003.0,16.3,40,26,11,16,13,15,36,41.7,21,25,0,25,19,59,2,1,Matches,2021-2022,Bundesliga
Obite N'Dicka,ci CIV,DF,Eint Frankfurt,21.0,1999.0,31.7,60,34,29,27,4,44,59,74.6,15,46,20,26,48,108,137,0,Matches,2021-2022,Bundesliga
Nikolas Nartey,dk DEN,"MF,DF",Stuttgart,21.0,2000.0,4.5,6,3,0,5,1,3,9,33.3,6,4,2,2,7,13,5,0,Matches,2021-2022,Bundesliga
Paul Nebel,de GER,"MF,FW",Mainz 05,18.0,2002.0,2.5,5,3,3,1,1,2,3,66.7,1,0,0,0,0,5,1,0,Matches,2021-2022,Bundesliga
David Nemeth,at AUT,DF,Mainz 05,20.0,2001.0,3.5,3,2,2,1,0,1,3,33.3,2,5,1,4,6,9,11,1,Matches,2021-2022,Bundesliga
Luca Netz,de GER,"DF,FW",Gladbach,18.0,2003.0,15.5,24,11,12,10,2,11,40,27.5,29,24,4,20,13,37,33,1,Matches,2021-2022,Bundesliga
Manuel Neuer,de GER,GK,Bayern Munich,35.0,1986.0,27.9,2,1,2,0,0,1,2,50.0,1,0,0,0,0,2,7,1,Matches,2021-2022,Bundesliga
Florian Neuhaus,de GER,MF,Gladbach,24.0,1997.0,23.6,55,28,24,26,5,27,64,42.2,37,38,6,32,31,86,19,4,Matches,2021-2022,Bundesliga
Jessic Ngankam,de GER,FW,Greuther Fürth,21.0,2000.0,3.8,3,1,1,1,1,1,2,50.0,1,3,0,3,0,3,1,0,Matches,2021-2022,Bundesliga
Moussa Niakhate,sn SEN,DF,Mainz 05,25.0,1996.0,28.5,40,23,25,13,2,20,33,60.6,13,37,11,26,50,90,69,1,Matches,2021-2022,Bundesliga
Tanguy Nianzou,fr FRA,DF,Bayern Munich,19.0,2002.0,6.5,11,7,7,3,1,7,11,63.6,4,7,2,5,7,18,17,0,Matches,2021-2022,Bundesliga
Florian Niederlechner,de GER,FW,Augsburg,30.0,1990.0,12.9,6,5,1,3,2,4,13,30.8,9,9,0,9,4,10,7,0,Matches,2021-2022,Bundesliga
Håvard Nielsen,no NOR,"MF,FW",Greuther Fürth,28.0,1993.0,15.2,17,12,5,11,1,8,21,38.1,13,18,1,17,7,24,22,0,Matches,2021-2022,Bundesliga
Joakim Nilsson,se SWE,DF,Arminia,27.0,1994.0,30.4,37,19,24,13,0,20,26,76.9,6,36,23,13,56,93,143,1,Matches,2021-2022,Bundesliga
Christopher Nkunku,fr FRA,"FW,MF",RB Leipzig,23.0,1997.0,30.3,23,10,10,11,2,9,35,25.7,26,23,2,21,15,38,15,0,Matches,2021-2022,Bundesliga
Felix Nmecha,de GER,"MF,FW",Wolfsburg,20.0,2000.0,3.6,3,1,1,1,1,0,2,0.0,2,2,0,2,7,10,6,0,Matches,2021-2022,Bundesliga
Lukas Nmecha,de GER,"FW,MF",Wolfsburg,22.0,1998.0,18.1,12,5,5,5,2,5,19,26.3,14,9,1,8,4,16,10,0,Matches,2021-2022,Bundesliga
Håvard Nordtveit,no NOR,DF,Hoffenheim,31.0,1990.0,3.4,7,6,2,4,1,4,4,100.0,0,2,1,1,10,17,11,0,Matches,2021-2022,Bundesliga
Connor Noß,ie IRL,MF,Gladbach,20.0,2001.0,0.6,1,0,0,1,0,0,1,0.0,1,1,1,0,0,1,0,0,Matches,2021-2022,Bundesliga
Hugo Novoa,es ESP,"MF,FW",RB Leipzig,18.0,2003.0,1.5,4,4,2,0,2,2,7,28.6,5,2,0,2,1,5,0,0,Matches,2021-2022,Bundesliga
Soma Novothny,hu HUN,"FW,MF",Bochum,27.0,1994.0,0.9,1,1,1,0,0,0,1,0.0,1,1,0,1,0,1,2,0,Matches,2021-2022,Bundesliga
Kasim Nuhu,gh GHA,DF,Hoffenheim,26.0,1995.0,0.1,0,0,0,0,0,0,1,0.0,1,0,0,0,0,0,1,0,Matches,2021-2022,Bundesliga
Hans Nunoo Sarpei,gh GHA,"DF,MF",Greuther Fürth,22.0,1998.0,7.1,16,11,9,7,0,10,14,71.4,4,8,5,3,14,30,21,0,Matches,2021-2022,Bundesliga
Bastian Oczipka,de GER,DF,Union Berlin,32.0,1989.0,10.4,24,15,15,7,2,10,13,76.9,3,10,2,8,12,36,21,0,Matches,2021-2022,Bundesliga
Masaya Okugawa,jp JPN,"MF,FW",Arminia,25.0,1996.0,28.1,46,25,18,22,6,12,37,32.4,25,29,1,28,20,66,13,0,Matches,2021-2022,Bundesliga
Mathias Olesen,lu LUX,"MF,FW",Köln,20.0,2001.0,0.2,0,0,0,0,0,0,0,,0,0,0,0,1,1,0,0,Matches,2021-2022,Bundesliga
Dani Olmo,es ESP,"MF,FW",RB Leipzig,23.0,1998.0,8.3,14,6,5,7,2,5,18,27.8,13,5,1,4,4,18,1,0,Matches,2021-2022,Bundesliga
Karim Onisiwo,at AUT,FW,Mainz 05,29.0,1992.0,26.2,18,10,4,6,8,7,22,31.8,15,27,2,25,7,25,8,0,Matches,2021-2022,Bundesliga
Willi Orban,hu HUN,DF,RB Leipzig,28.0,1992.0,29.4,32,22,20,11,1,13,25,52.0,12,40,24,16,44,76,123,2,Matches,2021-2022,Bundesliga
Stefan Ortega,de GER,GK,Arminia,28.0,1992.0,33.0,1,0,1,0,0,1,2,50.0,1,2,0,2,0,1,5,1,Matches,2021-2022,Bundesliga
Patrick Osterhage,de GER,MF,Bochum,21.0,2000.0,6.7,9,6,3,5,1,3,7,42.9,4,7,1,6,11,20,8,0,Matches,2021-2022,Bundesliga
Tomáš Ostrák,cz CZE,"MF,FW",Köln,21.0,2000.0,0.3,1,0,0,0,1,1,3,33.3,2,0,0,0,1,2,0,0,Matches,2021-2022,Bundesliga
Paulo Otávio,br BRA,"DF,MF",Wolfsburg,26.0,1994.0,4.0,14,10,7,4,3,8,15,53.3,7,11,6,5,4,18,9,0,Matches,2021-2022,Bundesliga
Reece Oxford,eng ENG,DF,Augsburg,22.0,1998.0,29.9,27,14,16,9,2,15,31,48.4,16,42,33,9,72,99,172,1,Matches,2021-2022,Bundesliga
Salih Özcan,tr TUR,MF,Köln,23.0,1998.0,25.7,42,30,14,23,5,22,51,43.1,29,37,5,32,51,93,35,1,Matches,2021-2022,Bundesliga
Levin Öztunalı,de GER,MF,Union Berlin,25.0,1996.0,6.4,14,11,6,5,3,7,17,41.2,10,3,0,3,4,18,12,0,Matches,2021-2022,Bundesliga
Gonçalo Paciência,pt POR,FW,Eint Frankfurt,26.0,1994.0,5.7,4,2,2,1,1,1,3,33.3,2,2,0,2,1,5,4,0,Matches,2021-2022,Bundesliga
Exequiel Palacios,ar ARG,MF,Leverkusen,22.0,1998.0,12.2,30,19,12,14,4,15,38,39.5,23,20,1,19,28,58,11,2,Matches,2021-2022,Bundesliga
Miloš Pantović,rs SRB,"MF,FW",Bochum,25.0,1996.0,17.0,19,10,8,7,4,6,25,24.0,19,26,4,22,18,37,14,0,Matches,2021-2022,Bundesliga
Antonios Papadopoulos,de GER,"DF,MF",Dortmund,21.0,1999.0,0.2,0,0,0,0,0,0,0,,0,1,0,1,0,0,0,0,Matches,2021-2022,Bundesliga
Merveille Papela,de GER,MF,Mainz 05,20.0,2001.0,0.9,3,2,2,1,0,2,3,66.7,1,2,0,2,2,5,0,0,Matches,2021-2022,Bundesliga
Kevin Paredes,us USA,"FW,DF",Wolfsburg,18.0,2003.0,0.2,1,0,0,0,1,0,0,,0,1,0,1,0,1,0,0,Matches,2021-2022,Bundesliga
Felix Passlack,de GER,DF,Dortmund,23.0,1998.0,5.2,13,9,8,4,1,6,12,50.0,6,5,1,4,4,17,7,0,Matches,2021-2022,Bundesliga
Paulinho,br BRA,"FW,MF",Leverkusen,21.0,2000.0,13.5,22,13,6,13,3,13,27,48.1,14,14,1,13,6,28,7,0,Matches,2021-2022,Bundesliga
Benjamin Pavard,fr FRA,DF,Bayern Munich,25.0,1996.0,23.1,35,20,21,13,1,19,29,65.5,10,28,16,12,36,71,50,1,Matches,2021-2022,Bundesliga
Mads Pedersen,dk DEN,"MF,DF",Augsburg,24.0,1996.0,15.5,28,21,8,15,5,12,27,44.4,15,13,4,9,15,43,30,0,Matches,2021-2022,Bundesliga
Peter Pekarík,sk SVK,DF,Hertha BSC,34.0,1986.0,24.8,45,29,33,11,1,32,46,69.6,14,28,10,18,29,74,58,0,Matches,2021-2022,Bundesliga
Philipp Pentke,de GER,GK,Hoffenheim,36.0,1985.0,1.0,0,0,0,0,0,0,0,,0,0,0,0,0,0,0,0,Matches,2021-2022,Bundesliga
Ricardo Pepi,us USA,"FW,MF",Augsburg,18.0,2003.0,5.3,4,2,1,3,0,1,8,12.5,7,7,0,7,3,7,8,0,Matches,2021-2022,Bundesliga
Pavao Pervan,at AUT,GK,Wolfsburg,33.0,1987.0,6.0,0,0,0,0,0,0,0,,0,0,0,0,0,0,3,0,Matches,2021-2022,Bundesliga
Nils Petersen,de GER,FW,Freiburg,32.0,1988.0,6.4,5,3,2,3,0,1,13,7.7,12,7,0,7,2,7,17,0,Matches,2021-2022,Bundesliga
Jens Petter Hauge,no NOR,"MF,FW",Eint Frankfurt,21.0,1999.0,11.6,14,5,6,7,1,7,23,30.4,16,7,0,7,3,17,5,0,Matches,2021-2022,Bundesliga
Immanuel Pherai,sr SUR,MF,Dortmund,20.0,2001.0,0.0,0,0,0,0,0,0,0,,0,0,0,0,0,0,0,0,Matches,2021-2022,Bundesliga
Maximilian Philipp,de GER,MF,Wolfsburg,27.0,1994.0,10.7,15,11,6,7,2,5,21,23.8,16,12,1,11,4,19,5,0,Matches,2021-2022,Bundesliga
Krzysztof Piątek,pl POL,FW,Hertha BSC,26.0,1995.0,3.9,2,2,0,1,1,0,1,0.0,1,0,0,0,0,2,6,0,Matches,2021-2022,Bundesliga
Amos Pieper,de GER,DF,Arminia,23.0,1998.0,26.4,58,29,38,19,1,32,51,62.7,19,37,23,14,50,108,132,1,Matches,2021-2022,Bundesliga
Marvin Plattenhardt,de GER,DF,Hertha BSC,29.0,1992.0,18.2,25,11,18,6,1,15,27,55.6,12,18,3,15,17,42,52,0,Matches,2021-2022,Bundesliga
Alassane Pléa,fr FRA,"MF,FW",Gladbach,28.0,1993.0,23.0,18,14,6,9,3,7,20,35.0,13,9,1,8,4,22,9,0,Matches,2021-2022,Bundesliga
Joel Pohjanpalo,fi FIN,FW,Leverkusen,26.0,1994.0,0.1,0,0,0,0,0,0,0,,0,0,0,0,0,0,0,0,Matches,2021-2022,Bundesliga
Sebastian Polter,de GER,FW,Bochum,30.0,1991.0,26.0,9,3,1,4,4,2,11,18.2,9,15,5,10,2,11,24,0,Matches,2021-2022,Bundesliga
Marin Pongračić,hr CRO,DF,Dortmund,23.0,1997.0,9.2,17,10,13,4,0,6,10,60.0,4,11,5,6,17,34,32,2,Matches,2021-2022,Bundesliga
Stefan Posch,at AUT,DF,Hoffenheim,24.0,1997.0,24.4,48,30,20,26,2,22,39,56.4,17,43,18,25,28,76,71,2,Matches,2021-2022,Bundesliga
Yussuf Poulsen,dk DEN,"FW,MF",RB Leipzig,27.0,1994.0,12.0,13,4,3,6,4,3,13,23.1,10,13,0,13,3,16,9,0,Matches,2021-2022,Bundesliga
Manuel Prietl,at AUT,MF,Arminia,29.0,1991.0,23.6,59,26,23,31,5,23,60,38.3,37,28,3,25,39,98,33,0,Matches,2021-2022,Bundesliga
Grischa Prömel,de GER,MF,Union Berlin,26.0,1995.0,26.9,36,22,14,17,5,22,52,42.3,30,18,3,15,23,59,22,0,Matches,2021-2022,Bundesliga
Nick Proschwitz,de GER,FW,Hoffenheim,34.0,1986.0,0.3,0,0,0,0,0,0,0,,0,0,0,0,0,0,0,0,Matches,2021-2022,Bundesliga
Afimico Pululu,ao ANG,"FW,MF",Greuther Fürth,22.0,1999.0,0.8,1,0,1,0,0,1,2,50.0,1,1,0,1,0,1,0,0,Matches,2021-2022,Bundesliga
Sidney Raebiger,de GER,MF,RB Leipzig,16.0,2005.0,0.0,0,0,0,0,0,0,0,,0,0,0,0,0,0,0,0,Matches,2021-2022,Bundesliga
Diant Ramaj,de GER,GK,Eint Frankfurt,19.0,2001.0,1.0,0,0,0,0,0,0,0,,0,0,0,0,0,0,3,0,Matches,2021-2022,Bundesliga
Guilherme Ramos,pt POR,DF,Arminia,23.0,1997.0,10.1,25,15,17,8,0,12,19,63.2,7,21,8,13,27,52,52,0,Matches,2021-2022,Bundesliga
Tobias Raschl,de GER,MF,Greuther Fürth,21.0,2000.0,6.6,12,9,4,8,0,5,7,71.4,2,10,1,9,3,15,1,0,Matches,2021-2022,Bundesliga
David Raum,de GER,"DF,FW",Hoffenheim,23.0,1998.0,30.6,52,29,30,10,12,30,64,46.9,34,38,5,33,27,79,39,1,Matches,2021-2022,Bundesliga
Reinier,br BRA,"FW,MF",Dortmund,19.0,2002.0,1.8,5,3,4,0,1,1,1,100.0,0,3,0,3,0,5,0,0,Matches,2021-2022,Bundesliga
Panagiotis Retsos,gr GRE,"DF,FW",Leverkusen,22.0,1998.0,0.4,0,0,0,0,0,0,0,,0,0,0,0,1,1,0,1,Matches,2021-2022,Bundesliga
Marco Reus,de GER,"MF,FW",Dortmund,32.0,1989.0,27.8,45,30,13,21,11,16,42,38.1,26,23,6,17,12,57,41,1,Matches,2021-2022,Bundesliga
Elvis Rexhbeçaj,xk KVX,MF,Bochum,23.0,1997.0,28.2,41,20,17,19,5,19,40,47.5,21,41,6,35,27,68,15,0,Matches,2021-2022,Bundesliga
Gio Reyna,us USA,MF,Dortmund,18.0,2002.0,4.9,7,4,2,4,1,3,9,33.3,6,6,0,6,1,8,3,0,Matches,2021-2022,Bundesliga
Chris Richards,us USA,DF,Hoffenheim,21.0,2000.0,14.5,26,15,10,15,1,11,18,61.1,7,21,9,12,22,48,50,1,Matches,2021-2022,Bundesliga
Chris Richards,us USA,DF,Bayern Munich,21.0,2000.0,0.0,0,0,0,0,0,0,0,,0,1,0,1,0,0,0,0,Matches,2021-2022,Bundesliga
Omar Richards,eng ENG,DF,Bayern Munich,23.0,1998.0,4.9,19,12,11,5,3,11,16,68.8,5,7,1,6,4,23,7,0,Matches,2021-2022,Bundesliga
Marco Richter,de GER,"FW,MF",Hertha BSC,23.0,1997.0,18.9,30,16,14,10,6,13,36,36.1,23,30,4,26,16,46,24,0,Matches,2021-2022,Bundesliga
Manuel Riemann,de GER,GK,Bochum,32.0,1988.0,31.0,1,0,1,0,0,1,4,25.0,3,0,0,0,1,2,12,3,Matches,2021-2022,Bundesliga
Marc Roca,es ESP,MF,Bayern Munich,24.0,1996.0,4.2,9,7,2,4,3,2,8,25.0,6,6,0,6,6,15,4,0,Matches,2021-2022,Bundesliga
Cimo Röcker,de GER,DF,Hertha BSC,27.0,1994.0,0.2,0,0,0,0,0,0,0,,0,0,0,0,2,2,0,0,Matches,2021-2022,Bundesliga
Sebastian Rode,de GER,MF,Eint Frankfurt,30.0,1990.0,8.4,15,7,5,8,2,5,17,29.4,12,11,1,10,13,28,8,0,Matches,2021-2022,Bundesliga
Romario Rösch,de GER,MF,Mainz 05,22.0,1999.0,0.0,0,0,0,0,0,0,0,,0,0,0,0,0,0,0,0,Matches,2021-2022,Bundesliga
Tom Rothe,de GER,DF,Dortmund,16.0,2004.0,1.0,4,3,2,2,0,3,6,50.0,3,2,0,2,2,6,3,0,Matches,2021-2022,Bundesliga
Jérôme Roussillon,fr FRA,DF,Wolfsburg,28.0,1993.0,19.7,14,9,8,6,0,10,16,62.5,6,24,5,19,14,28,34,2,Matches,2021-2022,Bundesliga
Sebastian Rudy,de GER,MF,Hoffenheim,31.0,1990.0,8.6,22,12,9,13,0,11,21,52.4,10,8,3,5,11,33,8,1,Matches,2021-2022,Bundesliga
Georginio Rutter,fr FRA,"FW,MF",Hoffenheim,19.0,2002.0,17.9,18,13,4,8,6,6,17,35.3,11,29,1,28,6,24,11,1,Matches,2021-2022,Bundesliga
Julian Ryerson,no NOR,DF,Union Berlin,23.0,1997.0,15.9,27,15,11,12,4,17,25,68.0,8,12,4,8,16,43,32,0,Matches,2021-2022,Bundesliga
Frederik Rønnow,dk DEN,GK,Union Berlin,28.0,1992.0,7.0,0,0,0,0,0,0,0,,0,0,0,0,0,0,1,0,Matches,2021-2022,Bundesliga
Marcel Sabitzer,at AUT,"MF,FW",RB Leipzig,27.0,1994.0,0.5,2,1,1,1,0,1,1,100.0,0,0,0,0,1,3,0,0,Matches,2021-2022,Bundesliga
Marcel Sabitzer,at AUT,"MF,DF",Bayern Munich,27.0,1994.0,10.1,18,7,8,8,2,9,19,47.4,10,7,0,7,9,27,10,1,Matches,2021-2022,Bundesliga
Roland Sallai,hu HUN,"MF,FW",Freiburg,24.0,1997.0,17.2,22,16,8,11,3,7,23,30.4,16,12,0,12,11,33,12,0,Matches,2021-2022,Bundesliga
Diadie Samassékou,ml MLI,MF,Hoffenheim,25.0,1996.0,18.4,41,26,14,21,6,21,44,47.7,23,27,11,16,28,69,26,0,Matches,2021-2022,Bundesliga
Leroy Sané,de GER,"FW,MF",Bayern Munich,25.0,1996.0,22.0,28,16,5,19,4,9,24,37.5,15,18,0,18,12,40,2,1,Matches,2021-2022,Bundesliga
Mohamed Sankoh,nl NED,FW,Stuttgart,17.0,2003.0,0.0,0,0,0,0,0,0,0,,0,0,0,0,0,0,0,0,Matches,2021-2022,Bundesliga
Baptiste Santamaria,fr FRA,MF,Freiburg,26.0,1995.0,0.2,0,0,0,0,0,0,1,0.0,1,0,0,0,1,1,1,0,Matches,2021-2022,Bundesliga
Bouna Sarr,sn SEN,DF,Bayern Munich,29.0,1992.0,0.7,4,4,2,1,1,4,5,80.0,1,2,1,1,6,10,1,0,Matches,2021-2022,Bundesliga
Joe Scally,us USA,DF,Gladbach,18.0,2002.0,21.2,40,30,21,14,5,17,41,41.5,24,27,4,23,22,62,38,0,Matches,2021-2022,Bundesliga
Kevin Schade,de GER,"MF,FW",Freiburg,19.0,2001.0,9.2,9,7,6,2,1,3,10,30.0,7,15,3,12,3,12,16,0,Matches,2021-2022,Bundesliga
András Schäfer,hu HUN,MF,Union Berlin,22.0,1999.0,2.7,4,1,3,1,0,0,5,0.0,5,7,1,6,2,6,4,0,Matches,2021-2022,Bundesliga
Louis Schaub,at AUT,"MF,FW",Köln,26.0,1994.0,7.3,16,10,7,7,2,11,20,55.0,9,17,3,14,3,19,3,0,Matches,2021-2022,Bundesliga
Patrik Schick,cz CZE,FW,Leverkusen,25.0,1996.0,23.1,5,2,2,2,1,1,9,11.1,8,6,1,5,3,8,28,0,Matches,2021-2022,Bundesliga
Kingsley Schindler,gh GHA,"DF,FW",Köln,28.0,1993.0,3.9,1,0,0,0,1,1,5,20.0,4,5,1,4,5,6,5,0,Matches,2021-2022,Bundesliga
Xaver Schlager,at AUT,MF,Wolfsburg,23.0,1997.0,11.6,43,20,20,20,3,20,49,40.8,29,25,2,23,9,52,14,0,Matches,2021-2022,Bundesliga
Keven Schlotterbeck,de GER,"DF,FW",Freiburg,24.0,1997.0,3.5,11,5,6,5,0,5,6,83.3,1,7,4,3,11,22,24,1,Matches,2021-2022,Bundesliga
Nico Schlotterbeck,de GER,DF,Freiburg,21.0,1999.0,30.9,72,43,36,34,2,33,48,68.8,15,41,32,9,56,128,154,1,Matches,2021-2022,Bundesliga
Jonathan Schmid,fr FRA,DF,Freiburg,31.0,1990.0,6.5,12,6,6,3,3,5,7,71.4,2,7,1,6,6,18,15,0,Matches,2021-2022,Bundesliga
Benno Schmitz,de GER,DF,Köln,26.0,1994.0,26.9,57,37,21,27,9,42,86,48.8,44,44,8,36,39,96,39,0,Matches,2021-2022,Bundesliga
Alessandro Schöpf,at AUT,MF,Arminia,27.0,1994.0,26.6,40,22,19,16,5,14,30,46.7,16,31,5,26,30,70,21,1,Matches,2021-2022,Bundesliga
Nico Schulz,de GER,DF,Dortmund,28.0,1993.0,9.3,21,12,9,7,5,9,21,42.9,12,8,1,7,11,32,8,0,Matches,2021-2022,Bundesliga
Marvin Schwäbe,de GER,GK,Köln,26.0,1995.0,21.0,0,0,0,0,0,0,0,,0,0,0,0,0,0,8,1,Matches,2021-2022,Bundesliga
Alexander Schwolow,de GER,GK,Hertha BSC,29.0,1992.0,24.2,0,0,0,0,0,0,1,0.0,1,0,0,0,2,2,18,3,Matches,2021-2022,Bundesliga
Paul Seguin,de GER,MF,Greuther Fürth,26.0,1995.0,23.4,50,31,15,32,3,26,56,46.4,30,27,3,24,19,69,30,1,Matches,2021-2022,Bundesliga
Davie Selke,de GER,FW,Hertha BSC,26.0,1995.0,11.2,5,4,1,3,1,1,3,33.3,2,6,1,5,1,6,11,0,Matches,2021-2022,Bundesliga
Lion Semić,de GER,DF,Dortmund,17.0,2003.0,0.0,0,0,0,0,0,0,0,,0,0,0,0,0,0,0,0,Matches,2021-2022,Bundesliga
Suat Serdar,de GER,"MF,FW",Hertha BSC,24.0,1997.0,24.6,64,30,24,29,11,25,55,45.5,30,32,3,29,20,84,14,0,Matches,2021-2022,Bundesliga
Janni Serra,de GER,FW,Arminia,23.0,1998.0,12.4,4,2,2,0,2,2,7,28.6,5,8,3,5,5,9,19,0,Matches,2021-2022,Bundesliga
Zidan Sertdemir,dk DEN,"MF,FW",Leverkusen,16.0,2005.0,0.2,2,2,2,0,0,0,0,,0,0,0,0,0,2,0,0,Matches,2021-2022,Bundesliga
Nils Seufert,de GER,MF,Greuther Fürth,24.0,1997.0,1.1,3,2,1,1,1,0,1,0.0,1,0,0,0,0,3,0,0,Matches,2021-2022,Bundesliga
Kiliann Sildillia,fr FRA,"DF,MF",Freiburg,19.0,2002.0,1.9,7,3,3,4,0,3,6,50.0,3,1,0,1,2,9,7,1,Matches,2021-2022,Bundesliga
André Silva,pt POR,FW,RB Leipzig,25.0,1995.0,23.1,13,9,2,3,8,4,13,30.8,9,20,2,18,2,15,15,0,Matches,2021-2022,Bundesliga
Mohamed Simakan,fr FRA,DF,RB Leipzig,21.0,2000.0,22.3,48,27,25,21,2,27,41,65.9,14,22,11,11,40,88,46,1,Matches,2021-2022,Bundesliga
Daley Sinkgraven,nl NED,DF,Leverkusen,26.0,1995.0,3.9,6,2,4,0,2,3,7,42.9,4,3,1,2,3,9,6,0,Matches,2021-2022,Bundesliga
Tobias Sippel,de GER,GK,Gladbach,33.0,1988.0,1.0,0,0,0,0,0,0,0,,0,0,0,0,0,0,0,0,Matches,2021-2022,Bundesliga
Hugo Siquet,be BEL,DF,Freiburg,19.0,2002.0,0.2,0,0,0,0,0,0,0,,0,0,0,0,0,0,0,0,Matches,2021-2022,Bundesliga
Ellyes Skhiri,tn TUN,MF,Köln,26.0,1995.0,20.2,55,33,25,26,4,22,41,53.7,19,41,7,34,37,92,35,1,Matches,2021-2022,Bundesliga
Robert Skov,dk DEN,"FW,DF",Hoffenheim,25.0,1996.0,4.1,3,2,1,1,1,2,9,22.2,7,2,0,2,3,6,3,0,Matches,2021-2022,Bundesliga
Danilo Soares,br BRA,DF,Bochum,29.0,1991.0,28.5,109,71,61,39,9,56,84,66.7,28,63,9,54,62,171,65,2,Matches,2021-2022,Bundesliga
Yann Sommer,ch SUI,GK,Gladbach,32.0,1988.0,33.0,0,0,0,0,0,0,2,0.0,2,0,0,0,3,3,8,3,Matches,2021-2022,Bundesliga
Borna Sosa,hr CRO,"DF,FW",Stuttgart,23.0,1998.0,27.8,22,12,14,5,3,12,26,46.2,14,30,3,27,26,48,61,0,Matches,2021-2022,Bundesliga
Djibril Sow,ch SUI,MF,Eint Frankfurt,24.0,1997.0,26.8,57,33,28,25,4,22,60,36.7,38,35,8,27,50,107,20,1,Matches,2021-2022,Bundesliga
Jerry St. Juste,nl NED,DF,Mainz 05,24.0,1996.0,6.7,13,9,7,6,0,7,8,87.5,1,7,3,4,14,27,14,0,Matches,2021-2022,Bundesliga
Anton Stach,de GER,MF,Mainz 05,22.0,1998.0,20.7,28,19,14,13,1,15,38,39.5,23,24,5,19,51,79,25,0,Matches,2021-2022,Bundesliga
Kostas Stafylidis,gr GRE,"DF,MF",Bochum,27.0,1993.0,15.4,37,27,22,13,2,20,26,76.9,6,19,6,13,31,68,43,0,Matches,2021-2022,Bundesliga
Josip Stanišić,hr CRO,DF,Bayern Munich,21.0,2000.0,7.2,21,10,7,12,2,12,18,66.7,6,7,0,7,11,32,10,2,Matches,2021-2022,Bundesliga
Niklas Stark,de GER,DF,Hertha BSC,26.0,1995.0,22.6,28,16,18,10,0,12,17,70.6,5,27,17,10,36,64,122,2,Matches,2021-2022,Bundesliga
Renato Steffen,ch SUI,"FW,MF",Wolfsburg,29.0,1991.0,10.7,20,16,10,10,0,9,16,56.3,7,7,0,7,13,33,14,0,Matches,2021-2022,Bundesliga
Pascal Stenzel,de GER,DF,Stuttgart,25.0,1996.0,10.0,24,11,15,5,4,17,33,51.5,16,13,3,10,11,35,25,0,Matches,2021-2022,Bundesliga
Angelo Stiller,de GER,MF,Hoffenheim,20.0,2001.0,18.8,30,17,11,15,4,9,23,39.1,14,32,6,26,9,39,16,2,Matches,2021-2022,Bundesliga
Lars Stindl,de GER,"MF,FW",Gladbach,32.0,1988.0,18.1,23,15,6,14,3,9,33,27.3,24,28,2,26,10,33,14,0,Matches,2021-2022,Bundesliga
Kevin Stöger,at AUT,MF,Mainz 05,27.0,1993.0,4.7,10,5,5,5,0,4,10,40.0,6,6,0,6,5,15,1,1,Matches,2021-2022,Bundesliga
Tobias Strobl,de GER,"MF,DF",Augsburg,31.0,1990.0,3.6,8,3,3,5,0,3,11,27.3,8,7,2,5,7,15,3,0,Matches,2021-2022,Bundesliga
Niklas Süle,de GER,DF,Bayern Munich,25.0,1995.0,20.4,29,23,21,7,1,18,24,75.0,6,16,12,4,28,57,49,0,Matches,2021-2022,Bundesliga
Ádám Szalai,hu HUN,FW,Mainz 05,33.0,1987.0,2.9,3,2,0,2,1,0,2,0.0,2,2,0,2,0,3,0,0,Matches,2021-2022,Bundesliga
Dominik Szoboszlai,hu HUN,"MF,FW",RB Leipzig,20.0,2000.0,17.1,17,12,5,9,3,8,27,29.6,19,30,3,27,10,27,15,0,Matches,2021-2022,Bundesliga
Jonathan Tah,de GER,DF,Leverkusen,25.0,1996.0,32.0,25,18,19,5,1,17,33,51.5,16,31,20,11,43,68,156,0,Matches,2021-2022,Bundesliga
Edmond Tapsoba,bf BFA,DF,Leverkusen,22.0,1999.0,20.2,35,17,24,10,1,20,32,62.5,12,27,15,12,29,64,72,1,Matches,2021-2022,Bundesliga
Niklas Tauer,de GER,"DF,MF",Mainz 05,20.0,2001.0,5.4,16,9,9,7,0,9,14,64.3,5,6,2,4,9,25,14,0,Matches,2021-2022,Bundesliga
Robert Tesche,de GER,MF,Bochum,34.0,1987.0,3.9,6,4,4,1,1,5,7,71.4,2,6,2,4,5,11,5,1,Matches,2021-2022,Bundesliga
Cedric Teuchert,de GER,"MF,FW",Union Berlin,24.0,1997.0,1.2,3,2,3,0,0,2,6,33.3,4,1,0,1,0,3,0,0,Matches,2021-2022,Bundesliga
Jan Thielmann,de GER,"MF,FW",Köln,19.0,2002.0,13.2,24,16,6,12,6,8,23,34.8,15,23,2,21,10,34,11,0,Matches,2021-2022,Bundesliga
Erik Thommy,de GER,"FW,MF",Stuttgart,26.0,1994.0,3.0,2,0,0,2,0,1,2,50.0,1,3,0,3,4,6,0,0,Matches,2021-2022,Bundesliga
Marcus Thuram,fr FRA,FW,Gladbach,23.0,1997.0,10.9,6,5,0,5,1,1,4,25.0,3,5,0,5,5,11,5,0,Matches,2021-2022,Bundesliga
Alexis Tibidi,fr FRA,"MF,FW",Stuttgart,17.0,2003.0,4.3,7,3,1,3,3,3,4,75.0,1,4,0,4,3,10,2,0,Matches,2021-2022,Bundesliga
Steffen Tigges,de GER,"FW,MF",Dortmund,23.0,1998.0,1.2,4,3,1,2,1,2,3,66.7,1,3,1,2,0,4,3,0,Matches,2021-2022,Bundesliga
Malik Tillman,us USA,"FW,MF",Bayern Munich,19.0,2002.0,1.2,2,1,0,1,1,0,1,0.0,1,5,1,4,2,4,1,0,Matches,2021-2022,Bundesliga
Timmy Tillman,de GER,MF,Greuther Fürth,22.0,1999.0,22.3,43,26,17,18,8,19,42,45.2,23,33,4,29,12,55,26,0,Matches,2021-2022,Bundesliga
Umut Tohumcu,de GER,MF,Hoffenheim,16.0,2004.0,0.1,0,0,0,0,0,0,0,,0,0,0,0,0,0,0,0,Matches,2021-2022,Bundesliga
Corentin Tolisso,fr FRA,MF,Bayern Munich,26.0,1994.0,7.8,11,5,1,9,1,7,17,41.2,10,5,1,4,9,20,10,0,Matches,2021-2022,Bundesliga
Tiago Tomás,pt POR,FW,Stuttgart,19.0,2002.0,11.9,8,4,0,7,1,0,6,0.0,6,3,0,3,4,12,1,0,Matches,2021-2022,Bundesliga
Jordan Torunarigha,de GER,DF,Hertha BSC,23.0,1997.0,5.4,4,1,1,3,0,4,5,80.0,1,4,2,2,17,21,30,0,Matches,2021-2022,Bundesliga
Almamy Touré,ml MLI,"DF,MF",Eint Frankfurt,25.0,1996.0,5.6,12,9,8,3,1,4,17,23.5,13,10,3,7,5,17,19,0,Matches,2021-2022,Bundesliga
Lucas Tousart,fr FRA,MF,Hertha BSC,24.0,1997.0,21.8,42,25,15,22,5,10,34,29.4,24,30,6,24,35,77,55,0,Matches,2021-2022,Bundesliga
Kevin Trapp,de GER,GK,Eint Frankfurt,31.0,1990.0,32.0,0,0,0,0,0,0,1,0.0,1,0,0,0,1,1,13,2,Matches,2021-2022,Bundesliga
Christopher Trimmel,at AUT,"DF,FW",Union Berlin,34.0,1987.0,22.1,49,30,25,19,5,26,45,57.8,19,20,3,17,34,83,75,0,Matches,2021-2022,Bundesliga
Philipp Tschauner,de GER,GK,RB Leipzig,35.0,1985.0,0.0,0,0,0,0,0,0,0,,0,0,0,0,0,0,0,0,Matches,2021-2022,Bundesliga
Tuta,br BRA,DF,Eint Frankfurt,22.0,1999.0,24.3,46,28,20,22,4,26,47,55.3,21,43,15,28,41,87,76,1,Matches,2021-2022,Bundesliga
Anthony Ujah,ng NGA,"FW,MF",Union Berlin,30.0,1990.0,0.4,0,0,0,0,0,0,0,,0,0,0,0,0,0,0,0,Matches,2021-2022,Bundesliga
Sven Ulreich,de GER,GK,Bayern Munich,32.0,1988.0,6.0,0,0,0,0,0,0,0,,0,0,0,0,0,0,1,0,Matches,2021-2022,Bundesliga
Dayot Upamecano,fr FRA,DF,Bayern Munich,22.0,1998.0,24.6,66,42,42,21,3,24,36,66.7,12,20,10,10,32,98,71,6,Matches,2021-2022,Bundesliga
Benjamin Uphoff,de GER,GK,Freiburg,27.0,1993.0,2.0,0,0,0,0,0,0,0,,0,0,0,0,0,0,2,2,Matches,2021-2022,Bundesliga
Mark Uth,de GER,"MF,FW",Köln,29.0,1991.0,22.5,32,20,9,14,9,15,49,30.6,34,27,1,26,14,46,13,0,Matches,2021-2022,Bundesliga
Ruben Vargas,ch SUI,"MF,FW",Augsburg,22.0,1998.0,22.0,28,21,7,14,7,11,30,36.7,19,9,1,8,16,44,13,0,Matches,2021-2022,Bundesliga
Sebastian Vasiliadis,gr GRE,MF,Arminia,23.0,1997.0,13.3,31,17,12,15,4,15,42,35.7,27,15,2,13,25,56,31,1,Matches,2021-2022,Bundesliga
Micky van de Ven,nl NED,DF,Wolfsburg,20.0,2001.0,2.1,4,4,3,1,0,0,1,0.0,1,4,1,3,2,6,8,0,Matches,2021-2022,Bundesliga
Vincent Vermeij,nl NED,MF,Freiburg,26.0,1994.0,0.0,0,0,0,0,0,0,0,,0,1,0,1,0,0,0,0,Matches,2021-2022,Bundesliga
Gabriel Vidovic,hr CRO,"FW,MF",Bayern Munich,17.0,2003.0,0.4,0,0,0,0,0,0,0,,0,0,0,0,0,0,0,0,Matches,2021-2022,Bundesliga
Nick Viergever,nl NED,DF,Greuther Fürth,31.0,1989.0,23.7,32,23,25,7,0,24,34,70.6,10,31,22,9,37,69,119,1,Matches,2021-2022,Bundesliga
Andreas Voglsammer,de GER,"FW,MF",Union Berlin,29.0,1992.0,9.8,14,9,8,3,3,6,14,42.9,8,9,2,7,2,16,7,0,Matches,2021-2022,Bundesliga
Kevin Vogt,de GER,DF,Hoffenheim,29.0,1991.0,28.5,21,12,15,6,0,11,21,52.4,10,18,7,11,13,34,101,1,Matches,2021-2022,Bundesliga
Aster Vranckx,be BEL,MF,Wolfsburg,18.0,2002.0,12.7,34,13,14,16,4,14,26,53.8,12,19,7,12,13,47,16,0,Matches,2021-2022,Bundesliga
Luca Waldschmidt,de GER,"MF,FW",Wolfsburg,25.0,1996.0,8.0,9,1,3,5,1,5,13,38.5,8,5,0,5,8,17,3,0,Matches,2021-2022,Bundesliga
Paul Wanner,de GER,"FW,MF",Bayern Munich,15.0,2005.0,0.4,2,2,0,2,0,1,1,100.0,0,0,0,0,0,2,0,0,Matches,2021-2022,Bundesliga
Wout Weghorst,nl NED,FW,Wolfsburg,28.0,1992.0,17.3,13,7,3,3,7,7,17,41.2,10,10,3,7,2,15,11,1,Matches,2021-2022,Bundesliga
Noah Weißhaupt,de GER,"MF,FW",Freiburg,19.0,2001.0,1.1,1,1,1,0,0,1,2,50.0,1,2,0,2,1,2,1,1,Matches,2021-2022,Bundesliga
Silvan Widmer,ch SUI,DF,Mainz 05,28.0,1993.0,32.4,60,28,32,20,8,36,61,59.0,25,44,16,28,43,103,59,2,Matches,2021-2022,Bundesliga
Jetro Willems,nl NED,DF,Greuther Fürth,27.0,1994.0,17.8,30,15,18,10,2,15,26,57.7,11,15,3,12,14,44,42,0,Matches,2021-2022,Bundesliga
Patrick Wimmer,at AUT,"FW,MF",Arminia,20.0,2001.0,22.8,53,31,13,31,9,22,61,36.1,39,30,1,29,27,80,13,0,Matches,2021-2022,Bundesliga
Jonas Wind,dk DEN,"FW,MF",Wolfsburg,22.0,1999.0,13.1,10,6,1,7,2,1,4,25.0,3,8,3,5,6,16,13,0,Matches,2021-2022,Bundesliga
Marten Winkler,de GER,MF,Hertha BSC,18.0,2002.0,0.3,0,0,0,0,0,0,0,,0,0,0,0,0,0,0,0,Matches,2021-2022,Bundesliga
Frederik Winther,dk DEN,DF,Augsburg,20.0,2001.0,3.6,7,2,7,0,0,5,6,83.3,1,4,1,3,8,15,21,0,Matches,2021-2022,Bundesliga
Florian Wirtz,de GER,"MF,FW",Leverkusen,18.0,2003.0,20.6,25,10,6,16,3,10,28,35.7,18,12,1,11,13,38,4,0,Matches,2021-2022,Bundesliga
Axel Witsel,be BEL,"MF,DF",Dortmund,32.0,1989.0,21.6,42,27,12,23,7,18,30,60.0,12,24,9,15,27,69,38,0,Matches,2021-2022,Bundesliga
Hannes Wolf,at AUT,"FW,MF",Gladbach,22.0,1999.0,3.4,23,12,4,13,6,10,20,50.0,10,10,0,10,2,25,1,0,Matches,2021-2022,Bundesliga
Marius Wolf,de GER,"DF,FW",Dortmund,26.0,1995.0,14.7,26,10,13,9,4,12,24,50.0,12,14,1,13,13,39,8,0,Matches,2021-2022,Bundesliga
Luca Wollschläger,de GER,"FW,MF",Hertha BSC,18.0,2003.0,0.2,1,1,0,1,0,0,1,0.0,1,0,0,0,0,1,0,0,Matches,2021-2022,Bundesliga
Jeong Woo-yeong,kr KOR,"FW,MF",Freiburg,21.0,1999.0,19.8,15,9,6,7,2,5,15,33.3,10,8,1,7,7,22,11,0,Matches,2021-2022,Bundesliga
Joscha Wosz,de GER,DF,RB Leipzig,19.0,2002.0,0.1,0,0,0,0,0,0,0,,0,0,0,0,0,0,0,0,Matches,2021-2022,Bundesliga
Dan-Axel Zagadou,fr FRA,DF,Dortmund,22.0,1999.0,10.6,13,7,11,1,1,7,10,70.0,3,14,4,10,15,28,38,2,Matches,2021-2022,Bundesliga
Denis Zakaria,ch SUI,"MF,DF",Gladbach,24.0,1996.0,15.5,23,14,9,10,4,12,35,34.3,23,25,5,20,19,42,22,1,Matches,2021-2022,Bundesliga
Deyovaisio Zeefuik,nl NED,DF,Hertha BSC,23.0,1998.0,6.3,11,10,6,4,1,6,12,50.0,6,12,4,8,11,22,21,1,Matches,2021-2022,Bundesliga
Robin Zentner,de GER,GK,Mainz 05,26.0,1994.0,32.0,2,2,2,0,0,2,2,100.0,0,0,0,0,2,4,21,1,Matches,2021-2022,Bundesliga
Andi Zeqiri,ch SUI,"FW,MF",Augsburg,22.0,1999.0,11.3,14,7,3,5,6,3,12,25.0,9,10,1,9,2,16,12,0,Matches,2021-2022,Bundesliga
Simon Zoller,de GER,FW,Bochum,30.0,1991.0,6.6,4,2,2,1,1,1,3,33.3,2,3,0,3,4,8,2,0,Matches,2021-2022,Bundesliga
Paxten Aaronson,us USA,"MF,DF",Eint Frankfurt,18.0,2003.0,1.9,6,5,2,2,2,2,3,66.7,1,2,1,1,0,6,2,0,Matches,2022-2023,Bundesliga
Sargis Adamyan,am ARM,"FW,MF",Köln,29.0,1993.0,7.2,14,7,5,3,6,7,17,41.2,10,12,0,12,4,18,5,0,Matches,2022-2023,Bundesliga
Karim Adeyemi,de GER,"FW,MF",Dortmund,20.0,2002.0,15.4,16,11,6,6,4,8,30,26.7,22,18,1,17,7,23,3,0,Matches,2022-2023,Bundesliga
Amine Adli,ma MAR,"FW,MF",Leverkusen,22.0,2000.0,15.9,18,10,4,6,8,5,17,29.4,12,28,2,26,6,24,7,0,Matches,2022-2023,Bundesliga
Felix Agu,de GER,"DF,FW",Werder Bremen,22.0,1999.0,0.5,1,0,0,1,0,0,0,,0,1,1,0,0,1,0,0,Matches,2022-2023,Bundesliga
Naouirou Ahamada,fr FRA,MF,Stuttgart,20.0,2002.0,15.5,17,11,7,7,3,8,20,40.0,12,16,5,11,8,25,7,0,Matches,2022-2023,Bundesliga
Ludovic Ajorque,fr FRA,"FW,MF",Mainz 05,28.0,1994.0,13.5,6,5,1,4,1,1,9,11.1,8,8,2,6,1,7,8,0,Matches,2022-2023,Bundesliga
Kevin Akpoguma,ng NGA,DF,Hoffenheim,27.0,1995.0,21.7,75,44,45,27,3,32,45,71.1,13,45,16,29,24,99,70,1,Matches,2022-2023,Bundesliga
Lucas Alario,ar ARG,"FW,MF",Eint Frankfurt,29.0,1992.0,3.7,3,2,1,0,2,0,1,0.0,1,0,0,0,2,5,13,0,Matches,2022-2023,Bundesliga
Faride Alidou,de GER,"DF,MF",Eint Frankfurt,21.0,2001.0,2.0,8,5,3,4,1,3,9,33.3,6,3,0,3,1,9,3,0,Matches,2022-2023,Bundesliga
Éder Álvarez Balanta,co COL,"MF,FW",Schalke 04,29.0,1993.0,2.6,5,4,2,3,0,2,6,33.3,4,0,0,0,3,8,4,0,Matches,2022-2023,Bundesliga
Lukáš Ambros,cz CZE,MF,Wolfsburg,18.0,2004.0,0.2,1,0,1,0,0,1,4,25.0,3,1,0,1,0,1,2,1,Matches,2022-2023,Bundesliga
Nadiem Amiri,de GER,"MF,FW",Leverkusen,25.0,1996.0,10.9,15,6,5,8,2,9,20,45.0,11,12,1,11,6,21,10,2,Matches,2022-2023,Bundesliga
Robert Andrich,de GER,MF,Leverkusen,27.0,1994.0,26.7,61,38,30,27,4,26,45,57.8,19,27,9,18,42,103,55,2,Matches,2022-2023,Bundesliga
Angeliño,es ESP,DF,Hoffenheim,25.0,1997.0,29.1,40,24,19,18,3,23,37,62.2,14,32,6,26,25,65,67,0,Matches,2022-2023,Bundesliga
Waldemar Anton,de GER,DF,Stuttgart,26.0,1996.0,32.6,49,27,27,19,3,27,51,52.9,24,44,16,28,38,87,123,2,Matches,2022-2023,Bundesliga
Christopher Antwi-Adjei,gh GHA,"FW,MF",Bochum,28.0,1994.0,22.0,23,15,7,8,8,10,29,34.5,19,17,0,17,5,28,16,0,Matches,2022-2023,Bundesliga
Charles Aránguiz,cl CHI,MF,Leverkusen,33.0,1989.0,5.5,17,7,7,10,0,12,20,60.0,8,4,0,4,7,24,4,0,Matches,2022-2023,Bundesliga
Maximilian Arnold,de GER,MF,Wolfsburg,28.0,1994.0,30.7,62,31,25,28,9,28,54,51.9,26,34,11,23,26,88,65,2,Matches,2022-2023,Bundesliga
Takuma Asano,jp JPN,"FW,MF",Bochum,27.0,1994.0,19.0,14,9,4,4,6,7,16,43.8,9,17,1,16,8,22,8,0,Matches,2022-2023,Bundesliga
Fisnik Asllani,xk KVX,FW,Hoffenheim,19.0,2002.0,1.9,0,0,0,0,0,0,4,0.0,4,2,0,2,3,3,3,0,Matches,2022-2023,Bundesliga
Mehmet Aydin,de GER,"DF,FW",Schalke 04,20.0,2002.0,6.3,25,18,14,9,2,11,24,45.8,13,11,0,11,10,35,15,0,Matches,2022-2023,Bundesliga
Ayman Azhil,ma MAR,MF,Leverkusen,21.0,2001.0,0.0,0,0,0,0,0,0,0,,0,0,0,0,0,0,0,0,Matches,2022-2023,Bundesliga
Sardar Azmoun,ir IRN,"FW,MF",Leverkusen,27.0,1995.0,10.3,6,3,1,4,1,1,7,14.3,6,4,0,4,2,8,14,0,Matches,2022-2023,Bundesliga
Sanoussy Ba,de GER,DF,RB Leipzig,18.0,2004.0,0.0,0,0,0,0,0,0,0,,0,0,0,0,0,0,0,0,Matches,2022-2023,Bundesliga
Mitchel Bakker,nl NED,"DF,MF",Leverkusen,22.0,2000.0,18.4,16,8,9,7,0,6,15,40.0,9,20,2,18,15,31,20,2,Matches,2022-2023,Bundesliga
Ridle Baku,de GER,"DF,FW",Wolfsburg,24.0,1998.0,28.7,50,26,29,17,4,32,58,55.2,26,44,6,38,21,71,59,0,Matches,2022-2023,Bundesliga
Aymen Barkok,ma MAR,MF,Mainz 05,24.0,1998.0,6.5,18,8,10,5,3,5,10,50.0,5,7,0,7,3,21,9,0,Matches,2022-2023,Bundesliga
Leandro Barreiro Martins,lu LUX,MF,Mainz 05,22.0,2000.0,23.8,60,38,19,28,13,22,49,44.9,27,38,13,25,41,101,39,1,Matches,2022-2023,Bundesliga
Gil Bastião Dias,pt POR,FW,Stuttgart,25.0,1996.0,4.4,8,6,3,4,1,3,12,25.0,9,7,0,7,2,10,3,0,Matches,2022-2023,Bundesliga
Maximilian Bauer,de GER,DF,Augsburg,22.0,2000.0,20.5,31,17,18,12,1,17,34,50.0,17,25,9,16,23,54,79,1,Matches,2022-2023,Bundesliga
Oliver Baumann,de GER,GK,Hoffenheim,32.0,1990.0,34.0,0,0,0,0,0,0,0,,0,0,0,0,0,0,15,1,Matches,2022-2023,Bundesliga
Timo Baumgartl,de GER,DF,Union Berlin,26.0,1996.0,6.2,11,6,5,4,2,5,18,27.8,13,12,4,8,2,13,14,0,Matches,2022-2023,Bundesliga
Julian Baumgartlinger,at AUT,MF,Augsburg,34.0,1988.0,6.2,15,4,5,6,4,6,19,31.6,13,4,2,2,4,19,15,0,Matches,2022-2023,Bundesliga
Christoph Baumgartner,at AUT,"MF,FW",Hoffenheim,22.0,1999.0,28.5,36,19,12,17,7,9,52,17.3,43,57,5,52,15,51,19,1,Matches,2022-2023,Bundesliga
Noah Joel Sarenren Bazee,ng NGA,"MF,FW",Augsburg,25.0,1996.0,0.2,0,0,0,0,0,0,1,0.0,1,1,0,1,0,0,0,0,Matches,2022-2023,Bundesliga
Ihlas Bebou,tg TOG,"FW,DF",Hoffenheim,28.0,1994.0,15.7,19,16,8,7,4,11,17,64.7,6,9,2,7,7,26,15,0,Matches,2022-2023,Bundesliga
Sheraldo Becker,sr SUR,FW,Union Berlin,27.0,1995.0,28.4,15,5,1,7,7,2,11,18.2,9,13,1,12,3,18,7,1,Matches,2022-2023,Bundesliga
Kevin Behrens,de GER,FW,Union Berlin,31.0,1991.0,17.1,11,7,4,4,3,4,18,22.2,14,18,3,15,5,16,25,0,Matches,2022-2023,Bundesliga
Stefan Bell,de GER,DF,Mainz 05,30.0,1991.0,26.6,43,28,32,10,1,22,44,50.0,22,42,15,27,44,87,133,0,Matches,2022-2023,Bundesliga
Karim Bellarabi,de GER,"FW,MF",Leverkusen,32.0,1990.0,0.9,2,0,1,1,0,2,3,66.7,1,0,0,0,0,2,0,0,Matches,2022-2023,Bundesliga
Jude Bellingham,eng ENG,MF,Dortmund,19.0,2003.0,29.9,76,42,28,34,14,34,51,66.7,17,51,4,47,35,111,30,0,Matches,2022-2023,Bundesliga
Ramy Bensebaini,dz ALG,DF,Gladbach,27.0,1995.0,27.6,34,21,21,10,3,26,39,66.7,13,44,14,30,36,70,98,1,Matches,2022-2023,Bundesliga
Mergim Berisha,de GER,FW,Augsburg,24.0,1998.0,18.7,11,6,4,3,4,4,14,28.6,10,16,1,15,0,11,19,0,Matches,2022-2023,Bundesliga
Ermin Bičakčić,ba BIH,DF,Hoffenheim,32.0,1990.0,2.9,8,4,6,1,1,2,6,33.3,4,4,3,1,5,13,14,0,Matches,2022-2023,Bundesliga
Tom Bischof,de GER,"MF,FW",Hoffenheim,17.0,2005.0,3.5,15,10,8,3,4,7,10,70.0,3,5,1,4,1,16,1,0,Matches,2022-2023,Bundesliga
Leonardo Bittencourt,de GER,"MF,DF",Werder Bremen,28.0,1993.0,18.1,53,28,20,25,8,25,62,40.3,37,13,0,13,10,63,15,0,Matches,2022-2023,Bundesliga
Janis Blaswich,de GER,GK,RB Leipzig,31.0,1991.0,26.0,0,0,0,0,0,0,0,,0,0,0,0,0,0,10,0,Matches,2022-2023,Bundesliga
Daley Blind,nl NED,"DF,MF",Bayern Munich,32.0,1990.0,1.5,2,0,2,0,0,0,1,0.0,1,4,2,2,2,4,6,0,Matches,2022-2023,Bundesliga
Kevin-Prince Boateng,gh GHA,MF,Hertha BSC,35.0,1987.0,5.2,8,6,4,2,2,3,9,33.3,6,11,3,8,3,11,5,0,Matches,2022-2023,Bundesliga
Jean-Paul Boëtius,nl NED,MF,Hertha BSC,28.0,1994.0,11.7,30,16,19,9,2,8,25,32.0,17,25,5,20,14,44,10,0,Matches,2022-2023,Bundesliga
Yvandro Borges Sanches,lu LUX,"FW,MF",Gladbach,18.0,2004.0,0.3,2,2,0,2,0,2,2,100.0,0,0,0,0,0,2,0,0,Matches,2022-2023,Bundesliga
Sebastiaan Bornauw,be BEL,DF,Wolfsburg,23.0,1999.0,21.4,29,17,17,10,2,16,22,72.7,6,27,12,15,31,60,83,1,Matches,2022-2023,Bundesliga
Rafael Borré,co COL,"MF,FW",Eint Frankfurt,26.0,1995.0,12.0,25,15,4,13,8,4,17,23.5,13,10,2,8,2,27,9,0,Matches,2022-2023,Bundesliga
Julian Brandt,de GER,"MF,FW",Dortmund,26.0,1996.0,26.6,29,20,6,14,9,12,43,27.9,31,23,0,23,15,44,9,1,Matches,2022-2023,Bundesliga
Fabian Bredlow,de GER,GK,Stuttgart,27.0,1995.0,15.0,1,1,1,0,0,1,1,100.0,0,0,0,0,0,1,4,2,Matches,2022-2023,Bundesliga
Josip Brekalo,hr CRO,"MF,FW",Wolfsburg,24.0,1998.0,3.0,2,1,2,0,0,0,4,0.0,4,0,0,0,2,4,2,0,Matches,2022-2023,Bundesliga
John Brooks,us USA,DF,Hoffenheim,29.0,1993.0,15.0,18,12,10,8,0,13,18,72.2,5,17,12,5,10,28,105,0,Matches,2022-2023,Bundesliga
Moritz Broschinski,de GER,"FW,MF",Bochum,21.0,2000.0,2.4,0,0,0,0,0,0,5,0.0,5,1,0,1,0,0,6,0,Matches,2022-2023,Bundesliga
Cédric Brunner,ch SUI,DF,Schalke 04,28.0,1994.0,25.7,39,27,26,11,2,30,45,66.7,15,24,7,17,43,82,79,0,Matches,2022-2023,Bundesliga
Jacob Bruun Larsen,dk DEN,FW,Hoffenheim,23.0,1998.0,3.6,4,3,0,1,3,3,4,75.0,1,3,1,2,1,5,0,0,Matches,2022-2023,Bundesliga
Lee Buchanan,eng ENG,"DF,FW",Werder Bremen,21.0,2001.0,5.2,14,10,2,11,1,6,12,50.0,6,5,0,5,12,26,21,0,Matches,2022-2023,Bundesliga
Marius Bülter,de GER,"FW,MF",Schalke 04,29.0,1993.0,28.9,22,11,8,7,7,12,32,37.5,20,34,1,33,10,32,20,0,Matches,2022-2023,Bundesliga
Delano Burgzorg,sr SUR,"FW,MF",Mainz 05,23.0,1998.0,2.7,3,3,1,1,1,2,3,66.7,1,2,0,2,0,3,2,0,Matches,2022-2023,Bundesliga
Jonathan Burkardt,de GER,"MF,FW",Mainz 05,22.0,2000.0,5.9,3,1,0,1,2,1,4,25.0,3,6,1,5,1,4,1,0,Matches,2022-2023,Bundesliga
Oliver Burke,sct SCO,"FW,MF",Werder Bremen,25.0,1997.0,3.0,1,0,0,0,1,0,0,,0,2,0,2,0,1,0,0,Matches,2022-2023,Bundesliga
Aurélio Buta,pt POR,DF,Eint Frankfurt,25.0,1997.0,14.6,33,19,15,13,5,15,27,55.6,12,18,1,17,9,42,34,0,Matches,2022-2023,Bundesliga
Anthony Caci,fr FRA,DF,Mainz 05,25.0,1997.0,22.6,58,33,32,20,6,28,42,66.7,14,28,4,24,54,112,40,0,Matches,2022-2023,Bundesliga
Kerim Calhanoglu,de GER,DF,Schalke 04,19.0,2002.0,0.7,2,1,2,0,0,2,2,100.0,0,1,0,1,0,2,3,0,Matches,2022-2023,Bundesliga
Daniel Caligiuri,it ITA,"DF,MF",Augsburg,34.0,1988.0,3.2,8,5,5,3,0,4,5,80.0,1,3,2,1,3,11,2,0,Matches,2022-2023,Bundesliga
Emre Can,de GER,MF,Dortmund,28.0,1994.0,21.1,57,28,25,27,5,22,43,51.2,21,16,6,10,25,82,39,1,Matches,2022-2023,Bundesliga
João Cancelo,pt POR,"DF,FW",Bayern Munich,28.0,1994.0,11.2,23,14,9,10,4,10,23,43.5,13,14,2,12,15,38,22,0,Matches,2022-2023,Bundesliga
Irvin Cardona,fr FRA,"MF,FW",Augsburg,24.0,1997.0,3.5,1,1,1,0,0,1,5,20.0,4,3,0,3,4,5,8,0,Matches,2022-2023,Bundesliga
Koen Casteels,be BEL,GK,Wolfsburg,30.0,1992.0,34.0,0,0,0,0,0,0,0,,0,0,0,0,1,1,10,1,Matches,2022-2023,Bundesliga
Julian Chabot,de GER,DF,Köln,24.0,1998.0,20.0,36,23,19,14,3,20,35,57.1,15,30,18,12,41,77,105,0,Matches,2022-2023,Bundesliga
Timothy Chandler,us USA,DF,Eint Frankfurt,32.0,1990.0,1.0,2,2,2,0,0,2,2,100.0,0,1,0,1,0,2,3,0,Matches,2022-2023,Bundesliga
Fabio Chiarodia,it ITA,DF,Werder Bremen,17.0,2005.0,0.7,0,0,0,0,0,0,0,,0,1,0,1,2,2,4,0,Matches,2022-2023,Bundesliga
Oliver Christensen,dk DEN,GK,Hertha BSC,23.0,1999.0,33.0,1,0,1,0,0,0,2,0.0,2,0,0,0,0,1,22,2,Matches,2022-2023,Bundesliga
Darko Churlinov,mk MKD,FW,Stuttgart,22.0,2000.0,0.3,3,2,2,1,0,2,3,66.7,1,1,0,1,0,3,0,0,Matches,2022-2023,Bundesliga
Tolga Ciğerci,tr TUR,MF,Hertha BSC,30.0,1992.0,7.5,16,13,6,9,1,10,16,62.5,6,6,2,4,8,24,5,0,Matches,2022-2023,Bundesliga
David Čolina,hr CRO,"DF,FW",Augsburg,22.0,2000.0,1.8,4,1,1,1,2,2,2,100.0,0,8,0,8,4,8,3,0,Matches,2022-2023,Bundesliga
Kingsley Coman,fr FRA,"FW,MF",Bayern Munich,26.0,1996.0,15.7,11,8,3,5,3,7,17,41.2,10,19,1,18,2,13,7,0,Matches,2022-2023,Bundesliga
Danny da Costa,de GER,DF,Mainz 05,29.0,1993.0,13.7,20,16,7,8,5,12,20,60.0,8,22,3,19,9,29,26,0,Matches,2022-2023,Bundesliga
Soumaïla Coulibaly,fr FRA,DF,Dortmund,18.0,2003.0,0.5,0,0,0,0,0,0,0,,0,0,0,0,0,0,0,1,Matches,2022-2023,Bundesliga
Tanguy Coulibaly,fr FRA,"FW,DF",Stuttgart,21.0,2001.0,3.6,12,9,9,1,2,5,12,41.7,7,10,0,10,3,15,0,0,Matches,2022-2023,Bundesliga
Nicolas Cozza,fr FRA,DF,Wolfsburg,23.0,1999.0,1.1,3,3,1,2,0,2,3,66.7,1,3,1,2,0,3,0,0,Matches,2022-2023,Bundesliga
Moanes Dabbur,il ISR,FW,Hoffenheim,30.0,1992.0,10.4,11,8,4,5,2,3,9,33.3,6,8,0,8,5,16,0,0,Matches,2022-2023,Bundesliga
Finn Dahmen,de GER,GK,Mainz 05,24.0,1998.0,8.0,0,0,0,0,0,0,0,,0,0,0,0,0,0,3,0,Matches,2022-2023,Bundesliga
Mahmoud Dahoud,de GER,MF,Dortmund,26.0,1996.0,3.7,11,9,3,4,4,7,7,100.0,0,6,2,4,7,18,3,0,Matches,2022-2023,Bundesliga
Muhammed Damar,de GER,MF,Hoffenheim,18.0,2004.0,1.8,6,3,1,2,3,1,2,50.0,1,3,0,3,0,6,0,0,Matches,2022-2023,Bundesliga
Márton Dárdai,hu HUN,"DF,MF",Hertha BSC,20.0,2002.0,10.5,17,8,9,8,0,9,18,50.0,9,14,9,5,11,28,45,1,Matches,2022-2023,Bundesliga
Vladimír Darida,cz CZE,MF,Hertha BSC,31.0,1990.0,0.3,1,1,0,1,0,0,0,,0,1,0,1,0,1,0,0,Matches,2022-2023,Bundesliga
Alphonso Davies,ca CAN,DF,Bayern Munich,21.0,2000.0,22.7,45,28,25,13,7,18,39,46.2,21,28,4,24,24,69,24,4,Matches,2022-2023,Bundesliga
Thomas Delaney,dk DEN,MF,Hoffenheim,30.0,1991.0,3.3,6,3,3,2,1,3,8,37.5,5,5,0,5,1,7,4,0,Matches,2022-2023,Bundesliga
Kerem Demirbay,de GER,MF,Leverkusen,29.0,1993.0,17.2,36,18,16,17,3,18,34,52.9,16,26,6,20,16,52,11,0,Matches,2022-2023,Bundesliga
Ermedin Demirović,ba BIH,"FW,MF",Augsburg,24.0,1998.0,26.3,31,14,9,12,10,9,22,40.9,13,31,4,27,14,45,37,0,Matches,2022-2023,Bundesliga
Sepp van den Berg,nl NED,DF,Schalke 04,20.0,2001.0,7.7,5,4,2,2,1,1,4,25.0,3,8,5,3,13,18,33,2,Matches,2022-2023,Bundesliga
Moussa Diaby,fr FRA,"FW,MF",Leverkusen,23.0,1999.0,30.0,14,8,4,8,2,7,14,50.0,7,8,0,8,5,19,3,0,Matches,2022-2023,Bundesliga
Abdou Diallo,sn SEN,"DF,MF",RB Leipzig,26.0,1996.0,5.3,6,5,5,1,0,1,3,33.3,2,8,5,3,8,14,22,0,Matches,2022-2023,Bundesliga
Justin Diehl,de GER,"MF,FW",Köln,17.0,2004.0,0.2,0,0,0,0,0,0,0,,0,0,0,0,0,0,0,0,Matches,2022-2023,Bundesliga
Florian Dietz,de GER,FW,Köln,23.0,1998.0,4.4,2,1,0,2,0,1,4,25.0,3,4,1,3,0,2,2,0,Matches,2022-2023,Bundesliga
Junior Dina Ebimbe,fr FRA,"DF,MF",Eint Frankfurt,21.0,2000.0,11.8,30,19,16,14,0,16,33,48.5,17,18,5,13,11,41,20,0,Matches,2022-2023,Bundesliga
Eren Dinkçi,de GER,"FW,MF",Werder Bremen,20.0,2001.0,2.6,5,5,2,1,2,2,6,33.3,4,2,0,2,0,5,2,0,Matches,2022-2023,Bundesliga
Ritsu Doan,jp JPN,"MF,FW",Freiburg,24.0,1998.0,26.9,61,29,19,29,13,25,55,45.5,30,40,1,39,14,75,12,0,Matches,2022-2023,Bundesliga
Danilho Doekhi,nl NED,DF,Union Berlin,24.0,1998.0,24.6,38,23,21,17,0,14,26,53.8,12,27,12,15,29,67,93,0,Matches,2022-2023,Bundesliga
Kasper Dolberg,dk DEN,"FW,MF",Hoffenheim,24.0,1997.0,4.5,7,5,1,4,2,4,6,66.7,2,6,2,4,0,7,5,0,Matches,2022-2023,Bundesliga
Niklas Dorsch,de GER,MF,Augsburg,24.0,1998.0,5.4,21,12,8,11,2,9,16,56.3,7,9,3,6,6,27,9,0,Matches,2022-2023,Bundesliga
Dion Drena Beljo,hr CRO,FW,Augsburg,20.0,2002.0,12.5,7,6,3,2,2,2,13,15.4,11,15,2,13,1,8,14,0,Matches,2022-2023,Bundesliga
Dominick Drexler,de GER,"MF,FW",Schalke 04,32.0,1990.0,15.2,25,17,12,10,3,9,22,40.9,13,18,2,16,8,33,12,0,Matches,2022-2023,Bundesliga
Marvin Ducksch,de GER,FW,Werder Bremen,28.0,1994.0,31.7,8,3,2,4,2,3,16,18.8,13,13,2,11,9,17,41,1,Matches,2022-2023,Bundesliga
Ondrej Duda,sk SVK,MF,Köln,27.0,1994.0,7.7,9,8,2,5,2,4,11,36.4,7,7,1,6,2,11,3,0,Matches,2022-2023,Bundesliga
Julien Duranville,be BEL,MF,Dortmund,16.0,2006.0,0.3,1,1,0,1,0,1,1,100.0,0,0,0,0,0,1,0,0,Matches,2022-2023,Bundesliga
Maximilian Eggestein,de GER,MF,Freiburg,25.0,1996.0,27.2,51,29,21,24,6,17,35,48.6,18,37,8,29,36,87,27,0,Matches,2022-2023,Bundesliga
Lilian Egloff,de GER,"MF,FW",Stuttgart,19.0,2002.0,2.7,12,10,4,5,3,4,6,66.7,2,2,0,2,1,13,1,0,Matches,2022-2023,Bundesliga
Kingsley Ehizibue,nl NED,DF,Köln,27.0,1995.0,0.7,0,0,0,0,0,0,0,,0,1,0,1,2,2,1,0,Matches,2022-2023,Bundesliga
Julian Eitschberger,de GER,FW,Hertha BSC,18.0,2004.0,0.0,0,0,0,0,0,0,0,,0,0,0,0,0,0,0,0,Matches,2022-2023,Bundesliga
Chidera Ejuke,ng NGA,"FW,MF",Hertha BSC,24.0,1998.0,9.9,5,4,1,4,0,1,5,20.0,4,4,0,4,4,9,1,0,Matches,2022-2023,Bundesliga
Nico Elvedi,ch SUI,DF,Gladbach,25.0,1996.0,31.4,46,24,32,12,2,27,41,65.9,14,31,16,15,35,81,149,3,Matches,2022-2023,Bundesliga
Wataru Endo,jp JPN,MF,Stuttgart,29.0,1993.0,32.5,70,37,30,31,9,38,85,44.7,47,44,6,38,26,96,63,0,Matches,2022-2023,Bundesliga
Arne Engels,be BEL,MF,Augsburg,18.0,2003.0,16.0,20,9,9,10,1,8,19,42.1,11,17,5,12,15,35,12,1,Matches,2022-2023,Bundesliga
Tjark Ernst,de GER,GK,Hertha BSC,19.0,2003.0,1.0,0,0,0,0,0,0,0,,0,0,0,0,0,0,1,0,Matches,2022-2023,Bundesliga
Kimberly Ezekwem,de GER,DF,Freiburg,21.0,2001.0,0.1,0,0,0,0,0,0,0,,0,1,0,1,0,0,0,0,Matches,2022-2023,Bundesliga
Ralf Fährmann,de GER,GK,Schalke 04,33.0,1988.0,11.4,1,0,1,0,0,1,1,100.0,0,0,0,0,0,1,10,2,Matches,2022-2023,Bundesliga
Ohis Felix Uduokhai,de GER,DF,Augsburg,24.0,1997.0,16.1,30,20,14,13,3,15,29,51.7,14,27,14,13,29,59,61,1,Matches,2022-2023,Bundesliga
Edimilson Fernandes,ch SUI,DF,Mainz 05,26.0,1996.0,27.1,35,25,26,5,4,18,34,52.9,16,37,16,21,54,89,87,2,Matches,2022-2023,Bundesliga
Kilian Fischer,de GER,"DF,FW",Wolfsburg,21.0,2000.0,5.6,9,6,3,4,2,6,11,54.5,5,6,0,6,5,14,18,0,Matches,2022-2023,Bundesliga
Mark Flekken,nl NED,GK,Freiburg,29.0,1993.0,34.0,0,0,0,0,0,0,1,0.0,1,1,0,1,0,0,9,5,Matches,2022-2023,Bundesliga
Florian Flick,de GER,MF,Schalke 04,22.0,2000.0,5.7,12,3,7,5,0,4,14,28.6,10,9,3,6,4,16,18,0,Matches,2022-2023,Bundesliga
Emil Forsberg,se SWE,"MF,FW",RB Leipzig,30.0,1991.0,16.5,16,11,1,8,7,6,20,30.0,14,25,2,23,3,19,7,0,Matches,2022-2023,Bundesliga
Philipp Förster,de GER,MF,Bochum,27.0,1995.0,14.5,31,19,11,15,5,12,40,30.0,28,22,0,22,6,37,6,0,Matches,2022-2023,Bundesliga
Timothy Fosu-Mensah,nl NED,DF,Leverkusen,24.0,1998.0,2.1,7,5,3,3,1,4,4,100.0,0,2,0,2,0,7,1,0,Matches,2022-2023,Bundesliga
Raphael Framberger,de GER,"DF,FW",Augsburg,26.0,1995.0,2.0,10,6,6,4,0,3,5,60.0,2,2,1,1,2,12,5,0,Matches,2022-2023,Bundesliga
Bartol Franjić,hr CRO,MF,Wolfsburg,22.0,2000.0,2.5,4,2,2,2,0,0,2,0.0,2,4,1,3,5,9,4,0,Matches,2022-2023,Bundesliga
Oscar Fraulo,dk DEN,"FW,MF",Gladbach,18.0,2003.0,0.1,0,0,0,0,0,0,0,,0,0,0,0,0,0,0,0,Matches,2022-2023,Bundesliga
Michael Frey,ch SUI,FW,Schalke 04,28.0,1994.0,9.6,13,5,2,8,3,4,13,30.8,9,6,0,6,2,15,1,0,Matches,2022-2023,Bundesliga
Marco Friedl,at AUT,DF,Werder Bremen,24.0,1998.0,28.8,62,46,40,22,0,41,68,60.3,27,46,17,29,58,120,127,1,Matches,2022-2023,Bundesliga
Marvin Friedrich,de GER,DF,Gladbach,26.0,1995.0,13.9,17,11,13,3,1,10,13,76.9,3,14,6,8,11,28,52,0,Matches,2022-2023,Bundesliga
Jeremie Frimpong,nl NED,"DF,MF",Leverkusen,21.0,2000.0,30.1,53,27,22,26,5,23,44,52.3,21,24,3,21,16,69,40,0,Matches,2022-2023,Bundesliga
Chris Führich,de GER,"FW,MF",Stuttgart,24.0,1998.0,20.9,36,14,15,14,7,24,44,54.5,20,29,2,27,7,43,13,0,Matches,2022-2023,Bundesliga
Angelo Fulgini,fr FRA,MF,Mainz 05,25.0,1996.0,5.8,6,5,2,3,1,5,12,41.7,7,5,0,5,5,11,7,0,Matches,2022-2023,Bundesliga
Niclas Füllkrug,de GER,FW,Werder Bremen,29.0,1993.0,27.5,9,4,0,6,3,3,13,23.1,10,13,4,9,1,10,24,0,Matches,2022-2023,Bundesliga
Cristian Gamboa,cr CRC,DF,Bochum,32.0,1989.0,16.4,42,24,27,14,1,21,31,67.7,10,20,7,13,16,58,34,1,Matches,2022-2023,Bundesliga
Silvère Ganvoula M'Boussy,cg CGO,"FW,MF",Bochum,26.0,1996.0,2.7,2,2,0,1,1,0,0,,0,0,0,0,0,2,3,0,Matches,2022-2023,Bundesliga
Dario Gebuhr,de GER,DF,Eint Frankfurt,19.0,2003.0,0.2,0,0,0,0,0,0,1,0.0,1,0,0,0,0,0,0,0,Matches,2022-2023,Bundesliga
Dennis Geiger,de GER,MF,Hoffenheim,24.0,1998.0,21.7,45,25,15,28,2,22,35,62.9,13,27,3,24,24,69,18,2,Matches,2022-2023,Bundesliga
Yannick Gerhardt,de GER,MF,Wolfsburg,28.0,1994.0,20.7,29,15,10,11,8,12,30,40.0,18,26,5,21,7,36,24,0,Matches,2022-2023,Bundesliga
Niko Gießelmann,de GER,DF,Union Berlin,30.0,1991.0,14.5,21,11,9,9,3,13,31,41.9,18,17,5,12,9,30,28,0,Matches,2022-2023,Bundesliga
Rafał Gikiewicz,pl POL,GK,Augsburg,34.0,1987.0,23.0,2,2,2,0,0,2,3,66.7,1,0,0,0,0,2,15,5,Matches,2022-2023,Bundesliga
Matthias Ginter,de GER,DF,Freiburg,28.0,1994.0,34.0,43,20,29,12,2,26,40,65.0,14,40,24,16,35,78,153,3,Matches,2022-2023,Bundesliga
Jamie Gittens,eng ENG,"FW,MF",Dortmund,17.0,2004.0,5.9,8,4,2,5,1,2,7,28.6,5,1,0,1,1,9,2,0,Matches,2022-2023,Bundesliga
Serge Gnabry,de GER,"FW,MF",Bayern Munich,27.0,1995.0,21.6,35,23,11,14,10,17,43,39.5,26,24,1,23,11,46,5,1,Matches,2022-2023,Bundesliga
Jacek Góralski,pl POL,MF,Bochum,29.0,1992.0,1.6,6,3,3,3,0,4,6,66.7,2,4,0,4,3,9,5,0,Matches,2022-2023,Bundesliga
Leon Goretzka,de GER,MF,Bayern Munich,27.0,1995.0,19.2,43,24,21,16,6,27,48,56.3,21,40,3,37,30,73,32,0,Matches,2022-2023,Bundesliga
Mario Götze,de GER,MF,Eint Frankfurt,30.0,1992.0,30.4,42,25,13,22,7,14,47,29.8,33,25,0,25,13,55,12,0,Matches,2022-2023,Bundesliga
Jeffrey Gouweleeuw,nl NED,DF,Augsburg,31.0,1991.0,31.1,42,27,19,17,6,24,49,49.0,25,41,23,18,50,92,141,2,Matches,2022-2023,Bundesliga
Ryan Gravenberch,nl NED,MF,Bayern Munich,20.0,2002.0,6.4,17,8,4,10,3,7,13,53.8,6,9,1,8,9,26,10,0,Matches,2022-2023,Bundesliga
Michael Gregoritsch,at AUT,FW,Freiburg,28.0,1994.0,23.9,19,12,6,9,4,3,21,14.3,18,23,4,19,5,24,10,0,Matches,2022-2023,Bundesliga
Leo Greiml,at AUT,DF,Schalke 04,21.0,2001.0,4.0,10,5,4,5,1,5,12,41.7,7,7,3,4,3,13,16,0,Matches,2022-2023,Bundesliga
Vincenzo Grifo,it ITA,"MF,FW",Freiburg,29.0,1993.0,26.8,29,16,6,15,8,13,31,41.9,18,18,1,17,19,48,19,0,Matches,2022-2023,Bundesliga
Lennart Grill,de GER,GK,Union Berlin,23.0,1999.0,5.0,0,0,0,0,0,0,1,0.0,1,0,0,0,0,0,1,1,Matches,2022-2023,Bundesliga
Christian Groß,de GER,MF,Werder Bremen,33.0,1989.0,21.0,56,25,20,34,2,29,60,48.3,31,20,5,15,23,79,38,1,Matches,2022-2023,Bundesliga
Brajan Gruda,de GER,MF,Mainz 05,18.0,2004.0,0.0,0,0,0,0,0,0,0,,0,0,0,0,0,0,0,0,Matches,2022-2023,Bundesliga
Ilia Gruev,bg BUL,MF,Werder Bremen,22.0,2000.0,17.6,44,27,16,25,3,18,31,58.1,13,23,6,17,22,66,21,1,Matches,2022-2023,Bundesliga
Carlos Gruezo,ec ECU,MF,Augsburg,27.0,1995.0,10.7,21,12,12,9,0,9,16,56.3,7,13,4,9,10,31,15,0,Matches,2022-2023,Bundesliga
Raphaël Guerreiro,pt POR,"DF,MF",Dortmund,28.0,1993.0,25.4,36,20,13,15,8,21,34,61.8,13,21,2,19,36,72,23,0,Matches,2022-2023,Bundesliga
Josuha Guilavogui,fr FRA,"DF,MF",Wolfsburg,31.0,1990.0,13.1,18,11,7,10,1,6,17,35.3,11,19,13,6,23,41,52,0,Matches,2022-2023,Bundesliga
Serhou Guirassy,gn GUI,FW,Stuttgart,26.0,1996.0,18.3,4,1,2,2,0,1,2,50.0,1,7,2,5,0,4,14,0,Matches,2022-2023,Bundesliga
Péter Gulácsi,hu HUN,GK,RB Leipzig,32.0,1990.0,6.0,0,0,0,0,0,0,0,,0,0,0,0,0,0,2,0,Matches,2022-2023,Bundesliga
Manuel Gulde,de GER,DF,Freiburg,31.0,1991.0,7.1,14,8,10,4,0,2,4,50.0,2,5,1,4,19,33,25,0,Matches,2022-2023,Bundesliga
Robert Gumny,pl POL,DF,Augsburg,24.0,1998.0,22.4,34,24,13,15,6,11,27,40.7,16,21,7,14,26,60,62,1,Matches,2022-2023,Bundesliga
Christian Günter,de GER,"DF,MF",Freiburg,29.0,1993.0,30.5,29,21,18,9,2,13,43,30.2,30,22,4,18,16,45,41,0,Matches,2022-2023,Bundesliga
Joško Gvardiol,hr CRO,DF,RB Leipzig,20.0,2002.0,24.1,23,17,15,8,0,9,22,40.9,13,34,17,17,34,57,76,1,Matches,2022-2023,Bundesliga
Janik Haberer,de GER,MF,Union Berlin,28.0,1994.0,24.3,29,17,8,18,3,17,48,35.4,31,35,2,33,14,43,25,0,Matches,2022-2023,Bundesliga
Alexander Hack,de GER,DF,Mainz 05,28.0,1993.0,12.6,30,18,21,9,0,19,33,57.6,14,18,5,13,24,54,45,1,Matches,2022-2023,Bundesliga
André Hahn,de GER,"FW,MF",Augsburg,31.0,1990.0,4.3,9,5,4,4,1,8,12,66.7,4,9,2,7,4,13,14,0,Matches,2022-2023,Bundesliga
Amadou Haidara,ml MLI,MF,RB Leipzig,24.0,1998.0,15.9,25,11,15,10,0,13,34,38.2,21,26,6,20,26,51,20,0,Matches,2022-2023,Bundesliga
Sébastien Haller,ci CIV,FW,Dortmund,28.0,1994.0,13.6,5,4,2,1,2,0,4,0.0,4,8,0,8,1,6,10,0,Matches,2022-2023,Bundesliga
Marcel Halstenberg,de GER,DF,RB Leipzig,30.0,1991.0,17.3,40,21,20,15,5,23,41,56.1,18,22,1,21,21,61,29,0,Matches,2022-2023,Bundesliga
Andreas Hanche-Olsen,no NOR,DF,Mainz 05,25.0,1997.0,16.6,35,23,24,7,4,22,39,56.4,17,16,8,8,33,68,77,2,Matches,2022-2023,Bundesliga
Genki Haraguchi,jp JPN,MF,Stuttgart,31.0,1991.0,8.3,16,7,7,7,2,4,16,25.0,12,13,2,11,8,24,6,0,Matches,2022-2023,Bundesliga
Genki Haraguchi,jp JPN,MF,Union Berlin,31.0,1991.0,5.5,12,8,1,10,1,3,9,33.3,6,7,1,6,3,15,9,0,Matches,2022-2023,Bundesliga
Makoto Hasebe,jp JPN,DF,Eint Frankfurt,38.0,1984.0,14.5,18,12,16,2,0,7,22,31.8,15,22,9,13,17,35,45,0,Matches,2022-2023,Bundesliga
Thorgan Hazard,be BEL,"FW,DF",Dortmund,29.0,1993.0,5.2,17,6,5,11,1,12,17,70.6,5,6,0,6,5,22,5,0,Matches,2022-2023,Bundesliga
Jonas Hector,de GER,DF,Köln,32.0,1990.0,31.4,112,66,59,43,10,66,113,58.4,47,61,9,52,39,151,74,1,Matches,2022-2023,Bundesliga
Dominique Heintz,de GER,DF,Bochum,28.0,1993.0,8.8,13,9,5,7,1,6,17,35.3,11,11,7,4,12,25,34,0,Matches,2022-2023,Bundesliga
Benjamin Henrichs,de GER,"DF,MF",RB Leipzig,25.0,1997.0,24.3,73,46,41,29,3,43,66,65.2,23,48,4,44,35,108,46,0,Matches,2022-2023,Bundesliga
Lucas Hernández,fr FRA,DF,Bayern Munich,26.0,1996.0,5.3,6,4,3,3,0,5,6,83.3,1,2,1,1,5,11,7,0,Matches,2022-2023,Bundesliga
Patrick Herrmann,de GER,"FW,MF",Gladbach,31.0,1991.0,1.8,6,2,4,1,1,2,4,50.0,2,2,0,2,2,8,1,0,Matches,2022-2023,Bundesliga
Piero Hincapié,ec ECU,"DF,MF",Leverkusen,20.0,2002.0,27.3,51,34,28,20,3,25,38,65.8,13,41,20,21,31,82,83,1,Matches,2022-2023,Bundesliga
Adam Hložek,cz CZE,"FW,MF",Leverkusen,20.0,2002.0,14.3,9,4,4,3,2,3,9,33.3,6,9,2,7,6,15,9,0,Matches,2022-2023,Bundesliga
Nicolas Höfler,de GER,MF,Freiburg,32.0,1990.0,31.3,66,35,28,35,3,27,61,44.3,34,40,13,27,58,124,49,0,Matches,2022-2023,Bundesliga
Jonas Hofmann,de GER,"FW,MF",Gladbach,30.0,1992.0,29.8,31,16,17,8,6,15,52,28.8,37,36,2,34,16,47,21,0,Matches,2022-2023,Bundesliga
Philipp Hofmann,de GER,FW,Bochum,29.0,1993.0,29.2,18,11,0,13,5,5,12,41.7,7,20,8,12,6,24,48,0,Matches,2022-2023,Bundesliga
Lucas Höler,de GER,"FW,MF",Freiburg,28.0,1994.0,16.7,19,14,5,7,7,6,22,27.3,16,22,5,17,10,29,17,0,Matches,2022-2023,Bundesliga
Gerrit Holtmann,ph PHI,"FW,MF",Bochum,27.0,1995.0,10.5,14,7,6,7,1,12,21,57.1,9,15,1,14,2,16,4,0,Matches,2022-2023,Bundesliga
Jannes Horn,de GER,"DF,FW",Bochum,25.0,1997.0,0.7,2,1,1,1,0,1,1,100.0,0,1,0,1,3,5,2,0,Matches,2022-2023,Bundesliga
Lukáš Hrádecký,fi FIN,GK,Leverkusen,32.0,1989.0,33.0,0,0,0,0,0,0,0,,0,0,0,0,0,0,3,3,Matches,2022-2023,Bundesliga
Timo Hübers,de GER,DF,Köln,26.0,1996.0,28.4,43,28,35,8,0,24,52,46.2,28,27,13,14,58,101,153,0,Matches,2022-2023,Bundesliga
Callum Hudson-Odoi,eng ENG,"FW,MF",Leverkusen,21.0,2000.0,6.7,5,3,4,0,1,1,1,100.0,0,0,0,0,2,7,4,0,Matches,2022-2023,Bundesliga
Mats Hummels,de GER,DF,Dortmund,33.0,1988.0,22.4,62,34,38,22,2,32,55,58.2,23,30,16,14,33,95,100,1,Matches,2022-2023,Bundesliga
Denis Huseinbasic,ba BIH,"MF,FW",Köln,21.0,2001.0,8.8,23,9,8,11,4,10,25,40.0,15,16,2,14,4,27,5,0,Matches,2022-2023,Bundesliga
Iago,br BRA,"DF,MF",Augsburg,25.0,1997.0,17.8,34,16,20,10,4,11,29,37.9,18,18,5,13,17,51,53,0,Matches,2022-2023,Bundesliga
Arijon Ibrahimović,de GER,MF,Bayern Munich,16.0,2005.0,0.2,1,1,1,0,0,0,0,,0,0,0,0,0,1,0,0,Matches,2022-2023,Bundesliga
Marcus Ingvartsen,dk DEN,"FW,MF",Mainz 05,26.0,1996.0,14.6,4,1,0,2,2,1,10,10.0,9,9,1,8,4,8,10,0,Matches,2022-2023,Bundesliga
Ko Itakura,jp JPN,DF,Gladbach,25.0,1997.0,22.0,29,17,18,7,4,16,30,53.3,14,41,25,16,27,56,95,0,Matches,2022-2023,Bundesliga
Hiroki Ito,jp JPN,DF,Stuttgart,23.0,1999.0,28.5,40,29,24,14,2,18,35,51.4,17,38,17,21,40,80,94,0,Matches,2022-2023,Bundesliga
Andreas Ivan,ro ROU,MF,Schalke 04,27.0,1995.0,0.5,0,0,0,0,0,0,1,0.0,1,0,0,0,0,0,1,0,Matches,2022-2023,Bundesliga
Lee Jae-sung,kr KOR,MF,Mainz 05,29.0,1992.0,21.0,38,17,9,21,8,16,36,44.4,20,29,5,24,17,55,21,0,Matches,2022-2023,Bundesliga
Paul Jaeckel,de GER,DF,Union Berlin,24.0,1998.0,13.3,24,18,11,11,2,17,35,48.6,18,11,5,6,19,43,44,1,Matches,2022-2023,Bundesliga
Kristijan Jakić,hr CRO,"DF,MF",Eint Frankfurt,25.0,1997.0,16.2,33,21,19,12,2,22,41,53.7,19,32,10,22,14,47,49,1,Matches,2022-2023,Bundesliga
Saidy Janko,gm GAM,DF,Bochum,26.0,1995.0,12.6,23,15,13,8,2,12,20,60.0,8,24,10,14,11,34,33,1,Matches,2022-2023,Bundesliga
Tony Jantschke,de GER,"DF,MF",Gladbach,32.0,1990.0,1.1,2,1,1,1,0,1,1,100.0,0,5,3,2,0,2,5,0,Matches,2022-2023,Bundesliga
Fredrik Jensen,fi FIN,"FW,MF",Augsburg,24.0,1997.0,10.3,15,10,8,3,4,5,10,50.0,5,12,5,7,4,19,12,0,Matches,2022-2023,Bundesliga
Moritz Jenz,de GER,DF,Schalke 04,23.0,1999.0,10.5,14,11,8,5,1,5,8,62.5,3,16,10,6,8,22,53,1,Matches,2022-2023,Bundesliga
Stevan Jovetić,me MNE,"FW,MF",Hertha BSC,32.0,1989.0,9.9,3,2,2,1,0,1,11,9.1,10,2,1,1,2,5,10,0,Matches,2022-2023,Bundesliga
Anthony Jung,de GER,"DF,FW",Werder Bremen,30.0,1991.0,29.1,46,27,19,20,7,31,58,53.4,27,30,6,24,22,68,63,0,Matches,2022-2023,Bundesliga
Josip Juranović,hr CRO,DF,Union Berlin,26.0,1995.0,10.4,9,7,5,2,2,7,18,38.9,11,9,3,6,6,15,22,1,Matches,2022-2023,Bundesliga
Ozan Kabak,tr TUR,DF,Hoffenheim,22.0,2000.0,26.5,51,34,27,21,3,17,30,56.7,13,35,23,12,45,96,83,0,Matches,2022-2023,Bundesliga
Pavel Kadeřábek,cz CZE,DF,Hoffenheim,30.0,1992.0,18.5,26,20,10,9,7,15,23,65.2,8,12,2,10,14,40,37,1,Matches,2022-2023,Bundesliga
Florian Kainz,at AUT,"MF,FW",Köln,29.0,1992.0,26.0,21,10,7,12,2,8,26,30.8,18,27,6,21,32,53,30,1,Matches,2022-2023,Bundesliga
Sasa Kalajdzic,at AUT,FW,Stuttgart,25.0,1997.0,2.6,3,2,0,1,2,1,3,33.3,2,1,0,1,0,3,0,0,Matches,2022-2023,Bundesliga
Daichi Kamada,jp JPN,MF,Eint Frankfurt,25.0,1996.0,25.2,51,31,10,37,4,31,57,54.4,26,31,2,29,16,67,17,1,Matches,2022-2023,Bundesliga
Jakub Kamiński,pl POL,"FW,DF",Wolfsburg,20.0,2002.0,22.9,36,25,15,13,8,20,40,50.0,20,37,2,35,8,44,15,0,Matches,2022-2023,Bundesliga
Marcin Kamiński,pl POL,DF,Schalke 04,30.0,1992.0,7.0,6,4,4,0,2,2,4,50.0,2,8,7,1,9,15,28,0,Matches,2022-2023,Bundesliga
Kevin Kampl,si SVN,MF,RB Leipzig,31.0,1990.0,15.2,21,11,6,14,1,6,27,22.2,21,26,9,17,22,43,11,0,Matches,2022-2023,Bundesliga
Wilfried Kanga,ci CIV,FW,Hertha BSC,24.0,1998.0,15.7,5,4,2,1,2,2,4,50.0,2,14,3,11,2,7,13,0,Matches,2022-2023,Bundesliga
Kenan Karaman,tr TUR,FW,Schalke 04,28.0,1994.0,10.8,11,8,3,5,3,3,12,25.0,9,9,1,8,3,14,9,0,Matches,2022-2023,Bundesliga
Atakan Karazor,,MF,Stuttgart,25.0,1996.0,21.8,49,30,18,25,6,24,47,51.1,23,39,11,28,31,80,44,0,Matches,2022-2023,Bundesliga
Thomas Kastanaras,gr GRE,"FW,DF",Stuttgart,19.0,2003.0,0.8,0,0,0,0,0,0,0,,0,1,0,1,0,0,0,0,Matches,2022-2023,Bundesliga
Silas Katompa,cd COD,"FW,MF",Stuttgart,23.0,1998.0,22.1,25,17,5,14,6,6,20,30.0,14,17,2,15,8,33,1,0,Matches,2022-2023,Bundesliga
Yannik Keitel,de GER,MF,Freiburg,22.0,2000.0,7.6,11,7,4,6,1,3,5,60.0,2,6,3,3,13,24,8,0,Matches,2022-2023,Bundesliga
Marc-Oliver Kempf,de GER,DF,Hertha BSC,27.0,1995.0,30.1,44,27,29,14,1,16,22,72.7,6,42,32,10,51,95,143,0,Matches,2022-2023,Bundesliga
Jonjoe Kenny,eng ENG,DF,Hertha BSC,25.0,1997.0,24.9,46,34,27,16,3,24,42,57.1,18,38,9,29,46,92,74,0,Matches,2022-2023,Bundesliga
Rani Khedira,de GER,MF,Union Berlin,28.0,1994.0,32.0,60,33,21,32,7,25,50,50.0,25,33,10,23,40,100,33,0,Matches,2022-2023,Bundesliga
Luca Kilian,de GER,DF,Köln,22.0,1999.0,12.5,22,16,14,7,1,12,21,57.1,9,16,8,8,11,33,48,0,Matches,2022-2023,Bundesliga
Joshua Kimmich,de GER,MF,Bayern Munich,27.0,1995.0,31.2,78,49,24,46,8,38,72,52.8,34,36,7,29,41,119,39,2,Matches,2022-2023,Bundesliga
Pascal Klemens,de GER,DF,Hertha BSC,17.0,2005.0,1.0,0,0,0,0,0,0,1,0.0,1,1,0,1,1,1,3,0,Matches,2022-2023,Bundesliga
Lukas Klostermann,de GER,DF,RB Leipzig,26.0,1996.0,10.1,16,8,7,9,0,8,15,53.3,7,6,3,3,13,29,31,0,Matches,2022-2023,Bundesliga
Ansgar Knauff,de GER,DF,Eint Frankfurt,20.0,2002.0,14.3,36,25,22,11,3,15,34,44.1,19,19,1,18,15,51,26,0,Matches,2022-2023,Bundesliga
Robin Knoche,de GER,DF,Union Berlin,30.0,1992.0,31.9,45,29,29,12,4,24,47,51.1,23,35,18,17,38,83,140,0,Matches,2022-2023,Bundesliga
Gregor Kobel,ch SUI,GK,Dortmund,24.0,1997.0,27.0,0,0,0,0,0,0,1,0.0,1,1,0,1,0,0,7,2,Matches,2022-2023,Bundesliga
Dominik Kohr,de GER,MF,Mainz 05,28.0,1994.0,25.5,59,33,23,31,5,29,61,47.5,32,46,9,37,34,93,26,1,Matches,2022-2023,Bundesliga
Randal Kolo Muani,fr FRA,FW,Eint Frankfurt,23.0,1998.0,29.2,14,10,3,3,8,1,9,11.1,8,19,2,17,3,17,13,0,Matches,2022-2023,Bundesliga
Timothée Kolodziejczak,fr FRA,DF,Schalke 04,30.0,1991.0,0.3,0,0,0,0,0,0,1,0.0,1,0,0,0,1,1,1,0,Matches,2022-2023,Bundesliga
Manu Koné,fr FRA,MF,Gladbach,21.0,2001.0,29.0,74,39,37,33,4,24,47,51.1,23,44,12,32,32,106,21,0,Matches,2022-2023,Bundesliga
Odilon Kossounou,ci CIV,DF,Leverkusen,21.0,2001.0,16.9,21,14,12,7,2,8,16,50.0,8,26,11,15,24,45,58,1,Matches,2022-2023,Bundesliga
Filip Kostić,rs SRB,"DF,MF",Eint Frankfurt,29.0,1992.0,0.8,2,0,1,1,0,0,0,,0,0,0,0,1,3,0,0,Matches,2022-2023,Bundesliga
Tomáš Koubek,cz CZE,GK,Augsburg,29.0,1992.0,11.0,0,0,0,0,0,0,0,,0,0,0,0,0,0,7,0,Matches,2022-2023,Bundesliga
Soichiro Kozuki,jp JPN,"FW,MF",Schalke 04,21.0,2000.0,4.2,6,4,3,3,0,4,6,66.7,2,5,0,5,3,9,3,0,Matches,2022-2023,Bundesliga
Alex Král,cz CZE,MF,Schalke 04,24.0,1998.0,26.2,34,24,10,22,2,17,37,45.9,20,31,6,25,17,51,53,0,Matches,2022-2023,Bundesliga
Andrej Kramarić,hr CRO,"MF,FW",Hoffenheim,31.0,1991.0,26.5,5,2,2,1,2,1,11,9.1,10,14,2,12,6,11,13,0,Matches,2022-2023,Bundesliga
Christoph Kramer,de GER,MF,Gladbach,31.0,1991.0,24.7,44,33,24,15,5,22,55,40.0,33,34,2,32,17,61,40,0,Matches,2022-2023,Bundesliga
Tom Krauß,de GER,MF,Schalke 04,21.0,2001.0,27.9,112,68,39,62,11,51,100,51.0,49,39,6,33,36,148,35,0,Matches,2022-2023,Bundesliga
Max Kruse,de GER,"MF,FW",Wolfsburg,34.0,1988.0,3.0,1,1,0,1,0,0,1,0.0,1,2,1,1,0,1,1,0,Matches,2022-2023,Bundesliga
Lukas Kübler,de GER,DF,Freiburg,29.0,1992.0,18.2,37,25,24,9,4,18,30,60.0,12,25,11,14,29,66,50,0,Matches,2022-2023,Bundesliga
Pierre Kunde,cm CMR,"MF,FW",Bochum,27.0,1995.0,4.2,12,6,3,8,1,6,14,42.9,8,7,1,6,7,19,9,0,Matches,2022-2023,Bundesliga
Alou Kuol,au AUS,FW,Stuttgart,21.0,2000.0,0.1,0,0,0,0,0,0,0,,0,0,0,0,0,0,0,0,Matches,2022-2023,Bundesliga
Daniel Kyereh,gh GHA,"MF,FW",Freiburg,26.0,1996.0,6.2,6,4,2,4,0,3,6,50.0,3,4,0,4,2,8,6,0,Matches,2022-2023,Bundesliga
Maxence Lacroix,fr FRA,DF,Wolfsburg,22.0,2000.0,18.1,22,13,15,7,0,8,16,50.0,8,22,11,11,26,48,85,0,Matches,2022-2023,Bundesliga
Aïssa Laïdouni,tn TUN,MF,Union Berlin,25.0,1996.0,9.7,14,7,6,8,0,5,17,29.4,12,22,4,18,9,23,3,0,Matches,2022-2023,Bundesliga
Konrad Laimer,at AUT,MF,RB Leipzig,25.0,1997.0,16.3,60,31,23,30,7,30,54,55.6,24,31,4,27,18,78,8,0,Matches,2022-2023,Bundesliga
Stefan Lainer,at AUT,DF,Gladbach,29.0,1992.0,9.1,16,8,10,5,1,10,23,43.5,13,8,1,7,14,30,34,1,Matches,2022-2023,Bundesliga
Vassilis Lambropoulos,gr GRE,DF,Bochum,32.0,1990.0,7.0,10,8,7,3,0,6,9,66.7,3,5,3,2,13,23,41,0,Matches,2022-2023,Bundesliga
Jordan Larsson,se SWE,"FW,MF",Schalke 04,25.0,1997.0,5.1,8,5,1,7,0,2,9,22.2,7,9,0,9,4,12,3,0,Matches,2022-2023,Bundesliga
Danny Latza,de GER,MF,Schalke 04,32.0,1989.0,9.5,17,13,8,8,1,5,17,29.4,12,16,1,15,5,22,15,0,Matches,2022-2023,Bundesliga
Diogo Leite,pt POR,DF,Union Berlin,23.0,1999.0,25.0,35,20,21,14,0,21,34,61.8,13,23,14,9,26,61,99,1,Matches,2022-2023,Bundesliga
Maxim Leitsch,de GER,DF,Mainz 05,24.0,1998.0,7.4,9,7,6,3,0,4,5,80.0,1,7,4,3,18,27,26,1,Matches,2022-2023,Bundesliga
Tim Lemperle,de GER,"FW,MF",Köln,20.0,2002.0,1.5,6,4,3,1,2,3,5,60.0,2,5,0,5,1,7,4,0,Matches,2022-2023,Bundesliga
Christopher Lenz,de GER,DF,Eint Frankfurt,27.0,1994.0,14.3,29,21,17,7,5,16,37,43.2,21,16,3,13,21,50,34,0,Matches,2022-2023,Bundesliga
Jamie Leweling,de GER,"FW,MF",Union Berlin,21.0,2001.0,2.9,5,3,2,2,1,3,5,60.0,2,3,0,3,1,6,0,0,Matches,2022-2023,Bundesliga
Philipp Lienhart,at AUT,DF,Freiburg,26.0,1996.0,27.8,29,18,19,10,0,13,27,48.1,14,29,15,14,35,64,97,0,Matches,2022-2023,Bundesliga
Matthijs de Ligt,nl NED,DF,Bayern Munich,22.0,1999.0,26.7,32,23,15,16,1,15,24,62.5,9,31,20,11,23,55,85,0,Matches,2022-2023,Bundesliga
Dimitris Limnios,gr GRE,FW,Köln,24.0,1998.0,0.4,0,0,0,0,0,0,0,,0,0,0,0,1,1,0,0,Matches,2022-2023,Bundesliga
Jesper Lindstrøm,dk DEN,"MF,FW",Eint Frankfurt,22.0,2000.0,18.7,26,11,15,7,4,7,22,31.8,15,25,3,22,9,35,9,0,Matches,2022-2023,Bundesliga
Dejan Ljubicic,at AUT,"MF,FW",Köln,24.0,1997.0,19.0,25,14,7,14,4,13,40,32.5,27,20,1,19,8,33,8,1,Matches,2022-2023,Bundesliga
Anthony Losilla,fr FRA,MF,Bochum,36.0,1986.0,30.2,76,49,32,34,10,38,77,49.4,39,39,12,27,37,113,67,0,Matches,2022-2023,Bundesliga
Dodi Lukebakio,be BEL,"FW,MF",Hertha BSC,24.0,1997.0,26.6,18,11,7,8,3,6,27,22.2,21,23,5,18,13,31,17,0,Matches,2022-2023,Bundesliga
Andrey Lunyov,ru RUS,GK,Leverkusen,30.0,1991.0,1.0,0,0,0,0,0,0,0,,0,0,0,0,0,0,0,0,Matches,2022-2023,Bundesliga
Arne Maier,de GER,MF,Augsburg,23.0,1999.0,21.8,31,22,17,11,3,10,18,55.6,8,21,0,21,15,46,22,0,Matches,2022-2023,Bundesliga
Linton Maina,de GER,"FW,MF",Köln,23.0,1999.0,24.9,18,12,5,11,2,7,30,23.3,23,19,0,19,5,23,9,0,Matches,2022-2023,Bundesliga
Donyell Malen,nl NED,FW,Dortmund,23.0,1999.0,19.0,13,5,3,4,6,5,12,41.7,7,14,1,13,4,17,11,0,Matches,2022-2023,Bundesliga
Sadio Mané,sn SEN,"FW,MF",Bayern Munich,30.0,1992.0,15.8,11,5,3,3,5,1,9,11.1,8,15,2,13,0,11,4,0,Matches,2022-2023,Bundesliga
Myziane Maolida,km COM,"FW,MF",Hertha BSC,23.0,1999.0,1.1,1,1,1,0,0,1,2,50.0,1,0,0,0,0,1,1,0,Matches,2022-2023,Bundesliga
Omar Marmoush,eg EGY,FW,Wolfsburg,23.0,1999.0,16.4,16,10,8,2,6,4,16,25.0,12,21,1,20,7,23,4,0,Matches,2022-2023,Bundesliga
Eric Martel,de GER,MF,Köln,20.0,2002.0,22.4,66,41,29,30,7,30,60,50.0,30,29,9,20,33,99,49,0,Matches,2022-2023,Bundesliga
Aarón Martín,es ESP,DF,Mainz 05,25.0,1997.0,20.5,42,27,25,11,6,21,40,52.5,19,22,1,21,15,57,31,0,Matches,2022-2023,Bundesliga
Erhan Mašović,rs SRB,"DF,MF",Bochum,23.0,1998.0,24.2,50,31,28,21,1,30,51,58.8,21,30,14,16,27,77,79,0,Matches,2022-2023,Bundesliga
Henning Matriciani,de GER,DF,Schalke 04,22.0,2000.0,20.7,43,23,28,12,3,26,60,43.3,34,28,11,17,23,66,57,1,Matches,2022-2023,Bundesliga
Konstantinos Mavropanos,gr GRE,DF,Stuttgart,24.0,1997.0,25.4,50,27,32,15,3,28,38,73.7,10,39,18,21,63,113,99,0,Matches,2022-2023,Bundesliga
Philipp Max,de GER,DF,Eint Frankfurt,28.0,1993.0,7.7,12,9,4,7,1,5,16,31.3,11,10,2,8,3,15,11,0,Matches,2022-2023,Bundesliga
Eric Maxim Choupo-Moting,cm CMR,FW,Bayern Munich,33.0,1989.0,12.4,10,7,2,6,2,1,2,50.0,1,8,0,8,0,10,5,0,Matches,2022-2023,Bundesliga
Keke Maximilian Topp,de GER,FW,Schalke 04,18.0,2004.0,0.2,0,0,0,0,0,0,0,,0,0,0,0,1,1,0,0,Matches,2022-2023,Bundesliga
Ibrahim Maza,dz ALG,"MF,FW",Hertha BSC,16.0,2005.0,0.8,1,1,1,0,0,0,1,0.0,1,2,0,2,0,1,1,0,Matches,2022-2023,Bundesliga
Noussair Mazraoui,ma MAR,DF,Bayern Munich,24.0,1997.0,11.9,29,21,9,9,11,15,24,62.5,9,13,2,11,10,39,25,0,Matches,2022-2023,Bundesliga
Noah Mbamba,be BEL,MF,Leverkusen,17.0,2005.0,0.0,0,0,0,0,0,0,0,,0,0,0,0,0,0,0,0,Matches,2022-2023,Bundesliga
Jean-Manuel Mbom,de GER,MF,Werder Bremen,22.0,2000.0,0.1,0,0,0,0,0,0,1,0.0,1,0,0,0,0,0,0,0,Matches,2022-2023,Bundesliga
Nathanael Mbuku,cd COD,"MF,FW",Augsburg,20.0,2002.0,0.4,1,0,0,1,0,0,0,,0,0,0,0,0,1,0,0,Matches,2022-2023,Bundesliga
Thomas Meunier,be BEL,DF,Dortmund,30.0,1991.0,6.5,16,7,8,5,3,10,17,58.8,7,7,2,5,9,25,16,0,Matches,2022-2023,Bundesliga
Alexander Meyer,de GER,GK,Dortmund,31.0,1991.0,7.0,0,0,0,0,0,0,1,0.0,1,0,0,0,0,0,1,0,Matches,2022-2023,Bundesliga
Sven Michel,de GER,"FW,MF",Union Berlin,32.0,1990.0,5.5,9,5,1,5,3,4,8,50.0,4,5,1,4,0,9,4,0,Matches,2022-2023,Bundesliga
Enzo Millot,fr FRA,MF,Stuttgart,20.0,2002.0,9.9,23,16,9,10,4,12,19,63.2,7,20,3,17,12,35,7,0,Matches,2022-2023,Bundesliga
Maximilian Mittelstädt,de GER,"DF,MF",Hertha BSC,25.0,1997.0,9.4,39,20,31,6,2,17,39,43.6,22,13,2,11,26,65,27,0,Matches,2022-2023,Bundesliga
Anthony Modeste,fr FRA,FW,Dortmund,34.0,1988.0,9.0,4,4,2,0,2,2,5,40.0,3,7,0,7,2,6,22,0,Matches,2022-2023,Bundesliga
Tobias Mohr,de GER,"DF,MF",Schalke 04,26.0,1995.0,9.3,8,5,3,5,0,2,7,28.6,5,14,5,9,8,16,19,0,Matches,2022-2023,Bundesliga
Clinton Mola,eng ENG,DF,Stuttgart,21.0,2001.0,0.2,3,1,2,1,0,1,1,100.0,0,1,1,0,1,4,2,0,Matches,2022-2023,Bundesliga
Florent Mollet,fr FRA,MF,Schalke 04,30.0,1991.0,4.6,4,1,0,4,0,2,7,28.6,5,7,1,6,1,5,1,0,Matches,2022-2023,Bundesliga
Youssoufa Moukoko,de GER,FW,Dortmund,17.0,2004.0,12.7,13,7,3,6,4,3,6,50.0,3,9,0,9,2,15,1,0,Matches,2022-2023,Bundesliga
Florian Müller,de GER,GK,Stuttgart,24.0,1997.0,19.0,0,0,0,0,0,0,0,,0,0,0,0,0,0,7,4,Matches,2022-2023,Bundesliga
Thomas Müller,de GER,"FW,MF",Bayern Munich,32.0,1989.0,18.5,21,12,5,9,7,6,16,37.5,10,19,3,16,4,25,16,0,Matches,2022-2023,Bundesliga
Jamal Musiala,de GER,"MF,FW",Bayern Munich,19.0,2003.0,24.4,34,23,9,16,9,13,35,37.1,22,30,3,27,19,53,3,0,Matches,2022-2023,Bundesliga
Marlon Mustapha,at AUT,"FW,MF",Mainz 05,21.0,2001.0,0.8,2,2,0,2,0,0,0,,0,4,0,4,0,2,0,0,Matches,2022-2023,Bundesliga
Obite N'Dicka,ci CIV,DF,Eint Frankfurt,22.0,1999.0,29.9,25,18,10,11,4,18,32,56.3,14,47,19,28,31,56,150,0,Matches,2022-2023,Bundesliga
Nathan N'Goumou,cm CMR,FW,Gladbach,22.0,2000.0,7.7,11,5,5,5,1,7,13,53.8,6,9,0,9,1,12,4,0,Matches,2022-2023,Bundesliga
Stanley N'Soki,fr FRA,DF,Hoffenheim,23.0,1999.0,14.3,22,13,14,7,1,12,22,54.5,10,22,5,17,24,46,34,0,Matches,2022-2023,Bundesliga
Nikolas Nartey,dk DEN,"DF,MF",Stuttgart,22.0,2000.0,5.3,11,6,7,3,1,5,9,55.6,4,9,0,9,4,15,12,0,Matches,2022-2023,Bundesliga
Luca Netz,de GER,DF,Gladbach,19.0,2003.0,7.8,25,13,19,3,3,19,32,59.4,13,5,1,4,6,31,27,0,Matches,2022-2023,Bundesliga
Manuel Neuer,de GER,GK,Bayern Munich,36.0,1986.0,12.0,0,0,0,0,0,0,0,,0,0,0,0,0,0,4,1,Matches,2022-2023,Bundesliga
Florian Neuhaus,de GER,MF,Gladbach,25.0,1997.0,15.6,19,9,9,5,5,8,27,29.6,19,20,3,17,12,31,5,0,Matches,2022-2023,Bundesliga
Jessic Ngankam,de GER,"FW,MF",Hertha BSC,22.0,2000.0,9.2,14,9,7,4,3,6,14,42.9,8,6,1,5,1,15,4,0,Matches,2022-2023,Bundesliga
Florian Niederlechner,de GER,"FW,MF",Augsburg,31.0,1990.0,10.1,10,5,5,4,1,4,7,57.1,3,16,2,14,1,11,9,0,Matches,2022-2023,Bundesliga
Florian Niederlechner,de GER,FW,Hertha BSC,31.0,1990.0,8.7,9,7,2,4,3,2,8,25.0,6,7,0,7,3,12,10,0,Matches,2022-2023,Bundesliga
Justin Njinmah,de GER,FW,Dortmund,21.0,2000.0,0.2,0,0,0,0,0,0,0,,0,0,0,0,0,0,0,0,Matches,2022-2023,Bundesliga
Christopher Nkunku,fr FRA,"FW,MF",RB Leipzig,24.0,1997.0,21.1,6,4,2,1,3,1,6,16.7,5,8,3,5,8,14,11,0,Matches,2022-2023,Bundesliga
Felix Nmecha,de GER,MF,Wolfsburg,21.0,2000.0,20.4,41,24,11,23,7,16,34,47.1,18,26,10,16,25,66,31,0,Matches,2022-2023,Bundesliga
Lukas Nmecha,de GER,FW,Wolfsburg,23.0,1998.0,10.0,5,3,0,2,3,3,3,100.0,0,5,1,4,3,8,4,0,Matches,2022-2023,Bundesliga
Hugo Novoa,es ESP,"DF,FW",RB Leipzig,19.0,2003.0,2.0,8,2,1,3,4,4,7,57.1,3,4,0,4,1,9,0,0,Matches,2022-2023,Bundesliga
Ørjan Nyland,no NOR,GK,RB Leipzig,31.0,1990.0,2.0,0,0,0,0,0,0,0,,0,0,0,0,0,0,0,0,Matches,2022-2023,Bundesliga
Tim Oermann,de GER,DF,Bochum,18.0,2003.0,2.2,2,1,2,0,0,1,1,100.0,0,3,2,1,1,3,8,1,Matches,2022-2023,Bundesliga
Finn Ole Becker,de GER,MF,Hoffenheim,22.0,2000.0,5.7,10,2,4,6,0,4,7,57.1,3,4,0,4,5,15,8,0,Matches,2022-2023,Bundesliga
Mathias Olesen,lu LUX,MF,Köln,21.0,2001.0,5.3,10,5,4,4,2,5,8,62.5,3,6,1,5,2,12,3,0,Matches,2022-2023,Bundesliga
Dani Olmo,es ESP,"MF,FW",RB Leipzig,24.0,1998.0,14.2,15,9,1,10,4,6,14,42.9,8,15,0,15,6,21,6,0,Matches,2022-2023,Bundesliga
Jan Olschowsky,de GER,GK,Gladbach,20.0,2001.0,4.0,0,0,0,0,0,0,1,0.0,1,1,0,1,0,0,1,0,Matches,2022-2023,Bundesliga
Jonas Omlin,ch SUI,GK,Gladbach,28.0,1994.0,14.3,1,1,1,0,0,1,3,33.3,2,1,0,1,0,1,9,1,Matches,2022-2023,Bundesliga
Karim Onisiwo,at AUT,"FW,MF",Mainz 05,30.0,1992.0,28.2,19,12,3,10,6,4,21,19.0,17,19,0,19,2,21,7,0,Matches,2022-2023,Bundesliga
Willi Orban,hu HUN,DF,RB Leipzig,29.0,1992.0,32.8,51,30,33,18,0,26,43,60.5,17,42,24,18,39,90,129,1,Matches,2022-2023,Bundesliga
Ivan Ordets,ua UKR,DF,Bochum,30.0,1992.0,27.2,31,19,21,9,1,16,28,57.1,12,34,17,17,57,88,139,0,Matches,2022-2023,Bundesliga
Jordi Osei-Tutu,eng ENG,"DF,FW",Bochum,23.0,1998.0,8.3,23,18,13,5,5,12,23,52.2,11,12,5,7,10,33,8,0,Matches,2022-2023,Bundesliga
Patrick Osterhage,de GER,MF,Bochum,22.0,2000.0,11.4,20,17,8,10,2,11,16,68.8,5,17,6,11,12,32,25,0,Matches,2022-2023,Bundesliga
Paulo Otávio,br BRA,DF,Wolfsburg,27.0,1994.0,22.7,72,46,46,17,9,44,66,66.7,22,42,6,36,30,102,70,1,Matches,2022-2023,Bundesliga
Thomas Ouwejan,nl NED,DF,Schalke 04,25.0,1996.0,10.0,20,8,13,5,2,6,10,60.0,4,17,4,13,13,33,27,0,Matches,2022-2023,Bundesliga
Reece Oxford,eng ENG,DF,Augsburg,23.0,1998.0,1.0,1,1,1,0,0,0,0,,0,4,3,1,1,2,5,0,Matches,2022-2023,Bundesliga
Salih Özcan,tr TUR,MF,Dortmund,24.0,1998.0,17.5,31,18,10,16,5,16,39,41.0,23,24,2,22,28,59,19,1,Matches,2022-2023,Bundesliga
Levin Öztunalı,de GER,MF,Union Berlin,26.0,1996.0,0.1,0,0,0,0,0,0,1,0.0,1,0,0,0,0,0,0,0,Matches,2022-2023,Bundesliga
Exequiel Palacios,ar ARG,MF,Leverkusen,23.0,1998.0,18.4,59,36,20,33,6,29,48,60.4,19,29,2,27,33,92,28,0,Matches,2022-2023,Bundesliga
Miloš Pantović,rs SRB,MF,Union Berlin,26.0,1996.0,2.3,4,2,4,0,0,3,5,60.0,2,3,0,3,0,4,5,0,Matches,2022-2023,Bundesliga
Antonios Papadopoulos,de GER,DF,Dortmund,22.0,1999.0,0.1,0,0,0,0,0,0,0,,0,0,0,0,1,1,0,0,Matches,2022-2023,Bundesliga
Kevin Paredes,us USA,"FW,MF",Wolfsburg,19.0,2003.0,5.9,13,9,6,3,4,9,12,75.0,3,7,0,7,6,19,8,0,Matches,2022-2023,Bundesliga
Marco Pašalić,hr CRO,MF,Dortmund,21.0,2000.0,0.1,0,0,0,0,0,0,0,,0,0,0,0,0,0,0,0,Matches,2022-2023,Bundesliga
Felix Passlack,de GER,DF,Dortmund,24.0,1998.0,0.7,4,3,0,4,0,1,1,100.0,0,1,1,0,0,4,1,0,Matches,2022-2023,Bundesliga
Paulinho,br BRA,FW,Leverkusen,22.0,2000.0,0.9,0,0,0,0,0,0,0,,0,1,0,1,0,0,2,0,Matches,2022-2023,Bundesliga
Benjamin Pavard,fr FRA,DF,Bayern Munich,26.0,1996.0,27.0,70,41,36,26,8,36,48,75.0,12,35,16,19,44,114,83,0,Matches,2022-2023,Bundesliga
Jiří Pavlenka,cz CZE,GK,Werder Bremen,30.0,1992.0,32.3,1,0,1,0,0,1,5,20.0,4,1,0,1,3,4,21,1,Matches,2022-2023,Bundesliga
Kristian Pedersen,dk DEN,DF,Köln,27.0,1994.0,3.1,5,4,4,1,0,0,2,0.0,2,3,0,3,6,11,17,0,Matches,2022-2023,Bundesliga
Mads Pedersen,dk DEN,"DF,MF",Augsburg,25.0,1996.0,20.4,44,23,31,11,2,22,33,66.7,11,32,9,23,20,64,41,1,Matches,2022-2023,Bundesliga
Jordan Pefok,us USA,FW,Union Berlin,26.0,1996.0,15.1,15,7,3,4,8,2,17,11.8,15,17,5,12,4,19,15,0,Matches,2022-2023,Bundesliga
Dženan Pejčinović,de GER,FW,Wolfsburg,17.0,2005.0,0.1,0,0,0,0,0,0,0,,0,0,0,0,0,0,0,0,Matches,2022-2023,Bundesliga
Peter Pekarík,sk SVK,DF,Hertha BSC,35.0,1986.0,2.3,4,3,4,0,0,4,6,66.7,2,6,2,4,4,8,7,0,Matches,2022-2023,Bundesliga
Luca Pellegrini,it ITA,DF,Eint Frankfurt,23.0,1999.0,6.2,13,8,10,3,0,8,8,100.0,0,8,2,6,7,20,11,1,Matches,2022-2023,Bundesliga
Ricardo Pepi,us USA,FW,Augsburg,19.0,2003.0,1.1,1,1,1,0,0,1,1,100.0,0,1,0,1,0,1,1,0,Matches,2022-2023,Bundesliga
Juan Perea,co COL,FW,Stuttgart,22.0,2000.0,4.6,5,4,0,2,3,2,4,50.0,2,2,1,1,1,6,3,0,Matches,2022-2023,Bundesliga
Nils Petersen,de GER,FW,Freiburg,33.0,1988.0,3.1,6,4,0,3,3,2,5,40.0,3,11,2,9,1,7,6,0,Matches,2022-2023,Bundesliga
Lukas Petkov,bg BUL,"MF,FW",Augsburg,21.0,2000.0,1.6,5,1,4,1,0,2,3,66.7,1,4,1,3,1,6,0,0,Matches,2022-2023,Bundesliga
Luca Pfeiffer,de GER,FW,Stuttgart,25.0,1996.0,7.8,1,1,1,0,0,0,1,0.0,1,4,0,4,1,2,5,0,Matches,2022-2023,Bundesliga
Maximilian Philipp,de GER,FW,Wolfsburg,28.0,1994.0,1.3,2,1,1,1,0,1,1,100.0,0,1,0,1,0,2,0,0,Matches,2022-2023,Bundesliga
Maximilian Philipp,de GER,"FW,MF",Werder Bremen,28.0,1994.0,4.9,6,5,3,2,1,1,9,11.1,8,7,1,6,3,9,4,0,Matches,2022-2023,Bundesliga
Amos Pieper,de GER,DF,Werder Bremen,24.0,1998.0,21.7,46,28,25,19,2,24,40,60.0,16,23,11,12,30,76,94,1,Matches,2022-2023,Bundesliga
Marvin Plattenhardt,de GER,DF,Hertha BSC,30.0,1992.0,26.7,43,33,24,15,4,29,47,61.7,18,25,11,14,15,58,82,0,Matches,2022-2023,Bundesliga
Alassane Pléa,fr FRA,FW,Gladbach,29.0,1993.0,19.7,16,8,5,7,4,8,26,30.8,18,23,3,20,12,28,14,0,Matches,2022-2023,Bundesliga
Joel Pohjanpalo,fi FIN,"FW,MF",Leverkusen,27.0,1994.0,0.0,0,0,0,0,0,0,0,,0,0,0,0,0,0,0,0,Matches,2022-2023,Bundesliga
Sebastian Polter,de GER,FW,Schalke 04,31.0,1991.0,7.0,4,3,0,4,0,1,4,25.0,3,4,0,4,1,5,6,0,Matches,2022-2023,Bundesliga
Stefan Posch,at AUT,DF,Hoffenheim,25.0,1997.0,0.2,0,0,0,0,0,0,0,,0,0,0,0,0,0,0,0,Matches,2022-2023,Bundesliga
Yussuf Poulsen,dk DEN,FW,RB Leipzig,28.0,1994.0,4.6,6,4,1,4,1,2,5,40.0,3,3,1,2,0,6,5,0,Matches,2022-2023,Bundesliga
Grischa Prömel,de GER,MF,Hoffenheim,27.0,1995.0,16.2,27,19,14,11,2,9,25,36.0,16,22,4,18,8,35,23,0,Matches,2022-2023,Bundesliga
Tymoteusz Puchacz,pl POL,DF,Union Berlin,23.0,1999.0,0.6,1,0,1,0,0,0,0,,0,0,0,0,0,1,1,0,Matches,2022-2023,Bundesliga
Eduardo Quaresma,pt POR,DF,Hoffenheim,20.0,2002.0,1.0,5,3,3,2,0,1,3,33.3,2,3,2,1,0,5,3,0,Matches,2022-2023,Bundesliga
Joshua Quarshie,de GER,MF,Hoffenheim,18.0,2004.0,0.0,0,0,0,0,0,0,0,,0,0,0,0,0,0,0,0,Matches,2022-2023,Bundesliga
Diant Ramaj,de GER,GK,Eint Frankfurt,20.0,2001.0,1.0,0,0,0,0,0,0,0,,0,0,0,0,0,0,1,0,Matches,2022-2023,Bundesliga
Nicolai Rapp,de GER,"MF,DF",Werder Bremen,25.0,1996.0,0.8,3,1,3,0,0,0,3,0.0,3,0,0,0,0,3,1,0,Matches,2022-2023,Bundesliga
David Raum,de GER,"DF,MF",RB Leipzig,24.0,1998.0,18.7,39,25,23,12,4,17,29,58.6,12,24,6,18,16,55,26,1,Matches,2022-2023,Bundesliga
Rocco Reitz,de GER,MF,Gladbach,20.0,2002.0,0.0,0,0,0,0,0,0,0,,0,0,0,0,0,0,0,0,Matches,2022-2023,Bundesliga
Marco Reus,de GER,"MF,FW",Dortmund,33.0,1989.0,15.0,30,17,12,14,4,7,24,29.2,17,12,4,8,8,38,8,0,Matches,2022-2023,Bundesliga
Elvis Rexhbeçaj,xk KVX,MF,Augsburg,24.0,1997.0,28.0,51,30,18,24,9,29,59,49.2,30,39,12,27,17,68,40,0,Matches,2022-2023,Bundesliga
Gio Reyna,us USA,"FW,MF",Dortmund,19.0,2002.0,6.9,14,7,2,5,7,5,10,50.0,5,8,2,6,3,17,5,0,Matches,2022-2023,Bundesliga
Marco Richter,de GER,"MF,FW",Hertha BSC,24.0,1997.0,20.4,43,23,18,17,8,19,48,39.6,29,29,2,27,24,67,25,0,Matches,2022-2023,Bundesliga
Manuel Riemann,de GER,GK,Bochum,33.0,1988.0,34.0,3,2,3,0,0,3,5,60.0,2,1,0,1,5,8,23,7,Matches,2022-2023,Bundesliga
Sebastian Rode,de GER,MF,Eint Frankfurt,31.0,1990.0,15.7,38,24,7,28,3,14,45,31.1,31,18,2,16,16,54,12,0,Matches,2022-2023,Bundesliga
Agustín Rogel,uy URU,DF,Hertha BSC,24.0,1997.0,15.8,18,9,13,5,0,11,17,64.7,6,15,8,7,11,29,74,1,Matches,2022-2023,Bundesliga
Merlin Röhl,de GER,"MF,FW",Freiburg,20.0,2002.0,0.6,1,0,1,0,0,0,0,,0,0,0,0,0,1,1,0,Matches,2022-2023,Bundesliga
Tony Rölke,de GER,FW,Hertha BSC,19.0,2003.0,0.2,0,0,0,0,0,0,0,,0,1,0,1,0,0,1,0,Matches,2022-2023,Bundesliga
Tom Rothe,de GER,DF,Dortmund,17.0,2004.0,0.3,1,1,0,1,0,1,1,100.0,0,0,0,0,1,2,2,0,Matches,2022-2023,Bundesliga
Jérôme Roussillon,fr FRA,"MF,DF",Wolfsburg,29.0,1993.0,0.2,0,0,0,0,0,0,0,,0,0,0,0,0,0,0,0,Matches,2022-2023,Bundesliga
Jérôme Roussillon,fr FRA,DF,Union Berlin,29.0,1993.0,10.6,16,9,6,8,2,8,12,66.7,4,7,2,5,4,20,22,0,Matches,2022-2023,Bundesliga
Sebastian Rudy,de GER,MF,Hoffenheim,32.0,1990.0,8.8,26,12,10,16,0,13,27,48.1,14,27,7,20,11,37,13,0,Matches,2022-2023,Bundesliga
Georginio Rutter,fr FRA,FW,Hoffenheim,20.0,2002.0,11.2,7,4,1,4,2,1,3,33.3,2,10,2,8,5,12,6,0,Matches,2022-2023,Bundesliga
Julian Ryerson,no NOR,DF,Union Berlin,24.0,1997.0,11.5,28,17,17,10,1,15,25,60.0,10,15,3,12,12,40,19,0,Matches,2022-2023,Bundesliga
Julian Ryerson,no NOR,DF,Dortmund,24.0,1997.0,15.7,27,15,17,7,3,19,37,51.4,18,13,2,11,8,35,28,0,Matches,2022-2023,Bundesliga
Frederik Rønnow,dk DEN,GK,Union Berlin,29.0,1992.0,29.0,0,0,0,0,0,0,5,0.0,5,0,0,0,0,0,9,1,Matches,2022-2023,Bundesliga
Marcel Sabitzer,at AUT,MF,Bayern Munich,28.0,1994.0,7.0,27,14,11,10,6,10,17,58.8,7,3,0,3,10,37,9,0,Matches,2022-2023,Bundesliga
Dikeni-Rafid Salifou,tg TOG,MF,Werder Bremen,19.0,2003.0,0.0,0,0,0,0,0,0,0,,0,0,0,0,0,0,0,0,Matches,2022-2023,Bundesliga
Roland Sallai,hu HUN,"MF,FW",Freiburg,25.0,1997.0,11.1,11,8,4,3,4,4,10,40.0,6,7,1,6,2,13,11,0,Matches,2022-2023,Bundesliga
Diadie Samassékou,ml MLI,"MF,FW",Hoffenheim,26.0,1996.0,0.4,1,0,0,1,0,0,1,0.0,1,0,0,0,0,1,0,0,Matches,2022-2023,Bundesliga
Leroy Sané,de GER,"MF,FW",Bayern Munich,26.0,1996.0,22.3,38,30,11,19,8,18,36,50.0,18,11,1,10,3,41,1,2,Matches,2022-2023,Bundesliga
Sidi Sané,de GER,FW,Schalke 04,19.0,2003.0,0.3,1,1,1,0,0,1,1,100.0,0,0,0,0,0,1,0,0,Matches,2022-2023,Bundesliga
Bouna Sarr,sn SEN,FW,Bayern Munich,30.0,1992.0,0.0,0,0,0,0,0,0,0,,0,0,0,0,0,0,0,0,Matches,2022-2023,Bundesliga
Joe Scally,us USA,DF,Gladbach,19.0,2002.0,24.5,31,20,25,5,1,24,31,77.4,7,17,6,11,8,39,61,0,Matches,2022-2023,Bundesliga
Kevin Schade,de GER,"FW,MF",Freiburg,20.0,2001.0,2.0,6,4,3,2,1,3,5,60.0,2,0,0,0,0,6,2,0,Matches,2022-2023,Bundesliga
András Schäfer,hu HUN,MF,Union Berlin,23.0,1999.0,9.6,21,9,7,12,2,6,14,42.9,8,12,2,10,4,25,11,0,Matches,2022-2023,Bundesliga
Derry Scherhant,de GER,"FW,MF",Hertha BSC,19.0,2002.0,3.2,7,6,3,3,1,4,8,50.0,4,3,0,3,0,7,5,0,Matches,2022-2023,Bundesliga
Patrik Schick,cz CZE,FW,Leverkusen,26.0,1996.0,10.5,0,0,0,0,0,0,1,0.0,1,4,1,3,1,1,7,0,Matches,2022-2023,Bundesliga
Kingsley Schindler,gh GHA,"DF,MF",Köln,29.0,1993.0,12.1,23,12,13,8,2,18,28,64.3,10,14,2,12,15,38,24,0,Matches,2022-2023,Bundesliga
Xaver Schlager,at AUT,MF,RB Leipzig,24.0,1997.0,16.7,41,24,13,26,2,20,43,46.5,23,19,2,17,17,58,23,0,Matches,2022-2023,Bundesliga
Keven Schlotterbeck,de GER,DF,Freiburg,25.0,1997.0,0.2,0,0,0,0,0,0,0,,0,1,1,0,2,2,2,0,Matches,2022-2023,Bundesliga
Keven Schlotterbeck,de GER,DF,Bochum,25.0,1997.0,8.2,17,9,12,5,0,9,11,81.8,2,11,5,6,14,31,49,0,Matches,2022-2023,Bundesliga
Nico Schlotterbeck,de GER,DF,Dortmund,22.0,1999.0,25.0,59,34,34,24,1,37,53,69.8,16,38,21,17,32,91,71,1,Matches,2022-2023,Bundesliga
Jonathan Schmid,fr FRA,DF,Freiburg,32.0,1990.0,0.5,1,1,1,0,0,0,0,,0,1,0,1,1,2,1,1,Matches,2022-2023,Bundesliga
Romano Schmid,at AUT,"MF,FW",Werder Bremen,22.0,2000.0,16.9,24,15,5,13,6,10,22,45.5,12,21,3,18,7,31,12,0,Matches,2022-2023,Bundesliga
Kenneth Schmidt,de GER,DF,Freiburg,20.0,2002.0,2.8,6,3,4,2,0,5,6,83.3,1,4,2,2,0,6,2,0,Matches,2022-2023,Bundesliga
Niklas Schmidt,de GER,MF,Werder Bremen,24.0,1998.0,12.1,25,10,12,11,2,13,28,46.4,15,10,0,10,5,30,12,0,Matches,2022-2023,Bundesliga
Benno Schmitz,de GER,DF,Köln,27.0,1994.0,26.9,64,42,31,28,5,42,82,51.2,40,34,4,30,26,90,57,0,Matches,2022-2023,Bundesliga
Marvin Schwäbe,de GER,GK,Köln,27.0,1995.0,34.0,1,0,1,0,0,1,1,100.0,0,0,0,0,2,3,8,2,Matches,2022-2023,Bundesliga
Alexander Schwolow,de GER,GK,Schalke 04,30.0,1992.0,22.6,0,0,0,0,0,0,2,0.0,2,0,0,0,1,1,6,3,Matches,2022-2023,Bundesliga
Paul Seguin,de GER,MF,Union Berlin,27.0,1995.0,7.7,17,8,9,4,4,8,18,44.4,10,6,0,6,6,23,7,0,Matches,2022-2023,Bundesliga
Davie Selke,de GER,FW,Hertha BSC,27.0,1995.0,3.1,2,1,1,1,0,0,1,0.0,1,3,1,2,1,3,5,0,Matches,2022-2023,Bundesliga
Davie Selke,de GER,FW,Köln,27.0,1995.0,9.7,0,0,0,0,0,0,4,0.0,4,4,1,3,0,0,11,0,Matches,2022-2023,Bundesliga
Suat Serdar,de GER,MF,Hertha BSC,25.0,1997.0,22.5,51,23,14,30,7,20,41,48.8,21,48,12,36,29,80,24,0,Matches,2022-2023,Bundesliga
Eniss Shabani,al ALB,MF,Mainz 05,19.0,2003.0,0.1,0,0,0,0,0,0,0,,0,0,0,0,0,0,0,0,Matches,2022-2023,Bundesliga
Kiliann Sildillia,fr FRA,"DF,MF",Freiburg,20.0,2002.0,22.0,33,20,10,19,4,18,30,60.0,12,24,9,15,21,54,47,1,Matches,2022-2023,Bundesliga
André Silva,pt POR,FW,RB Leipzig,26.0,1995.0,19.3,12,6,2,5,5,3,8,37.5,5,11,1,10,3,15,3,0,Matches,2022-2023,Bundesliga
Mohamed Simakan,fr FRA,DF,RB Leipzig,22.0,2000.0,16.2,21,14,12,5,4,14,21,66.7,7,21,4,17,16,37,55,0,Matches,2022-2023,Bundesliga
Daley Sinkgraven,nl NED,"DF,MF",Leverkusen,27.0,1995.0,3.8,10,7,7,3,0,7,9,77.8,2,8,4,4,5,15,7,0,Matches,2022-2023,Bundesliga
Tobias Sippel,de GER,GK,Gladbach,34.0,1988.0,5.7,0,0,0,0,0,0,0,,0,0,0,0,0,0,1,1,Matches,2022-2023,Bundesliga
Hugo Siquet,be BEL,DF,Freiburg,20.0,2002.0,0.2,2,2,2,0,0,2,2,100.0,0,1,0,1,0,2,0,0,Matches,2022-2023,Bundesliga
Tim Skarke,de GER,"DF,MF",Union Berlin,25.0,1996.0,0.6,1,1,0,0,1,0,0,,0,1,0,1,0,1,0,0,Matches,2022-2023,Bundesliga
Tim Skarke,de GER,"FW,MF",Schalke 04,25.0,1996.0,4.9,13,7,3,8,2,8,11,72.7,3,5,0,5,0,13,4,0,Matches,2022-2023,Bundesliga
Ellyes Skhiri,tn TUN,MF,Köln,27.0,1995.0,31.7,79,44,29,42,8,26,66,39.4,40,52,12,40,56,135,48,0,Matches,2022-2023,Bundesliga
Robert Skov,dk DEN,DF,Hoffenheim,26.0,1996.0,15.0,22,11,14,7,1,10,26,38.5,16,22,8,14,8,30,20,2,Matches,2022-2023,Bundesliga
Hrvoje Smolčić,hr CRO,DF,Eint Frankfurt,21.0,2000.0,5.2,8,7,6,2,0,5,10,50.0,5,11,4,7,6,14,38,0,Matches,2022-2023,Bundesliga
Danilo Soares,br BRA,DF,Bochum,30.0,1991.0,19.6,72,46,42,23,7,43,72,59.7,29,29,6,23,30,102,56,1,Matches,2022-2023,Bundesliga
Nikola Soldo,hr CRO,DF,Köln,21.0,2001.0,6.6,15,9,8,7,0,7,11,63.6,4,7,6,1,7,22,28,0,Matches,2022-2023,Bundesliga
Yann Sommer,ch SUI,GK,Gladbach,33.0,1988.0,10.0,1,0,1,0,0,1,1,100.0,0,0,0,0,0,1,8,0,Matches,2022-2023,Bundesliga
Yann Sommer,ch SUI,GK,Bayern Munich,33.0,1988.0,19.0,0,0,0,0,0,0,0,,0,0,0,0,1,1,5,1,Matches,2022-2023,Bundesliga
Borna Sosa,hr CRO,DF,Stuttgart,24.0,1998.0,21.7,27,21,18,8,1,21,32,65.6,11,20,5,15,19,46,37,0,Matches,2022-2023,Bundesliga
Djibril Sow,ch SUI,MF,Eint Frankfurt,25.0,1997.0,29.4,41,25,13,25,3,22,44,50.0,22,22,4,18,28,69,23,0,Matches,2022-2023,Bundesliga
Anton Stach,de GER,MF,Mainz 05,23.0,1998.0,23.0,27,21,10,15,2,16,38,42.1,22,28,2,26,41,68,25,0,Matches,2022-2023,Bundesliga
Kostas Stafylidis,gr GRE,"DF,MF",Bochum,28.0,1993.0,11.6,27,16,13,8,6,10,24,41.7,14,21,8,13,20,47,31,1,Matches,2022-2023,Bundesliga
Jens Stage,dk DEN,MF,Werder Bremen,25.0,1996.0,20.6,34,17,15,18,1,10,37,27.0,27,34,11,23,16,50,37,0,Matches,2022-2023,Bundesliga
Veit Stange,de GER,MF,Hertha BSC,18.0,2004.0,0.1,1,1,1,0,0,1,1,100.0,0,0,0,0,0,1,0,0,Matches,2022-2023,Bundesliga
Josip Stanišić,hr CRO,DF,Bayern Munich,22.0,2000.0,6.4,19,11,14,2,3,12,17,70.6,5,9,1,8,7,26,11,3,Matches,2022-2023,Bundesliga
Niklas Stark,de GER,DF,Werder Bremen,27.0,1995.0,23.1,56,36,29,24,3,27,42,64.3,15,24,13,11,37,93,110,0,Matches,2022-2023,Bundesliga
Pascal Stenzel,de GER,DF,Stuttgart,26.0,1996.0,3.7,12,8,8,4,0,5,9,55.6,4,9,2,7,5,17,6,0,Matches,2022-2023,Bundesliga
Angelo Stiller,de GER,MF,Hoffenheim,21.0,2001.0,7.8,26,12,9,13,4,8,12,66.7,4,12,2,10,10,36,14,0,Matches,2022-2023,Bundesliga
Lars Stindl,de GER,"FW,MF",Gladbach,33.0,1988.0,19.3,24,14,4,17,3,10,28,35.7,18,24,5,19,11,35,19,0,Matches,2022-2023,Bundesliga
Kevin Stöger,at AUT,MF,Bochum,28.0,1993.0,28.9,84,45,38,32,14,31,94,33.0,63,27,4,23,26,110,21,1,Matches,2022-2023,Bundesliga
Niklas Süle,de GER,DF,Dortmund,26.0,1995.0,23.5,25,19,18,3,4,14,23,60.9,9,28,19,9,17,42,53,0,Matches,2022-2023,Bundesliga
Ivan Šunjić,ba BIH,MF,Hertha BSC,25.0,1996.0,11.0,38,20,16,21,1,16,24,66.7,8,17,5,12,13,51,19,1,Matches,2022-2023,Bundesliga
Mattias Svanberg,se SWE,"MF,FW",Wolfsburg,23.0,1999.0,20.4,25,16,8,16,1,10,30,33.3,20,27,5,22,21,46,25,1,Matches,2022-2023,Bundesliga
Dominik Szoboszlai,hu HUN,"MF,FW",RB Leipzig,21.0,2000.0,27.2,45,28,12,20,13,17,42,40.5,25,43,2,41,17,62,27,0,Matches,2022-2023,Bundesliga
Alexander Sørloth,no NOR,FW,RB Leipzig,26.0,1995.0,0.1,0,0,0,0,0,0,0,,0,0,0,0,0,0,0,0,Matches,2022-2023,Bundesliga
Jonathan Tah,de GER,DF,Leverkusen,26.0,1996.0,27.6,25,12,21,4,0,12,18,66.7,6,30,18,12,40,65,118,0,Matches,2022-2023,Bundesliga
Edmond Tapsoba,bf BFA,DF,Leverkusen,23.0,1999.0,31.9,51,30,35,12,4,30,42,71.4,12,40,17,23,36,87,109,1,Matches,2022-2023,Bundesliga
Niklas Tauer,de GER,"DF,MF",Mainz 05,21.0,2001.0,1.0,2,1,2,0,0,1,3,33.3,2,2,1,1,2,4,4,0,Matches,2022-2023,Bundesliga
Mathys Tel,fr FRA,FW,Bayern Munich,17.0,2005.0,4.6,2,2,0,1,1,1,1,100.0,0,5,1,4,0,2,2,0,Matches,2022-2023,Bundesliga
Semir Telalovic,de GER,"MF,FW",Gladbach,22.0,1999.0,0.1,0,0,0,0,0,0,0,,0,0,0,0,0,0,0,0,Matches,2022-2023,Bundesliga
Simon Terodde,de GER,FW,Schalke 04,34.0,1988.0,20.3,15,8,4,7,4,3,14,21.4,11,6,2,4,6,21,9,0,Matches,2022-2023,Bundesliga
Malick Thiaw,de GER,DF,Schalke 04,20.0,2001.0,3.0,3,1,2,1,0,1,2,50.0,1,4,3,1,9,12,24,1,Matches,2022-2023,Bundesliga
Jan Thielmann,de GER,FW,Köln,20.0,2002.0,9.7,9,8,3,4,2,2,11,18.2,9,16,3,13,9,18,7,0,Matches,2022-2023,Bundesliga
Morten Thorsby,no NOR,MF,Union Berlin,26.0,1996.0,9.3,22,10,9,11,2,13,21,61.9,8,11,5,6,3,25,20,0,Matches,2022-2023,Bundesliga
Marcus Thuram,fr FRA,FW,Gladbach,24.0,1997.0,27.9,14,7,3,6,5,6,13,46.2,7,20,3,17,6,20,22,0,Matches,2022-2023,Bundesliga
Steffen Tigges,de GER,FW,Köln,24.0,1998.0,17.7,12,7,1,8,3,4,14,28.6,10,13,2,11,8,20,17,0,Matches,2022-2023,Bundesliga
Umut Tohumcu,de GER,"MF,DF",Hoffenheim,17.0,2004.0,3.0,10,5,4,5,1,3,9,33.3,6,4,0,4,2,12,8,0,Matches,2022-2023,Bundesliga
Tiago Tomás,pt POR,"FW,MF",Stuttgart,20.0,2002.0,14.3,10,4,2,4,4,8,13,61.5,5,9,2,7,1,11,5,0,Matches,2022-2023,Bundesliga
Almamy Touré,ml MLI,DF,Eint Frankfurt,26.0,1996.0,4.4,13,7,7,5,1,5,9,55.6,4,9,2,7,10,23,8,0,Matches,2022-2023,Bundesliga
Lucas Tousart,fr FRA,MF,Hertha BSC,25.0,1997.0,32.7,73,38,35,28,10,27,60,45.0,33,42,6,36,48,121,75,1,Matches,2022-2023,Bundesliga
Kevin Trapp,de GER,GK,Eint Frankfurt,32.0,1990.0,33.0,1,1,1,0,0,0,2,0.0,2,2,0,2,0,1,10,0,Matches,2022-2023,Bundesliga
Christopher Trimmel,at AUT,DF,Union Berlin,35.0,1987.0,20.1,31,16,16,12,3,20,31,64.5,11,14,1,13,25,56,48,0,Matches,2022-2023,Bundesliga
Tuta,br BRA,DF,Eint Frankfurt,23.0,1999.0,30.2,53,35,27,19,7,33,57,57.9,24,47,14,33,49,102,134,2,Matches,2022-2023,Bundesliga
Sven Ulreich,de GER,GK,Bayern Munich,33.0,1988.0,3.0,1,1,1,0,0,1,1,100.0,0,0,0,0,0,1,0,1,Matches,2022-2023,Bundesliga
Lauren Ulrich,de GER,MF,Stuttgart,17.0,2005.0,0.1,1,1,0,0,1,0,0,,0,0,0,0,0,1,0,0,Matches,2022-2023,Bundesliga
Dayot Upamecano,fr FRA,DF,Bayern Munich,23.0,1998.0,26.1,65,37,43,22,0,28,45,62.2,17,26,6,20,27,92,71,4,Matches,2022-2023,Bundesliga
Filip Uremović,hr CRO,DF,Hertha BSC,25.0,1997.0,19.2,38,23,29,8,1,14,22,63.6,8,18,13,5,36,74,88,2,Matches,2022-2023,Bundesliga
Jere Uronen,fi FIN,DF,Schalke 04,28.0,1994.0,7.5,14,10,6,6,2,6,10,60.0,4,5,2,3,8,22,13,0,Matches,2022-2023,Bundesliga
Mark Uth,de GER,"MF,FW",Köln,30.0,1991.0,0.5,0,0,0,0,0,0,0,,0,0,0,0,0,0,0,0,Matches,2022-2023,Bundesliga
Josha Vagnoman,de GER,DF,Stuttgart,21.0,2000.0,16.4,26,15,12,11,3,15,27,55.6,12,20,2,18,8,34,29,1,Matches,2022-2023,Bundesliga
Ruben Vargas,ch SUI,"MF,FW",Augsburg,23.0,1998.0,12.6,15,7,6,7,2,5,11,45.5,6,8,2,6,6,21,16,1,Matches,2022-2023,Bundesliga
Renato Veiga,pt POR,DF,Augsburg,19.0,2003.0,7.1,9,6,4,3,2,7,9,77.8,2,20,6,14,7,16,29,1,Matches,2022-2023,Bundesliga
Miloš Veljković,rs SRB,DF,Werder Bremen,26.0,1995.0,25.2,30,19,17,13,0,18,29,62.1,11,32,16,16,33,63,103,0,Matches,2022-2023,Bundesliga
Micky van de Ven,nl NED,DF,Wolfsburg,21.0,2001.0,33.0,45,30,26,18,1,28,39,71.8,11,42,24,18,26,71,108,2,Matches,2022-2023,Bundesliga
Gabriel Vidovic,hr CRO,FW,Bayern Munich,18.0,2003.0,0.2,0,0,0,0,0,0,0,,0,0,0,0,0,0,0,0,Matches,2022-2023,Bundesliga
Kevin Vogt,de GER,DF,Hoffenheim,30.0,1991.0,19.7,15,10,10,5,0,9,22,40.9,13,18,11,7,26,41,67,0,Matches,2022-2023,Bundesliga
Aster Vranckx,be BEL,MF,Wolfsburg,19.0,2002.0,0.1,0,0,0,0,0,0,0,,0,0,0,0,0,0,1,0,Matches,2022-2023,Bundesliga
Robert Wagner,de GER,MF,Freiburg,19.0,2003.0,0.4,0,0,0,0,0,0,0,,0,2,0,2,0,0,2,0,Matches,2022-2023,Bundesliga
Luca Waldschmidt,de GER,"FW,MF",Wolfsburg,26.0,1996.0,5.8,5,2,2,1,2,2,10,20.0,8,6,0,6,3,8,5,0,Matches,2022-2023,Bundesliga
Paul Wanner,de GER,MF,Bayern Munich,16.0,2005.0,0.3,3,1,1,2,0,1,1,100.0,0,0,0,0,0,3,1,0,Matches,2022-2023,Bundesliga
Julian Weigl,de GER,MF,Gladbach,26.0,1995.0,21.0,43,16,21,21,1,23,41,56.1,18,23,2,21,18,61,32,0,Matches,2022-2023,Bundesliga
Nelson Weiper,de GER,"FW,DF",Mainz 05,17.0,2005.0,1.1,2,0,0,0,2,1,3,33.3,2,2,0,2,0,2,1,0,Matches,2022-2023,Bundesliga
Mitchell Weiser,de GER,"DF,FW",Werder Bremen,28.0,1994.0,28.0,71,43,38,24,9,38,75,50.7,37,50,7,43,28,99,38,1,Matches,2022-2023,Bundesliga
Noah Weißhaupt,de GER,"MF,DF",Freiburg,20.0,2001.0,4.7,11,6,3,7,1,2,7,28.6,5,4,0,4,6,17,8,0,Matches,2022-2023,Bundesliga
Marcel Wenig,de GER,MF,Eint Frankfurt,18.0,2004.0,0.0,0,0,0,0,0,0,0,,0,0,0,0,0,0,0,0,Matches,2022-2023,Bundesliga
Timo Werner,de GER,"FW,MF",RB Leipzig,26.0,1996.0,21.5,10,5,4,3,3,4,12,33.3,8,12,0,12,7,17,5,0,Matches,2022-2023,Bundesliga
Silvan Widmer,ch SUI,DF,Mainz 05,29.0,1993.0,18.8,26,17,15,10,1,20,39,51.3,19,22,8,14,31,57,28,0,Matches,2022-2023,Bundesliga
Patrick Wimmer,at AUT,"FW,MF",Wolfsburg,21.0,2001.0,18.3,39,26,18,11,10,12,38,31.6,26,27,2,25,15,54,15,0,Matches,2022-2023,Bundesliga
Jonas Wind,dk DEN,FW,Wolfsburg,23.0,1999.0,14.3,14,6,2,7,5,5,10,50.0,5,14,4,10,1,15,10,0,Matches,2022-2023,Bundesliga
Frederik Winther,dk DEN,DF,Augsburg,21.0,2001.0,1.0,2,2,1,1,0,0,2,0.0,2,1,1,0,0,2,7,0,Matches,2022-2023,Bundesliga
Florian Wirtz,de GER,"FW,MF",Leverkusen,19.0,2003.0,12.1,18,10,9,7,2,8,16,50.0,8,15,1,14,1,19,6,0,Matches,2022-2023,Bundesliga
Hannes Wolf,at AUT,FW,Gladbach,23.0,1999.0,5.0,11,8,4,5,2,5,13,38.5,8,3,0,3,3,14,9,0,Matches,2022-2023,Bundesliga
Marius Wolf,de GER,DF,Dortmund,27.0,1995.0,17.4,25,18,9,12,4,16,29,55.2,13,40,10,30,18,43,22,1,Matches,2022-2023,Bundesliga
Jeong Woo-yeong,kr KOR,"MF,FW",Freiburg,22.0,1999.0,7.3,7,3,4,2,1,2,5,40.0,3,7,1,6,1,8,7,0,Matches,2022-2023,Bundesliga
Kelvin Yeboah,it ITA,"FW,MF",Augsburg,22.0,2000.0,3.9,6,4,2,4,0,2,5,40.0,3,7,0,7,1,7,2,0,Matches,2022-2023,Bundesliga
Maya Yoshida,jp JPN,DF,Schalke 04,33.0,1988.0,28.4,34,22,19,13,2,18,29,62.1,11,40,29,11,46,80,132,2,Matches,2022-2023,Bundesliga
Dan-Axel Zagadou,fr FRA,DF,Stuttgart,23.0,1999.0,14.1,14,9,10,4,0,5,14,35.7,9,19,16,3,21,35,81,1,Matches,2022-2023,Bundesliga
Rodrigo Zalazar,uy URU,"MF,FW",Schalke 04,22.0,1999.0,14.7,16,8,5,9,2,9,24,37.5,15,16,1,15,7,23,13,0,Matches,2022-2023,Bundesliga
Aaron Zehnter,de GER,DF,Augsburg,17.0,2004.0,0.0,0,0,0,0,0,0,1,0.0,1,0,0,0,1,1,0,0,Matches,2022-2023,Bundesliga
Robin Zentner,de GER,GK,Mainz 05,27.0,1994.0,26.0,0,0,0,0,0,0,4,0.0,4,0,0,0,0,0,17,1,Matches,2022-2023,Bundesliga
Michael Zetterer,de GER,GK,Werder Bremen,27.0,1995.0,1.7,0,0,0,0,0,0,0,,0,0,0,0,0,0,1,0,Matches,2022-2023,Bundesliga
Simon Zoller,de GER,FW,Bochum,31.0,1991.0,16.2,11,4,2,8,1,4,12,33.3,8,14,1,13,6,17,21,0,Matches,2022-2023,Bundesliga
Brenden Aaronson,us USA,"MF,FW",Union Berlin,22.0,2000.0,14.1,32,18,13,13,6,16,32,50.0,16,26,1,25,2,34,4,0,Matches,2023-2024,Bundesliga
Paxten Aaronson,us USA,MF,Eint Frankfurt,19.0,2003.0,1.1,2,2,1,1,0,1,1,100.0,0,2,0,2,0,2,0,0,Matches,2023-2024,Bundesliga
Junior Adamu,at AUT,"FW,MF",Freiburg,22.0,2001.0,1.2,5,1,1,2,2,1,2,50.0,1,1,0,1,0,5,2,0,Matches,2023-2024,Bundesliga
Sargis Adamyan,am ARM,"FW,MF",Köln,30.0,1993.0,8.9,14,9,2,9,3,6,11,54.5,5,16,1,15,5,19,7,0,Matches,2023-2024,Bundesliga
Karim Adeyemi,de GER,"FW,MF",Dortmund,21.0,2002.0,10.1,16,14,9,4,3,8,20,40.0,12,11,0,11,3,19,5,0,Matches,2023-2024,Bundesliga
Amine Adli,ma MAR,"MF,FW",Leverkusen,23.0,2000.0,10.0,16,7,2,10,4,7,17,41.2,10,10,2,8,6,22,5,0,Matches,2023-2024,Bundesliga
Felix Agu,de GER,"DF,MF",Werder Bremen,23.0,1999.0,17.9,45,29,28,13,4,29,41,70.7,12,27,7,20,13,58,41,0,Matches,2023-2024,Bundesliga
Ludovic Ajorque,fr FRA,FW,Mainz 05,29.0,1994.0,15.1,3,2,1,2,0,2,11,18.2,9,6,2,4,4,7,11,0,Matches,2023-2024,Bundesliga
Kevin Akpoguma,ng NGA,DF,Hoffenheim,28.0,1995.0,12.2,35,18,22,12,1,26,35,74.3,9,28,8,20,18,53,32,0,Matches,2023-2024,Bundesliga
Faride Alidou,de GER,"FW,MF",Köln,22.0,2001.0,14.2,10,4,3,6,1,4,18,22.2,14,23,2,21,8,18,15,1,Matches,2023-2024,Bundesliga
Skelly Alvero,fr FRA,MF,Werder Bremen,21.0,2002.0,1.4,6,4,1,5,0,3,3,100.0,0,3,1,2,1,7,1,0,Matches,2023-2024,Bundesliga
Nadiem Amiri,de GER,MF,Mainz 05,26.0,1996.0,14.6,22,14,8,10,4,13,19,68.4,6,16,2,14,14,36,18,0,Matches,2023-2024,Bundesliga
Nadiem Amiri,de GER,MF,Leverkusen,26.0,1996.0,1.0,4,2,0,3,1,0,3,0.0,3,0,0,0,0,4,1,0,Matches,2023-2024,Bundesliga
Kofi Amoako,de GER,MF,Wolfsburg,18.0,2005.0,0.0,0,0,0,0,0,0,0,,0,0,0,0,0,0,0,0,Matches,2023-2024,Bundesliga
Robert Andrich,de GER,"MF,DF",Leverkusen,28.0,1994.0,18.8,30,18,8,14,8,13,24,54.2,11,15,4,11,20,50,17,0,Matches,2023-2024,Bundesliga
Waldemar Anton,de GER,DF,Stuttgart,27.0,1996.0,32.1,39,25,21,16,2,23,42,54.8,19,33,20,13,40,79,150,1,Matches,2023-2024,Bundesliga
Christopher Antwi-Adjei,gh GHA,"FW,MF",Bochum,29.0,1994.0,13.5,21,12,10,6,5,12,22,54.5,10,13,2,11,2,23,11,1,Matches,2023-2024,Bundesliga
Asaf Arania,il ISR,MF,Darmstadt 98,17.0,2005.0,0.1,0,0,0,0,0,0,0,,0,0,0,0,0,0,0,0,Matches,2023-2024,Bundesliga
Maximilian Arnold,de GER,MF,Wolfsburg,29.0,1994.0,27.8,51,31,15,27,9,28,57,49.1,29,23,4,19,24,75,60,0,Matches,2023-2024,Bundesliga
Arthur,br BRA,DF,Leverkusen,20.0,2003.0,2.0,4,3,2,0,2,2,2,100.0,0,1,1,0,0,4,7,0,Matches,2023-2024,Bundesliga
Takuma Asano,jp JPN,"FW,MF",Bochum,28.0,1994.0,22.1,17,6,2,9,6,7,23,30.4,16,17,3,14,4,21,11,0,Matches,2023-2024,Bundesliga
Jonathan Asp Jensen,dk DEN,FW,Bayern Munich,17.0,2006.0,0.0,0,0,0,0,0,0,0,,0,0,0,0,0,0,1,0,Matches,2023-2024,Bundesliga
Noah Atubolu,de GER,GK,Freiburg,21.0,2002.0,34.0,0,0,0,0,0,0,1,0.0,1,0,0,0,0,0,8,1,Matches,2023-2024,Bundesliga
Matthias Bader,de GER,"DF,MF",Darmstadt 98,26.0,1997.0,20.0,51,25,32,11,8,33,65,50.8,32,22,4,18,25,76,20,0,Matches,2023-2024,Bundesliga
Ridle Baku,de GER,"DF,MF",Wolfsburg,25.0,1998.0,22.4,37,20,24,7,6,21,46,45.7,25,27,1,26,21,58,45,1,Matches,2023-2024,Bundesliga
Samuel Bamba,de GER,FW,Dortmund,19.0,2004.0,0.5,1,1,1,0,0,1,2,50.0,1,0,0,0,0,1,1,0,Matches,2023-2024,Bundesliga
Aymen Barkok,ma MAR,"MF,FW",Mainz 05,25.0,1998.0,3.6,9,5,2,6,1,3,6,50.0,3,7,0,7,2,11,1,0,Matches,2023-2024,Bundesliga
Leandro Barreiro Martins,lu LUX,MF,Mainz 05,23.0,2000.0,29.0,65,40,19,37,9,30,50,60.0,20,45,16,29,36,101,53,0,Matches,2023-2024,Bundesliga
Daniel Batz,de GER,GK,Mainz 05,32.0,1991.0,4.0,0,0,0,0,0,0,0,,0,0,0,0,0,0,3,0,Matches,2023-2024,Bundesliga
Maximilian Bauer,de GER,DF,Augsburg,23.0,2000.0,9.0,19,12,13,4,2,9,17,52.9,8,14,8,6,11,30,30,1,Matches,2023-2024,Bundesliga
Elias Baum,de GER,"DF,MF",Eint Frankfurt,17.0,2005.0,0.3,1,0,0,0,1,0,0,,0,3,2,1,0,1,1,0,Matches,2023-2024,Bundesliga
Oliver Baumann,de GER,GK,Hoffenheim,33.0,1990.0,34.0,1,1,1,0,0,1,2,50.0,1,0,0,0,0,1,19,2,Matches,2023-2024,Bundesliga
Christoph Baumgartner,at AUT,"MF,FW",RB Leipzig,23.0,1999.0,12.9,26,13,10,12,4,14,38,36.8,24,20,1,19,5,31,14,0,Matches,2023-2024,Bundesliga
Ihlas Bebou,tg TOG,"FW,DF",Hoffenheim,29.0,1994.0,18.2,22,12,10,8,4,8,16,50.0,8,13,2,11,14,36,15,0,Matches,2023-2024,Bundesliga
Adrian Beck,de GER,"MF,FW",Heidenheim,26.0,1997.0,10.8,22,13,8,12,2,9,24,37.5,15,17,0,17,4,26,15,0,Matches,2023-2024,Bundesliga
Sheraldo Becker,sr SUR,"FW,MF",Union Berlin,28.0,1995.0,7.2,3,3,0,2,1,0,2,0.0,2,2,0,2,0,3,2,0,Matches,2023-2024,Bundesliga
Chris Bedia,ci CIV,"FW,MF",Union Berlin,27.0,1996.0,1.6,2,1,0,2,0,0,1,0.0,1,3,0,3,0,2,2,0,Matches,2023-2024,Bundesliga
Donny van de Beek,nl NED,"MF,FW",Eint Frankfurt,26.0,1997.0,4.0,8,3,3,3,2,3,7,42.9,4,5,1,4,3,11,1,0,Matches,2023-2024,Bundesliga
Kevin Behrens,de GER,FW,Wolfsburg,32.0,1991.0,6.8,2,1,0,1,1,0,2,0.0,2,9,0,9,3,5,6,0,Matches,2023-2024,Bundesliga
Kevin Behrens,de GER,FW,Union Berlin,32.0,1991.0,14.0,13,10,3,7,3,1,4,25.0,3,7,2,5,6,19,19,0,Matches,2023-2024,Bundesliga
Maximilian Beier,de GER,"FW,MF",Hoffenheim,20.0,2002.0,26.9,20,12,5,11,4,4,19,21.1,15,21,1,20,9,29,12,0,Matches,2023-2024,Bundesliga
Stefan Bell,de GER,DF,Mainz 05,31.0,1991.0,7.4,8,8,7,1,0,4,8,50.0,4,7,5,2,6,14,30,0,Matches,2023-2024,Bundesliga
Ramy Bensebaini,dz ALG,DF,Dortmund,28.0,1995.0,11.5,34,21,21,11,2,24,34,70.6,10,22,7,15,16,50,37,0,Matches,2023-2024,Bundesliga
Mergim Berisha,de GER,FW,Hoffenheim,25.0,1998.0,1.6,0,0,0,0,0,0,0,,0,2,1,1,0,0,0,0,Matches,2023-2024,Bundesliga
Mergim Berisha,de GER,FW,Augsburg,25.0,1998.0,1.4,0,0,0,0,0,0,0,,0,1,0,1,0,0,3,0,Matches,2023-2024,Bundesliga
Bernardo,br BRA,DF,Bochum,28.0,1995.0,32.5,99,58,56,35,8,45,69,65.2,24,66,30,36,55,154,120,1,Matches,2023-2024,Bundesliga
Matúš Bero,sk SVK,"MF,FW",Bochum,27.0,1995.0,18.5,32,22,13,12,7,13,32,40.6,19,24,3,21,12,44,26,0,Matches,2023-2024,Bundesliga
Jan-Niklas Beste,de GER,"FW,MF",Heidenheim,24.0,1999.0,28.9,77,49,35,24,18,28,55,50.9,27,48,1,47,18,95,31,0,Matches,2023-2024,Bundesliga
Pep Biel,es ESP,"MF,FW",Augsburg,26.0,1996.0,3.2,4,3,0,2,2,1,3,33.3,2,2,1,1,2,6,2,0,Matches,2023-2024,Bundesliga
Tom Bischof,de GER,"MF,FW",Hoffenheim,18.0,2005.0,2.0,8,4,6,1,1,2,9,22.2,7,3,0,3,1,9,2,0,Matches,2023-2024,Bundesliga
Leonardo Bittencourt,de GER,MF,Werder Bremen,29.0,1993.0,17.5,42,18,20,17,5,15,39,38.5,24,18,1,17,13,55,6,0,Matches,2023-2024,Bundesliga
Hendry Blank,de GER,DF,Dortmund,18.0,2004.0,0.5,1,0,1,0,0,1,1,100.0,0,1,0,1,0,1,4,0,Matches,2023-2024,Bundesliga
Janis Blaswich,de GER,GK,RB Leipzig,32.0,1991.0,21.0,1,1,1,0,0,0,0,,0,0,0,0,0,1,7,3,Matches,2023-2024,Bundesliga
Sacha Boey,fr FRA,DF,Bayern Munich,22.0,2000.0,1.2,2,0,2,0,0,1,2,50.0,1,1,0,1,1,3,2,0,Matches,2023-2024,Bundesliga
Victor Boniface,ng NGA,FW,Leverkusen,22.0,2000.0,17.2,6,4,0,1,5,1,4,25.0,3,6,1,5,0,6,13,0,Matches,2023-2024,Bundesliga
Leonardo Bonucci,it ITA,DF,Union Berlin,36.0,1987.0,5.1,6,5,2,4,0,4,4,100.0,0,5,3,2,7,13,16,0,Matches,2023-2024,Bundesliga
Yvandro Borges Sanches,lu LUX,"MF,FW",Gladbach,19.0,2004.0,0.2,0,0,0,0,0,0,0,,0,0,0,0,0,0,0,0,Matches,2023-2024,Bundesliga
Sebastiaan Bornauw,be BEL,DF,Wolfsburg,24.0,1999.0,15.9,26,12,19,7,0,13,19,68.4,6,21,12,9,18,44,81,0,Matches,2023-2024,Bundesliga
Rafael Borré,co COL,FW,Werder Bremen,27.0,1995.0,11.0,10,7,2,4,4,5,16,31.3,11,8,2,6,2,12,10,0,Matches,2023-2024,Bundesliga
Julian Brandt,de GER,"MF,FW",Dortmund,27.0,1996.0,24.7,17,14,8,8,1,10,27,37.0,17,20,3,17,8,25,18,0,Matches,2023-2024,Bundesliga
Fabian Bredlow,de GER,GK,Stuttgart,28.0,1995.0,4.0,0,0,0,0,0,0,1,0.0,1,0,0,0,0,0,3,0,Matches,2023-2024,Bundesliga
Tim Breithaupt,de GER,MF,Augsburg,21.0,2002.0,7.0,20,11,11,9,0,13,21,61.9,8,15,3,12,8,28,10,0,Matches,2023-2024,Bundesliga
Maximilian Breunig,de GER,FW,Freiburg,22.0,2000.0,0.1,0,0,0,0,0,0,0,,0,1,0,1,0,0,0,0,Matches,2023-2024,Bundesliga
Bennit Bröger,de GER,FW,Wolfsburg,17.0,2006.0,0.1,0,0,0,0,0,0,0,,0,0,0,0,0,0,0,0,Matches,2023-2024,Bundesliga
John Brooks,us USA,DF,Hoffenheim,30.0,1993.0,17.1,28,15,17,10,1,15,30,50.0,15,29,17,12,27,55,109,1,Matches,2023-2024,Bundesliga
Moritz Broschinski,de GER,FW,Bochum,22.0,2000.0,13.9,11,7,2,5,4,2,8,25.0,6,11,2,9,0,11,6,0,Matches,2023-2024,Bundesliga
Alexander Brunst,de GER,GK,Darmstadt 98,28.0,1995.0,3.0,0,0,0,0,0,0,2,0.0,2,0,0,0,0,0,2,1,Matches,2023-2024,Bundesliga
Marius Bülter,de GER,"DF,FW",Hoffenheim,30.0,1993.0,15.0,18,11,9,5,4,12,23,52.2,11,17,3,14,10,28,20,0,Matches,2023-2024,Bundesliga
Jonathan Burkardt,de GER,"FW,MF",Mainz 05,23.0,2000.0,17.1,12,8,2,6,4,4,11,36.4,7,16,3,13,3,15,2,0,Matches,2023-2024,Bundesliga
Oliver Burke,sct SCO,FW,Werder Bremen,26.0,1997.0,0.4,0,0,0,0,0,0,2,0.0,2,0,0,0,0,0,0,0,Matches,2023-2024,Bundesliga
Marnon Busch,de GER,DF,Heidenheim,28.0,1994.0,6.6,11,9,6,3,2,7,12,58.3,5,9,2,7,10,21,12,0,Matches,2023-2024,Bundesliga
Aurélio Buta,pt POR,"DF,MF",Eint Frankfurt,26.0,1997.0,19.4,40,25,19,16,5,21,38,55.3,17,24,5,19,15,55,36,0,Matches,2023-2024,Bundesliga
Anthony Caci,fr FRA,DF,Mainz 05,26.0,1997.0,27.6,56,23,30,25,1,27,44,61.4,17,43,7,36,32,88,45,0,Matches,2023-2024,Bundesliga
Emre Can,de GER,"MF,DF",Dortmund,29.0,1994.0,21.7,63,45,37,23,3,28,48,58.3,20,30,7,23,22,85,41,2,Matches,2023-2024,Bundesliga
Irvin Cardona,fr FRA,"MF,DF",Augsburg,25.0,1997.0,0.6,1,1,0,0,1,1,3,33.3,2,1,0,1,0,1,1,0,Matches,2023-2024,Bundesliga
Rasmus Carstensen,dk DEN,"DF,FW",Köln,22.0,2000.0,18.4,47,22,23,20,4,31,56,55.4,25,38,9,29,20,67,50,2,Matches,2023-2024,Bundesliga
Fabio Carvalho,pt POR,MF,RB Leipzig,20.0,2002.0,1.8,3,1,0,2,1,1,3,33.3,2,8,0,8,0,3,1,0,Matches,2023-2024,Bundesliga
Koen Casteels,be BEL,GK,Wolfsburg,31.0,1992.0,25.0,2,1,2,0,0,2,3,66.7,1,0,0,0,0,2,16,5,Matches,2023-2024,Bundesliga
Václav Černý,cz CZE,"FW,MF",Wolfsburg,25.0,1997.0,10.2,8,3,3,4,1,2,14,14.3,12,13,0,13,8,16,6,0,Matches,2023-2024,Bundesliga
Julian Chabot,de GER,DF,Köln,25.0,1998.0,30.0,59,42,40,17,2,35,59,59.3,24,66,43,23,45,104,145,0,Matches,2023-2024,Bundesliga
El Chadaille Bitshiabu,fr FRA,"DF,MF",RB Leipzig,18.0,2005.0,0.4,1,0,1,0,0,0,0,,0,0,0,0,1,2,4,0,Matches,2023-2024,Bundesliga
Fares Chaïbi,dz ALG,"MF,FW",Eint Frankfurt,20.0,2002.0,21.2,27,17,7,12,8,8,18,44.4,10,37,1,36,5,32,19,0,Matches,2023-2024,Bundesliga
Timothy Chandler,us USA,"MF,DF",Eint Frankfurt,33.0,1990.0,0.2,0,0,0,0,0,0,0,,0,0,0,0,0,0,0,0,Matches,2023-2024,Bundesliga
Fabio Chiarodia,it ITA,DF,Gladbach,18.0,2005.0,1.7,8,5,5,1,2,5,7,71.4,2,2,1,1,3,11,9,0,Matches,2023-2024,Bundesliga
Jacob Christensen,dk DEN,MF,Köln,22.0,2001.0,2.4,10,6,7,3,0,4,7,57.1,3,8,2,6,4,14,4,0,Matches,2023-2024,Bundesliga
Nnamdi Collins,de GER,DF,Eint Frankfurt,19.0,2004.0,1.0,0,0,0,0,0,0,0,,0,0,0,0,2,2,4,0,Matches,2023-2024,Bundesliga
Kingsley Coman,fr FRA,FW,Bayern Munich,27.0,1996.0,12.4,12,7,5,3,4,9,17,52.9,8,15,1,14,2,14,5,0,Matches,2023-2024,Bundesliga
Bambasé Conté,de GER,"MF,FW",Hoffenheim,20.0,2003.0,0.5,3,3,2,0,1,1,1,100.0,0,0,0,0,0,3,0,0,Matches,2023-2024,Bundesliga
Danny da Costa,de GER,DF,Mainz 05,30.0,1993.0,9.2,18,9,9,7,2,9,19,47.4,10,17,4,13,16,34,24,0,Matches,2023-2024,Bundesliga
Nicolas Cozza,fr FRA,DF,Wolfsburg,24.0,1999.0,3.1,8,6,4,4,0,2,7,28.6,5,3,0,3,4,12,6,0,Matches,2023-2024,Bundesliga
Tomáš Čvančara,cz CZE,FW,Gladbach,22.0,2000.0,10.0,4,3,0,2,2,1,3,33.3,2,5,1,4,2,6,8,0,Matches,2023-2024,Bundesliga
Finn Dahmen,de GER,GK,Augsburg,25.0,1998.0,31.0,1,0,1,0,0,1,3,33.3,2,0,0,0,0,1,17,5,Matches,2023-2024,Bundesliga
Mahmoud Dahoud,de GER,MF,Stuttgart,27.0,1996.0,2.5,5,1,1,4,0,3,7,42.9,4,4,0,4,0,5,1,0,Matches,2023-2024,Bundesliga
Lukas Daschner,de GER,"MF,FW",Bochum,24.0,1998.0,6.0,9,4,2,3,4,4,9,44.4,5,7,0,7,2,11,2,0,Matches,2023-2024,Bundesliga
David Datro Fofana,ci CIV,"FW,MF",Union Berlin,20.0,2002.0,7.6,10,7,3,5,2,4,9,44.4,5,4,0,4,0,10,5,0,Matches,2023-2024,Bundesliga
Alphonso Davies,ca CAN,DF,Bayern Munich,22.0,2000.0,22.9,47,24,29,13,5,30,53,56.6,23,30,4,26,26,73,49,1,Matches,2023-2024,Bundesliga
Olivier Deman,be BEL,DF,Werder Bremen,23.0,2000.0,15.2,28,15,21,4,3,18,38,47.4,20,24,8,16,14,42,49,1,Matches,2023-2024,Bundesliga
Ermedin Demirović,ba BIH,"FW,MF",Augsburg,25.0,1998.0,31.9,24,14,5,16,3,12,40,30.0,28,28,2,26,11,35,26,0,Matches,2023-2024,Bundesliga
Sepp van den Berg,nl NED,DF,Mainz 05,21.0,2001.0,31.5,38,23,20,15,3,15,26,57.7,11,66,36,30,43,81,159,2,Matches,2023-2024,Bundesliga
Samuele Di Benedetto,de GER,MF,Stuttgart,18.0,2005.0,0.1,0,0,0,0,0,0,0,,0,0,0,0,1,1,0,0,Matches,2023-2024,Bundesliga
Justin Diehl,de GER,"FW,MF",Köln,18.0,2004.0,1.9,0,0,0,0,0,0,0,,0,1,1,0,0,0,0,1,Matches,2023-2024,Bundesliga
Eric Dier,eng ENG,DF,Bayern Munich,29.0,1994.0,13.0,11,8,5,5,1,5,6,83.3,1,20,12,8,10,21,48,1,Matches,2023-2024,Bundesliga
Florian Dietz,de GER,"FW,MF",Köln,24.0,1998.0,0.8,0,0,0,0,0,0,0,,0,1,0,1,0,0,0,0,Matches,2023-2024,Bundesliga
Junior Dina Ebimbe,fr FRA,"MF,DF",Eint Frankfurt,22.0,2000.0,21.7,44,29,15,17,12,18,41,43.9,23,28,7,21,9,53,39,1,Matches,2023-2024,Bundesliga
Eren Dinkçi,de GER,"FW,MF",Heidenheim,21.0,2001.0,29.4,32,18,16,13,3,19,48,39.6,29,40,4,36,12,44,21,0,Matches,2023-2024,Bundesliga
Ritsu Doan,jp JPN,"DF,MF",Freiburg,25.0,1998.0,25.0,50,27,21,19,10,21,36,58.3,15,30,3,27,9,59,29,0,Matches,2023-2024,Bundesliga
Danilho Doekhi,nl NED,DF,Union Berlin,25.0,1998.0,24.0,34,23,18,16,0,15,21,71.4,6,46,25,21,38,72,111,1,Matches,2023-2024,Bundesliga
Niklas Dorsch,de GER,MF,Augsburg,25.0,1998.0,15.4,35,24,13,21,1,13,33,39.4,20,15,9,6,16,51,27,0,Matches,2023-2024,Bundesliga
Nikola Dovedan,at AUT,"MF,FW",Heidenheim,29.0,1994.0,7.3,14,9,2,10,2,5,25,20.0,20,9,0,9,1,15,3,0,Matches,2023-2024,Bundesliga
Damion Downs,us USA,"FW,MF",Köln,19.0,2004.0,2.0,1,1,1,0,0,1,2,50.0,1,1,0,1,0,1,1,0,Matches,2023-2024,Bundesliga
Dion Drena Beljo,hr CRO,"FW,MF",Augsburg,21.0,2002.0,6.5,0,0,0,0,0,0,2,0.0,2,8,1,7,1,1,4,0,Matches,2023-2024,Bundesliga
Tim Drexler,de GER,DF,Hoffenheim,18.0,2005.0,6.4,16,9,12,4,0,8,17,47.1,9,12,8,4,8,24,14,0,Matches,2023-2024,Bundesliga
Marvin Ducksch,de GER,FW,Werder Bremen,29.0,1994.0,30.0,8,3,4,3,1,6,14,42.9,8,2,0,2,4,12,25,0,Matches,2023-2024,Bundesliga
Julien Duranville,be BEL,"FW,MF",Dortmund,17.0,2006.0,0.1,1,0,0,1,0,1,1,100.0,0,0,0,0,0,1,0,0,Matches,2023-2024,Bundesliga
Maximilian Eggestein,de GER,MF,Freiburg,26.0,1996.0,32.4,49,24,25,19,5,15,36,41.7,21,53,19,34,28,77,40,1,Matches,2023-2024,Bundesliga
Lilian Egloff,de GER,"MF,DF",Stuttgart,20.0,2002.0,1.2,4,1,3,1,0,2,4,50.0,2,3,1,2,1,5,0,0,Matches,2023-2024,Bundesliga
Hugo Ekitike,fr FRA,FW,Eint Frankfurt,21.0,2002.0,8.0,11,7,3,6,2,4,6,66.7,2,10,0,10,2,13,4,0,Matches,2023-2024,Bundesliga
Elif Elmas,mk MKD,"MF,FW",RB Leipzig,23.0,1999.0,3.0,8,6,1,6,1,6,8,75.0,2,5,0,5,1,9,2,0,Matches,2023-2024,Bundesliga
Nico Elvedi,ch SUI,DF,Gladbach,26.0,1996.0,27.6,33,18,22,10,1,18,24,75.0,6,40,25,15,43,76,150,2,Matches,2023-2024,Bundesliga
Arne Engels,be BEL,"MF,DF",Augsburg,19.0,2003.0,15.6,33,18,15,14,4,12,29,41.4,17,23,1,22,15,48,21,0,Matches,2023-2024,Bundesliga
Ohis Felix Uduokhai,de GER,DF,Augsburg,25.0,1997.0,32.5,37,21,18,14,5,16,25,64.0,9,45,35,10,46,83,178,2,Matches,2023-2024,Bundesliga
Edimilson Fernandes,ch SUI,DF,Mainz 05,27.0,1996.0,14.3,25,16,15,9,1,16,24,66.7,8,14,6,8,22,47,52,0,Matches,2023-2024,Bundesliga
Nacho Ferri,es ESP,"FW,MF",Eint Frankfurt,18.0,2004.0,0.8,3,3,1,2,0,2,3,66.7,1,0,0,0,0,3,2,0,Matches,2023-2024,Bundesliga
Max Finkgräfe,de GER,"DF,FW",Köln,19.0,2004.0,19.5,65,39,40,25,0,39,74,52.7,35,35,10,25,22,87,39,0,Matches,2023-2024,Bundesliga
Kilian Fischer,de GER,"DF,MF",Wolfsburg,22.0,2000.0,3.2,8,6,4,3,1,2,5,40.0,3,8,1,7,1,9,12,0,Matches,2023-2024,Bundesliga
Jonas Föhrenbach,de GER,DF,Heidenheim,27.0,1996.0,31.0,44,24,24,14,6,19,36,52.8,17,34,19,15,31,75,70,0,Matches,2023-2024,Bundesliga
Emil Forsberg,se SWE,"MF,FW",RB Leipzig,31.0,1991.0,5.2,7,3,2,5,0,5,12,41.7,7,7,0,7,0,7,5,0,Matches,2023-2024,Bundesliga
Philipp Förster,de GER,"MF,FW",Bochum,28.0,1995.0,4.3,9,5,3,4,2,2,6,33.3,4,3,0,3,7,16,3,0,Matches,2023-2024,Bundesliga
Bartol Franjić,hr CRO,MF,Darmstadt 98,23.0,2000.0,13.7,15,12,4,10,1,7,28,25.0,21,12,4,8,30,45,29,2,Matches,2023-2024,Bundesliga
Marco Friedl,at AUT,DF,Werder Bremen,25.0,1998.0,24.4,53,32,38,15,0,36,48,75.0,12,45,29,16,35,88,129,0,Matches,2023-2024,Bundesliga
Marvin Friedrich,de GER,DF,Gladbach,27.0,1995.0,17.4,23,15,16,6,1,12,20,60.0,8,28,20,8,17,40,87,0,Matches,2023-2024,Bundesliga
Jeremie Frimpong,nl NED,DF,Leverkusen,22.0,2000.0,25.0,26,17,12,7,7,8,20,40.0,12,26,0,26,7,33,17,0,Matches,2023-2024,Bundesliga
Chris Führich,de GER,"FW,MF",Stuttgart,25.0,1998.0,28.5,30,19,6,14,10,16,37,43.2,21,31,0,31,7,37,7,0,Matches,2023-2024,Bundesliga
Shiō Fukuda,jp JPN,"FW,MF",Gladbach,19.0,2004.0,0.4,2,0,1,1,0,1,2,50.0,1,0,0,0,1,3,0,0,Matches,2023-2024,Bundesliga
Niclas Füllkrug,de GER,FW,Werder Bremen,30.0,1993.0,2.0,1,1,0,1,0,1,1,100.0,0,2,1,1,0,1,1,0,Matches,2023-2024,Bundesliga
Niclas Füllkrug,de GER,FW,Dortmund,30.0,1993.0,24.6,7,2,1,6,0,2,8,25.0,6,17,4,13,2,9,25,0,Matches,2023-2024,Bundesliga
Cristian Gamboa,cr CRC,DF,Bochum,33.0,1989.0,13.2,24,18,12,11,1,14,33,42.4,19,20,7,13,15,39,34,1,Matches,2023-2024,Bundesliga
Dennis Geiger,de GER,MF,Hoffenheim,25.0,1998.0,0.7,1,0,1,0,0,0,0,,0,1,1,0,0,1,0,0,Matches,2023-2024,Bundesliga
Yannick Gerhardt,de GER,"MF,DF",Wolfsburg,29.0,1994.0,18.1,31,20,16,12,3,9,32,28.1,23,15,2,13,7,38,35,0,Matches,2023-2024,Bundesliga
Anwar El Ghazi,nl NED,"MF,DF",Mainz 05,28.0,1995.0,0.6,0,0,0,0,0,0,1,0.0,1,0,0,0,0,0,0,0,Matches,2023-2024,Bundesliga
Benedikt Gimber,de GER,DF,Heidenheim,26.0,1997.0,22.5,40,24,25,14,1,19,35,54.3,16,27,17,10,16,56,101,1,Matches,2023-2024,Bundesliga
Matthias Ginter,de GER,DF,Freiburg,29.0,1994.0,21.3,29,15,19,9,1,16,29,55.2,13,40,26,14,16,45,93,0,Matches,2023-2024,Bundesliga
Jamie Gittens,eng ENG,"FW,MF",Dortmund,18.0,2004.0,11.8,14,7,6,7,1,2,17,11.8,15,11,2,9,4,18,7,0,Matches,2023-2024,Bundesliga
Klaus Gjasula,al ALB,"DF,MF",Darmstadt 98,33.0,1989.0,15.1,44,22,18,25,1,17,30,56.7,13,26,14,12,19,63,42,2,Matches,2023-2024,Bundesliga
Serge Gnabry,de GER,"FW,MF",Bayern Munich,28.0,1995.0,4.8,8,5,0,5,3,2,13,15.4,11,5,0,5,3,11,2,0,Matches,2023-2024,Bundesliga
Leon Goretzka,de GER,MF,Bayern Munich,28.0,1995.0,24.9,41,23,18,14,9,24,54,44.4,30,44,8,36,31,72,42,1,Matches,2023-2024,Bundesliga
Robin Gosens,de GER,"DF,MF",Union Berlin,29.0,1994.0,25.4,63,44,25,31,7,30,44,68.2,14,52,9,43,36,99,75,0,Matches,2023-2024,Bundesliga
Mario Götze,de GER,MF,Eint Frankfurt,31.0,1992.0,23.0,51,34,18,25,8,28,62,45.2,34,19,3,16,14,65,10,0,Matches,2023-2024,Bundesliga
Jeffrey Gouweleeuw,nl NED,DF,Augsburg,32.0,1991.0,28.8,35,23,13,17,5,16,25,64.0,9,44,24,20,35,70,108,0,Matches,2023-2024,Bundesliga
Jens Grahl,de GER,GK,Eint Frankfurt,34.0,1988.0,2.0,0,0,0,0,0,0,0,,0,0,0,0,0,0,3,0,Matches,2023-2024,Bundesliga
Ryan Gravenberch,nl NED,FW,Bayern Munich,21.0,2002.0,0.1,0,0,0,0,0,0,0,,0,0,0,0,0,0,0,0,Matches,2023-2024,Bundesliga
Michael Gregoritsch,at AUT,FW,Freiburg,29.0,1994.0,18.7,16,12,8,5,3,2,14,14.3,12,17,4,13,9,25,27,0,Matches,2023-2024,Bundesliga
Vincenzo Grifo,it ITA,"MF,FW",Freiburg,30.0,1993.0,25.8,31,20,14,11,6,14,31,45.2,17,22,1,21,15,46,20,0,Matches,2023-2024,Bundesliga
Florian Grillitsch,at AUT,"DF,MF",Hoffenheim,27.0,1995.0,25.5,54,28,31,19,4,22,54,40.7,32,41,20,21,52,106,90,2,Matches,2023-2024,Bundesliga
Álex Grimaldo,es ESP,DF,Leverkusen,27.0,1995.0,30.9,45,24,26,10,9,30,55,54.5,25,32,7,25,22,67,41,0,Matches,2023-2024,Bundesliga
Christian Groß,de GER,"DF,MF",Werder Bremen,34.0,1989.0,8.9,21,16,11,9,1,11,25,44.0,14,17,6,11,13,34,28,1,Matches,2023-2024,Bundesliga
Brajan Gruda,de GER,"MF,FW",Mainz 05,19.0,2004.0,18.2,22,14,5,11,6,14,24,58.3,10,15,0,15,5,27,4,0,Matches,2023-2024,Bundesliga
Ilia Gruev,bg BUL,MF,Werder Bremen,23.0,2000.0,0.0,0,0,0,0,0,0,0,,0,0,0,0,0,0,0,0,Matches,2023-2024,Bundesliga
Raphaël Guerreiro,pt POR,"DF,MF",Bayern Munich,29.0,1993.0,13.2,19,16,6,9,4,9,15,60.0,6,7,1,6,15,34,5,1,Matches,2023-2024,Bundesliga
Josuha Guilavogui,fr FRA,DF,Mainz 05,32.0,1990.0,4.5,15,10,10,5,0,6,7,85.7,1,13,7,6,13,28,21,0,Matches,2023-2024,Bundesliga
Serhou Guirassy,gn GUI,FW,Stuttgart,27.0,1996.0,24.5,6,3,1,4,1,2,5,40.0,3,8,1,7,6,12,29,0,Matches,2023-2024,Bundesliga
Péter Gulácsi,hu HUN,GK,RB Leipzig,33.0,1990.0,13.0,0,0,0,0,0,0,0,,0,0,0,0,0,0,8,1,Matches,2023-2024,Bundesliga
Manuel Gulde,de GER,DF,Freiburg,32.0,1991.0,22.7,37,23,23,13,1,17,23,73.9,6,24,14,10,25,62,82,0,Matches,2023-2024,Bundesliga
Robert Gumny,pl POL,DF,Augsburg,25.0,1998.0,5.3,6,5,1,3,2,1,5,20.0,4,13,5,8,7,13,15,0,Matches,2023-2024,Bundesliga
Christian Günter,de GER,DF,Freiburg,30.0,1993.0,11.8,20,12,9,11,0,7,18,38.9,11,9,3,6,2,22,16,0,Matches,2023-2024,Bundesliga
Janik Haberer,de GER,"MF,DF",Union Berlin,29.0,1994.0,13.6,36,24,16,13,7,22,45,48.9,23,21,4,17,12,48,18,0,Matches,2023-2024,Bundesliga
Robin Hack,de GER,"FW,MF",Gladbach,24.0,1998.0,15.0,15,8,6,7,2,4,17,23.5,13,16,0,16,14,29,21,0,Matches,2023-2024,Bundesliga
Amadou Haidara,ml MLI,MF,RB Leipzig,25.0,1998.0,17.0,42,27,24,16,2,23,41,56.1,18,28,6,22,21,63,37,0,Matches,2023-2024,Bundesliga
Sébastien Haller,ci CIV,FW,Dortmund,29.0,1994.0,4.4,1,0,0,1,0,1,1,100.0,0,4,1,3,0,1,7,0,Matches,2023-2024,Bundesliga
Andreas Hanche-Olsen,no NOR,DF,Mainz 05,26.0,1997.0,11.0,20,12,10,8,2,10,16,62.5,6,10,4,6,11,31,41,0,Matches,2023-2024,Bundesliga
Isak Hansen-Aarøen,no NOR,MF,Werder Bremen,18.0,2004.0,0.3,0,0,0,0,0,0,1,0.0,1,1,0,1,1,1,0,0,Matches,2023-2024,Bundesliga
Genki Haraguchi,jp JPN,MF,Stuttgart,32.0,1991.0,0.3,1,1,1,0,0,0,0,,0,0,0,0,0,1,1,0,Matches,2023-2024,Bundesliga
Makoto Hasebe,jp JPN,"DF,MF",Eint Frankfurt,39.0,1984.0,2.4,4,2,2,2,0,3,6,50.0,3,2,1,1,2,6,5,0,Matches,2023-2024,Bundesliga
Thorgan Hazard,be BEL,DF,Dortmund,30.0,1993.0,0.1,0,0,0,0,0,0,0,,0,0,0,0,0,0,0,0,Matches,2023-2024,Bundesliga
Dominique Heintz,de GER,DF,Köln,29.0,1993.0,6.3,12,5,6,6,0,8,12,66.7,4,6,1,5,3,15,28,0,Matches,2023-2024,Bundesliga
Benjamin Henrichs,de GER,DF,RB Leipzig,26.0,1997.0,28.1,68,39,32,26,10,27,58,46.6,31,49,4,45,33,101,37,0,Matches,2023-2024,Bundesliga
Patrick Herrmann,de GER,"FW,DF",Gladbach,32.0,1991.0,1.0,4,4,2,1,1,2,2,100.0,0,1,0,1,1,5,2,0,Matches,2023-2024,Bundesliga
Piero Hincapié,ec ECU,DF,Leverkusen,21.0,2002.0,16.5,35,22,14,17,4,13,17,76.5,4,18,7,11,13,48,43,0,Matches,2023-2024,Bundesliga
Adam Hložek,cz CZE,"MF,FW",Leverkusen,21.0,2002.0,5.1,10,4,2,4,4,3,7,42.9,4,4,1,3,2,12,1,0,Matches,2023-2024,Bundesliga
Nicolas Höfler,de GER,MF,Freiburg,33.0,1990.0,25.9,63,40,36,20,7,22,49,44.9,27,30,16,14,31,94,45,0,Matches,2023-2024,Bundesliga
Jonas Hofmann,de GER,MF,Leverkusen,31.0,1992.0,24.5,20,14,6,9,5,10,24,41.7,14,18,0,18,8,28,6,0,Matches,2023-2024,Bundesliga
Philipp Hofmann,de GER,FW,Bochum,30.0,1993.0,17.5,10,5,4,5,1,4,7,57.1,3,11,2,9,4,14,17,0,Matches,2023-2024,Bundesliga
Lucas Höler,de GER,"FW,MF",Freiburg,29.0,1994.0,25.6,32,24,14,10,8,4,23,17.4,19,19,4,15,15,47,35,0,Matches,2023-2024,Bundesliga
Fabian Holland,de GER,"MF,DF",Darmstadt 98,33.0,1990.0,20.4,47,26,18,21,8,20,37,54.1,17,22,12,10,24,71,29,0,Matches,2023-2024,Bundesliga
Benedict Hollerbach,de GER,"FW,MF",Union Berlin,22.0,2001.0,14.2,17,11,5,7,5,7,22,31.8,15,28,0,28,4,21,3,0,Matches,2023-2024,Bundesliga
Gerrit Holtmann,ph PHI,"MF,FW",Darmstadt 98,28.0,1995.0,4.4,8,5,3,4,1,7,10,70.0,3,7,0,7,2,10,4,1,Matches,2023-2024,Bundesliga
Franck Honorat,fr FRA,"DF,FW",Gladbach,26.0,1996.0,26.1,25,13,13,10,2,11,20,55.0,9,22,3,19,9,34,35,1,Matches,2023-2024,Bundesliga
Mathias Honsak,at AUT,"FW,MF",Darmstadt 98,26.0,1996.0,11.3,14,7,7,6,1,6,20,30.0,14,14,2,12,8,22,25,0,Matches,2023-2024,Bundesliga
Fraser Hornby,sct SCO,"FW,MF",Darmstadt 98,23.0,1999.0,2.4,0,0,0,0,0,0,1,0.0,1,2,1,1,0,0,4,0,Matches,2023-2024,Bundesliga
Lukáš Hrádecký,fi FIN,GK,Leverkusen,33.0,1989.0,33.0,0,0,0,0,0,0,1,0.0,1,1,0,1,0,0,10,2,Matches,2023-2024,Bundesliga
Timo Hübers,de GER,DF,Köln,27.0,1996.0,30.9,68,47,51,14,3,49,80,61.3,31,54,28,26,63,131,168,1,Matches,2023-2024,Bundesliga
Mats Hummels,de GER,DF,Dortmund,34.0,1988.0,17.6,52,34,34,12,6,30,53,56.6,23,33,11,22,33,85,82,0,Matches,2023-2024,Bundesliga
Denis Huseinbasic,ba BIH,MF,Köln,22.0,2001.0,18.1,38,18,17,15,6,20,31,64.5,11,26,1,25,13,51,14,0,Matches,2023-2024,Bundesliga
Iago,br BRA,DF,Augsburg,26.0,1997.0,18.0,36,17,22,10,4,17,33,51.5,16,39,8,31,18,54,43,0,Matches,2023-2024,Bundesliga
Borja Iglesias,es ESP,FW,Leverkusen,30.0,1993.0,2.8,1,0,0,1,0,0,1,0.0,1,2,0,2,1,2,1,0,Matches,2023-2024,Bundesliga
Joel Imasuen,us USA,FW,Werder Bremen,18.0,2004.0,0.0,0,0,0,0,0,0,0,,0,0,0,0,0,0,0,0,Matches,2023-2024,Bundesliga
Thomas Isherwood,se SWE,DF,Darmstadt 98,25.0,1998.0,7.1,11,5,7,3,1,5,9,55.6,4,10,7,3,10,21,34,0,Matches,2023-2024,Bundesliga
Ko Itakura,jp JPN,"DF,MF",Gladbach,26.0,1997.0,17.7,34,21,17,15,2,16,26,61.5,10,32,18,14,22,56,62,0,Matches,2023-2024,Bundesliga
Hiroki Ito,jp JPN,DF,Stuttgart,24.0,1999.0,24.8,19,18,13,6,0,11,26,42.3,15,29,17,12,29,48,86,2,Matches,2023-2024,Bundesliga
Lee Jae-sung,kr KOR,"MF,FW",Mainz 05,30.0,1992.0,23.5,33,20,11,16,6,13,39,33.3,26,22,2,20,27,60,23,0,Matches,2023-2024,Bundesliga
Paul Jaeckel,de GER,DF,Union Berlin,25.0,1998.0,2.6,7,2,4,3,0,5,9,55.6,4,3,2,1,4,11,7,0,Matches,2023-2024,Bundesliga
Kristijan Jakić,hr CRO,MF,Augsburg,26.0,1997.0,11.7,28,14,14,10,4,15,33,45.5,18,13,1,12,20,48,15,0,Matches,2023-2024,Bundesliga
Kristijan Jakić,hr CRO,"MF,FW",Eint Frankfurt,26.0,1997.0,2.2,3,3,1,2,0,1,3,33.3,2,1,0,1,2,5,2,0,Matches,2023-2024,Bundesliga
Tony Jantschke,de GER,"DF,MF",Gladbach,33.0,1990.0,0.3,1,1,1,0,0,1,1,100.0,0,2,2,0,1,2,4,0,Matches,2023-2024,Bundesliga
Nuha Jatta,gm GAM,FW,RB Leipzig,17.0,2006.0,0.0,0,0,0,0,0,0,0,,0,0,0,0,0,0,0,0,Matches,2023-2024,Bundesliga
Fredrik Jensen,fi FIN,"MF,FW",Augsburg,25.0,1997.0,14.9,23,11,9,8,6,14,28,50.0,14,30,1,29,12,35,21,0,Matches,2023-2024,Bundesliga
Moritz Jenz,de GER,DF,Wolfsburg,24.0,1999.0,19.4,34,24,21,11,2,14,21,66.7,7,29,17,12,26,60,94,0,Matches,2023-2024,Bundesliga
Anthony Jung,de GER,DF,Werder Bremen,31.0,1991.0,28.7,37,23,21,14,2,18,33,54.5,15,39,17,22,24,61,102,0,Matches,2023-2024,Bundesliga
Josip Juranović,hr CRO,DF,Union Berlin,27.0,1995.0,14.4,20,14,11,7,2,10,21,47.6,11,17,3,14,12,32,27,1,Matches,2023-2024,Bundesliga
David Jurásek,cz CZE,DF,Hoffenheim,22.0,2000.0,5.5,14,11,13,1,0,7,17,41.2,10,7,2,5,3,17,22,1,Matches,2023-2024,Bundesliga
Julian Justvan,de GER,"FW,MF",Hoffenheim,25.0,1998.0,0.5,1,0,1,0,0,1,2,50.0,1,1,0,1,0,1,0,0,Matches,2023-2024,Bundesliga
Julian Justvan,de GER,"MF,FW",Darmstadt 98,25.0,1998.0,11.4,10,4,2,7,1,3,17,17.6,14,12,2,10,11,21,6,1,Matches,2023-2024,Bundesliga
Ozan Kabak,tr TUR,DF,Hoffenheim,23.0,2000.0,25.4,48,35,32,14,2,19,33,57.6,14,43,21,22,46,94,106,2,Matches,2023-2024,Bundesliga
Pavel Kadeřábek,cz CZE,"DF,FW",Hoffenheim,31.0,1992.0,26.8,31,19,10,15,6,18,40,45.0,22,22,8,14,23,54,68,0,Matches,2023-2024,Bundesliga
Florian Kainz,at AUT,"MF,FW",Köln,30.0,1992.0,24.4,28,20,8,13,7,17,39,43.6,22,20,6,14,13,41,23,1,Matches,2023-2024,Bundesliga
Sasa Kalajdzic,at AUT,FW,Eint Frankfurt,26.0,1997.0,3.6,2,2,0,2,0,0,0,,0,2,2,0,2,4,6,0,Matches,2023-2024,Bundesliga
Jakub Kamiński,pl POL,"FW,MF",Wolfsburg,21.0,2002.0,5.3,14,5,12,2,0,3,6,50.0,3,3,0,3,2,16,5,0,Matches,2023-2024,Bundesliga
Kevin Kampl,si SVN,MF,RB Leipzig,32.0,1990.0,15.1,19,8,8,9,2,10,21,47.6,11,19,7,12,11,30,14,1,Matches,2023-2024,Bundesliga
Harry Kane,eng ENG,FW,Bayern Munich,30.0,1993.0,31.5,13,9,4,4,5,6,18,33.3,12,12,4,8,6,19,14,0,Matches,2023-2024,Bundesliga
Atakan Karazor,,MF,Stuttgart,26.0,1996.0,29.1,72,44,23,38,11,29,60,48.3,31,37,8,29,27,99,43,0,Matches,2023-2024,Bundesliga
Emir Karic,at AUT,DF,Darmstadt 98,26.0,1997.0,19.8,45,27,23,14,8,21,33,63.6,12,42,11,31,13,58,43,0,Matches,2023-2024,Bundesliga
Silas Katompa,cd COD,"FW,MF",Stuttgart,24.0,1998.0,10.0,5,3,3,2,0,3,12,25.0,9,9,0,9,0,5,4,0,Matches,2023-2024,Bundesliga
Mikkel Kaufmann,dk DEN,FW,Union Berlin,22.0,2001.0,5.4,6,3,2,3,1,3,10,30.0,7,12,0,12,1,7,4,0,Matches,2023-2024,Bundesliga
Naby Keïta,gn GUI,"MF,DF",Werder Bremen,28.0,1995.0,1.2,1,1,1,0,0,0,1,0.0,1,2,0,2,2,3,1,0,Matches,2023-2024,Bundesliga
Yannik Keitel,de GER,"DF,MF",Freiburg,23.0,2000.0,10.2,20,15,14,5,1,10,15,66.7,5,17,8,9,12,32,44,3,Matches,2023-2024,Bundesliga
Thomas Keller,de GER,"MF,FW",Heidenheim,23.0,1999.0,0.0,0,0,0,0,0,0,0,,0,0,0,0,0,0,0,0,Matches,2023-2024,Bundesliga
Aljoscha Kemlein,de GER,MF,Union Berlin,18.0,2004.0,0.3,0,0,0,0,0,0,3,0.0,3,1,0,1,0,0,0,0,Matches,2023-2024,Bundesliga
Tobias Kempe,de GER,MF,Darmstadt 98,34.0,1989.0,15.0,20,13,9,8,3,8,24,33.3,16,16,4,12,9,29,12,0,Matches,2023-2024,Bundesliga
Rani Khedira,de GER,MF,Union Berlin,29.0,1994.0,14.9,35,22,15,19,1,17,26,65.4,9,12,5,7,22,57,38,0,Matches,2023-2024,Bundesliga
Luca Kilian,de GER,DF,Köln,23.0,1999.0,7.1,16,9,15,1,0,9,14,64.3,5,12,5,7,7,23,28,0,Matches,2023-2024,Bundesliga
Joshua Kimmich,de GER,"MF,DF",Bayern Munich,28.0,1995.0,24.2,45,33,25,15,5,26,39,66.7,13,32,4,28,14,59,28,1,Matches,2023-2024,Bundesliga
Christoph Klarer,at AUT,DF,Darmstadt 98,23.0,2000.0,26.2,37,22,30,4,3,24,36,66.7,12,31,20,11,21,58,94,1,Matches,2023-2024,Bundesliga
Tim Kleindienst,de GER,FW,Heidenheim,27.0,1995.0,31.9,21,12,6,11,4,7,25,28.0,18,32,8,24,12,33,58,0,Matches,2023-2024,Bundesliga
Lukas Klostermann,de GER,DF,RB Leipzig,27.0,1996.0,16.0,15,10,7,7,1,4,13,30.8,9,25,12,13,13,28,64,1,Matches,2023-2024,Bundesliga
Ansgar Knauff,de GER,"MF,DF",Eint Frankfurt,21.0,2002.0,23.4,43,26,17,16,10,17,31,54.8,14,40,3,37,20,63,15,0,Matches,2023-2024,Bundesliga
Robin Knoche,de GER,DF,Union Berlin,31.0,1992.0,21.3,34,22,27,7,0,19,30,63.3,11,27,19,8,13,47,73,0,Matches,2023-2024,Bundesliga
Gregor Kobel,ch SUI,GK,Dortmund,25.0,1997.0,26.3,0,0,0,0,0,0,1,0.0,1,0,0,0,0,0,11,0,Matches,2023-2024,Bundesliga
Robin Koch,de GER,DF,Eint Frankfurt,27.0,1996.0,30.4,38,23,26,12,0,17,27,63.0,10,33,24,9,32,70,136,2,Matches,2023-2024,Bundesliga
Dominik Kohr,de GER,"DF,MF",Mainz 05,29.0,1994.0,24.3,65,42,36,25,4,36,57,63.2,21,27,6,21,43,108,58,0,Matches,2023-2024,Bundesliga
Randal Kolo Muani,fr FRA,FW,Eint Frankfurt,24.0,1998.0,1.7,0,0,0,0,0,0,0,,0,0,0,0,0,0,1,0,Matches,2023-2024,Bundesliga
Mert Kömür,de GER,"MF,DF",Augsburg,18.0,2005.0,1.3,3,3,3,0,0,3,5,60.0,2,0,0,0,0,3,1,0,Matches,2023-2024,Bundesliga
Manu Koné,fr FRA,MF,Gladbach,22.0,2001.0,17.3,45,26,20,20,5,17,25,68.0,8,22,1,21,15,60,16,1,Matches,2023-2024,Bundesliga
Odilon Kossounou,ci CIV,DF,Leverkusen,22.0,2001.0,20.1,30,20,11,12,7,15,26,57.7,11,27,3,24,27,57,43,1,Matches,2023-2024,Bundesliga
Tomáš Koubek,cz CZE,GK,Augsburg,30.0,1992.0,3.0,0,0,0,0,0,0,0,,0,0,0,0,0,0,1,1,Matches,2023-2024,Bundesliga
Matej Kovar,cz CZE,GK,Leverkusen,23.0,2000.0,1.0,0,0,0,0,0,0,0,,0,0,0,0,0,0,0,0,Matches,2023-2024,Bundesliga
Dawid Kownacki,pl POL,FW,Werder Bremen,26.0,1997.0,4.2,1,1,1,0,0,1,4,25.0,3,3,1,2,0,1,1,0,Matches,2023-2024,Bundesliga
Alex Král,cz CZE,MF,Union Berlin,25.0,1998.0,15.2,19,14,7,10,2,8,20,40.0,12,15,4,11,11,30,30,0,Matches,2023-2024,Bundesliga
Andrej Kramarić,hr CRO,"MF,FW",Hoffenheim,32.0,1991.0,24.4,11,2,5,4,2,6,13,46.2,7,14,2,12,10,21,12,2,Matches,2023-2024,Bundesliga
Christoph Kramer,de GER,MF,Gladbach,32.0,1991.0,2.8,10,5,5,5,0,2,14,14.3,12,7,1,6,4,14,6,0,Matches,2023-2024,Bundesliga
Frans Krätzig,de GER,DF,Bayern Munich,20.0,2003.0,0.6,2,0,2,0,0,1,2,50.0,1,0,0,0,0,2,0,0,Matches,2023-2024,Bundesliga
Tom Krauß,de GER,MF,Mainz 05,22.0,2001.0,15.0,57,33,22,31,4,21,58,36.2,37,33,4,29,17,74,28,0,Matches,2023-2024,Bundesliga
Lukas Kübler,de GER,DF,Freiburg,30.0,1992.0,20.5,50,24,35,13,2,26,42,61.9,16,36,14,22,37,87,57,1,Matches,2023-2024,Bundesliga
Mahmut Kücüksahin,,MF,Augsburg,19.0,2004.0,0.0,0,0,0,0,0,0,0,,0,0,0,0,0,0,0,0,Matches,2023-2024,Bundesliga
Christian Kühlwetter,de GER,MF,Heidenheim,27.0,1996.0,0.1,0,0,0,0,0,0,0,,0,0,0,0,0,0,0,0,Matches,2023-2024,Bundesliga
Moritz-Broni Kwarteng,gh GHA,FW,Bochum,25.0,1998.0,3.1,3,0,0,3,0,1,7,14.3,6,4,0,4,2,5,0,0,Matches,2023-2024,Bundesliga
Maxence Lacroix,fr FRA,DF,Wolfsburg,23.0,2000.0,26.2,48,29,28,18,2,29,41,70.7,12,35,12,23,24,72,121,0,Matches,2023-2024,Bundesliga
Aïssa Laïdouni,tn TUN,MF,Union Berlin,26.0,1996.0,11.9,21,12,4,12,5,4,12,33.3,8,26,2,24,12,33,14,2,Matches,2023-2024,Bundesliga
Konrad Laimer,at AUT,"DF,MF",Bayern Munich,26.0,1997.0,19.7,56,36,25,20,11,22,52,42.3,30,42,6,36,18,74,13,2,Matches,2023-2024,Bundesliga
Stefan Lainer,at AUT,"DF,MF",Gladbach,30.0,1992.0,8.3,23,16,15,8,0,14,24,58.3,10,13,6,7,5,28,28,0,Matches,2023-2024,Bundesliga
Hugo Larsson,se SWE,MF,Eint Frankfurt,19.0,2004.0,21.0,32,18,18,10,4,15,28,53.6,13,34,7,27,29,61,30,1,Matches,2023-2024,Bundesliga
Diogo Leite,pt POR,DF,Union Berlin,24.0,1999.0,30.0,52,36,31,15,6,25,51,49.0,26,48,22,26,47,99,155,1,Matches,2023-2024,Bundesliga
Maxim Leitsch,de GER,DF,Mainz 05,25.0,1998.0,4.2,6,3,5,1,0,3,6,50.0,3,2,0,2,4,10,13,0,Matches,2023-2024,Bundesliga
Christopher Lenz,de GER,"DF,MF",RB Leipzig,28.0,1994.0,0.5,2,1,2,0,0,1,1,100.0,0,0,0,0,2,4,2,0,Matches,2023-2024,Bundesliga
Christopher Lenz,de GER,DF,Eint Frankfurt,28.0,1994.0,0.1,1,1,0,1,0,1,1,100.0,0,0,0,0,0,1,1,0,Matches,2023-2024,Bundesliga
Jamie Leweling,de GER,"FW,MF",Stuttgart,22.0,2001.0,16.9,18,10,4,6,8,5,17,29.4,12,21,1,20,5,23,13,0,Matches,2023-2024,Bundesliga
Philipp Lienhart,at AUT,DF,Freiburg,27.0,1996.0,14.1,20,13,14,5,1,13,23,56.5,10,18,11,7,14,34,51,0,Matches,2023-2024,Bundesliga
Matthijs de Ligt,nl NED,DF,Bayern Munich,23.0,1999.0,15.4,15,12,4,8,3,6,11,54.5,5,14,10,4,19,34,52,0,Matches,2023-2024,Bundesliga
Jesper Lindstrøm,dk DEN,FW,Eint Frankfurt,23.0,2000.0,0.9,1,1,1,0,0,0,0,,0,0,0,0,0,1,0,0,Matches,2023-2024,Bundesliga
Dejan Ljubicic,at AUT,"MF,FW",Köln,25.0,1997.0,22.8,43,27,20,18,5,20,43,46.5,23,22,2,20,18,61,11,0,Matches,2023-2024,Bundesliga
Noah Loosli,ch SUI,DF,Bochum,26.0,1997.0,3.8,10,7,6,4,0,7,14,50.0,7,7,1,6,7,17,18,0,Matches,2023-2024,Bundesliga
Anthony Losilla,fr FRA,MF,Bochum,37.0,1986.0,28.6,63,37,15,40,8,23,51,45.1,28,37,8,29,25,88,51,0,Matches,2023-2024,Bundesliga
Castello Lukeba,fr FRA,DF,RB Leipzig,20.0,2002.0,24.3,19,12,10,9,0,10,12,83.3,2,35,13,22,12,31,94,2,Matches,2023-2024,Bundesliga
Andreas Luthe,de GER,GK,Bochum,36.0,1987.0,1.0,0,0,0,0,0,0,0,,0,0,0,0,0,0,1,0,Matches,2023-2024,Bundesliga
Senne Lynen,be BEL,MF,Werder Bremen,24.0,1999.0,20.0,64,38,33,27,4,30,70,42.9,40,41,8,33,41,105,56,0,Matches,2023-2024,Bundesliga
Ian Maatsen,nl NED,DF,Dortmund,21.0,2002.0,14.0,30,22,15,9,6,16,30,53.3,14,22,4,18,13,43,26,0,Matches,2023-2024,Bundesliga
Matej Maglica,hr CRO,DF,Darmstadt 98,24.0,1998.0,18.9,35,21,25,10,0,22,36,61.1,14,29,11,18,22,57,92,5,Matches,2023-2024,Bundesliga
Arne Maier,de GER,MF,Augsburg,24.0,1999.0,11.1,14,9,5,8,1,5,14,35.7,9,19,2,17,6,20,11,0,Matches,2023-2024,Bundesliga
Linton Maina,de GER,"FW,MF",Köln,24.0,1999.0,21.1,18,15,11,5,2,9,28,32.1,19,12,1,11,6,24,12,0,Matches,2023-2024,Bundesliga
Patrick Mainka,de GER,DF,Heidenheim,28.0,1994.0,34.0,85,49,58,24,3,38,74,51.4,36,66,32,34,49,134,158,1,Matches,2023-2024,Bundesliga
Lovro Majer,hr CRO,"MF,FW",Wolfsburg,25.0,1998.0,23.4,39,18,17,22,0,12,31,38.7,19,20,1,19,12,51,13,0,Matches,2023-2024,Bundesliga
Jordy Makengo,fr FRA,DF,Freiburg,21.0,2001.0,11.4,17,11,11,5,1,6,10,60.0,4,16,4,12,11,28,37,0,Matches,2023-2024,Bundesliga
Julián Malatini,ar ARG,DF,Werder Bremen,22.0,2001.0,6.7,18,13,12,3,3,16,24,66.7,8,8,1,7,13,31,26,0,Matches,2023-2024,Bundesliga
Donyell Malen,nl NED,"FW,MF",Dortmund,24.0,1999.0,19.8,11,7,5,3,3,2,6,33.3,4,11,4,7,2,13,8,0,Matches,2023-2024,Bundesliga
Lennard Maloney,us USA,MF,Heidenheim,23.0,1999.0,25.4,43,26,14,24,5,25,59,42.4,34,33,9,24,25,68,88,0,Matches,2023-2024,Bundesliga
David Mamutovic,de GER,"FW,DF",Mainz 05,22.0,2000.0,0.1,1,1,0,1,0,1,1,100.0,0,0,0,0,0,1,0,0,Matches,2023-2024,Bundesliga
Braydon Manu,gh GHA,MF,Darmstadt 98,26.0,1997.0,1.9,2,0,0,1,1,0,0,,0,1,0,1,0,2,0,0,Matches,2023-2024,Bundesliga
Omar Marmoush,eg EGY,"FW,MF",Eint Frankfurt,24.0,1999.0,25.6,21,11,7,8,6,6,16,37.5,10,13,0,13,11,32,7,0,Matches,2023-2024,Bundesliga
Eric Martel,de GER,MF,Köln,21.0,2002.0,27.3,70,43,32,34,4,37,67,55.2,30,65,19,46,43,113,80,0,Matches,2023-2024,Bundesliga
Erhan Mašović,rs SRB,"DF,MF",Bochum,24.0,1998.0,24.7,64,40,37,22,5,37,70,52.9,33,32,10,22,25,89,75,2,Matches,2023-2024,Bundesliga
Roberto Massimo,de GER,"FW,DF",Stuttgart,22.0,2000.0,0.9,1,0,1,0,0,1,2,50.0,1,0,0,0,0,1,1,0,Matches,2023-2024,Bundesliga
Jean Mattéo Bahoya,fr FRA,"MF,FW",Eint Frankfurt,18.0,2005.0,2.0,3,1,0,3,0,1,4,25.0,3,2,0,2,1,4,1,0,Matches,2023-2024,Bundesliga
Philipp Max,de GER,DF,Eint Frankfurt,29.0,1993.0,15.0,26,17,6,18,2,19,26,73.1,7,18,1,17,7,33,18,2,Matches,2023-2024,Bundesliga
Eric Maxim Choupo-Moting,cm CMR,"MF,FW",Bayern Munich,34.0,1989.0,8.0,17,12,8,5,4,6,14,42.9,8,5,0,5,7,24,7,0,Matches,2023-2024,Bundesliga
Noussair Mazraoui,ma MAR,DF,Bayern Munich,25.0,1997.0,13.3,32,21,14,11,7,13,21,61.9,8,14,1,13,20,52,27,1,Matches,2023-2024,Bundesliga
Kevin Mbabu,ch SUI,DF,Augsburg,28.0,1995.0,22.7,51,39,25,18,8,23,40,57.5,17,29,9,20,24,75,48,0,Matches,2023-2024,Bundesliga
Noah Mbamba,be BEL,MF,Leverkusen,18.0,2005.0,0.2,0,0,0,0,0,0,0,,0,0,0,0,1,1,0,0,Matches,2023-2024,Bundesliga
Nathanael Mbuku,cd COD,FW,Augsburg,21.0,2002.0,0.1,0,0,0,0,0,0,0,,0,1,0,1,0,0,0,0,Matches,2023-2024,Bundesliga
Marvin Mehlem,de GER,MF,Darmstadt 98,25.0,1997.0,16.5,28,21,10,14,4,11,27,40.7,16,21,2,19,33,61,15,0,Matches,2023-2024,Bundesliga
Thomas Meunier,be BEL,DF,Dortmund,31.0,1991.0,6.5,5,1,3,2,0,3,13,23.1,10,8,2,6,4,9,22,0,Matches,2023-2024,Bundesliga
Alexander Meyer,de GER,GK,Dortmund,32.0,1991.0,7.7,1,1,1,0,0,1,1,100.0,0,0,0,0,0,1,2,1,Matches,2023-2024,Bundesliga
Sven Michel,de GER,"FW,MF",Augsburg,33.0,1990.0,6.5,7,5,2,1,4,2,7,28.6,5,1,0,1,0,7,4,0,Matches,2023-2024,Bundesliga
Enzo Millot,fr FRA,"MF,FW",Stuttgart,21.0,2002.0,24.9,40,22,9,21,10,18,39,46.2,21,24,2,22,16,56,7,1,Matches,2023-2024,Bundesliga
Jovan Milošević,rs SRB,"FW,MF",Stuttgart,18.0,2005.0,0.3,0,0,0,0,0,0,0,,0,0,0,0,0,0,0,0,Matches,2023-2024,Bundesliga
Kim Min-jae,kr KOR,DF,Bayern Munich,26.0,1996.0,21.9,37,24,21,11,5,12,24,50.0,12,29,19,10,45,82,70,2,Matches,2023-2024,Bundesliga
Maximilian Mittelstädt,de GER,DF,Stuttgart,26.0,1997.0,23.4,91,51,46,39,6,53,89,59.6,36,36,6,30,46,137,65,0,Matches,2023-2024,Bundesliga
Marko Mladenović,rs SRB,MF,Eint Frankfurt,18.0,2005.0,0.1,0,0,0,0,0,0,0,,0,0,0,0,0,0,0,0,Matches,2023-2024,Bundesliga
Max Moerstedt,de GER,"DF,FW",Hoffenheim,,,0.1,0,0,0,0,0,0,1,0.0,1,0,0,0,0,0,0,0,Matches,2023-2024,Bundesliga
Mateu Morey,es ESP,DF,Dortmund,23.0,2000.0,1.2,2,2,1,1,0,2,4,50.0,2,3,1,2,1,3,3,0,Matches,2023-2024,Bundesliga
Youssoufa Moukoko,de GER,FW,Dortmund,18.0,2004.0,6.9,4,1,2,2,0,3,7,42.9,4,4,1,3,2,6,4,0,Matches,2023-2024,Bundesliga
Andreas Müller,de GER,MF,Darmstadt 98,23.0,2000.0,3.9,14,9,8,5,1,4,9,44.4,5,5,2,3,4,18,5,0,Matches,2023-2024,Bundesliga
Jannik Müller,de GER,"DF,MF",Darmstadt 98,29.0,1994.0,12.6,33,16,21,9,3,16,27,59.3,11,24,12,12,17,50,39,1,Matches,2023-2024,Bundesliga
Kevin Müller,de GER,GK,Heidenheim,32.0,1991.0,34.0,3,0,3,0,0,3,5,60.0,2,0,0,0,0,3,6,1,Matches,2023-2024,Bundesliga
Marcus Müller,de GER,MF,Mainz 05,20.0,2002.0,0.2,0,0,0,0,0,0,0,,0,0,0,0,0,0,0,0,Matches,2023-2024,Bundesliga
Thomas Müller,de GER,"MF,FW",Bayern Munich,33.0,1989.0,18.4,26,16,5,10,11,13,35,37.1,22,22,0,22,3,29,6,0,Matches,2023-2024,Bundesliga
Jamal Musiala,de GER,"MF,FW",Bayern Munich,20.0,2003.0,19.5,40,25,9,21,10,14,36,38.9,22,25,1,24,16,56,5,0,Matches,2023-2024,Bundesliga
Florent Muslija,xk KVX,"MF,FW",Freiburg,25.0,1998.0,1.2,5,4,3,2,0,2,5,40.0,3,1,0,1,0,5,2,0,Matches,2023-2024,Bundesliga
Phillipp Mwene,at AUT,DF,Mainz 05,29.0,1994.0,22.2,34,15,15,16,3,16,33,48.5,17,27,3,24,17,51,47,0,Matches,2023-2024,Bundesliga
Joakim Mæhle,dk DEN,"DF,MF",Wolfsburg,26.0,1997.0,27.2,62,39,33,18,11,41,64,64.1,23,43,5,38,29,91,65,0,Matches,2023-2024,Bundesliga
Nathan N'Goumou,cm CMR,"FW,MF",Gladbach,23.0,2000.0,15.4,37,22,17,18,2,16,34,47.1,18,22,0,22,5,42,17,1,Matches,2023-2024,Bundesliga
Stanley N'Soki,fr FRA,DF,Hoffenheim,24.0,1999.0,7.0,21,10,12,8,1,17,29,58.6,12,13,2,11,8,29,33,0,Matches,2023-2024,Bundesliga
Luca Netz,de GER,DF,Gladbach,20.0,2003.0,24.7,38,22,19,16,3,23,43,53.5,20,36,10,26,22,60,76,1,Matches,2023-2024,Bundesliga
Manuel Neuer,de GER,GK,Bayern Munich,37.0,1986.0,22.8,1,1,1,0,0,0,0,,0,0,0,0,0,1,14,3,Matches,2023-2024,Bundesliga
Florian Neuhaus,de GER,MF,Gladbach,26.0,1997.0,13.6,15,12,7,8,0,8,26,30.8,18,8,6,2,14,29,8,0,Matches,2023-2024,Bundesliga
Jessic Ngankam,de GER,"FW,MF",Mainz 05,23.0,2000.0,2.0,1,1,0,1,0,0,0,,0,3,1,2,3,4,0,0,Matches,2023-2024,Bundesliga
Jessic Ngankam,de GER,FW,Eint Frankfurt,23.0,2000.0,3.1,3,2,1,1,1,0,0,,0,0,0,0,0,3,1,0,Matches,2023-2024,Bundesliga
Moritz Nicolas,de GER,GK,Gladbach,25.0,1997.0,27.0,1,0,1,0,0,1,3,33.3,2,0,0,0,0,1,12,5,Matches,2023-2024,Bundesliga
Justin Njinmah,de GER,FW,Werder Bremen,22.0,2000.0,11.3,5,1,2,2,1,3,9,33.3,6,9,1,8,2,7,6,0,Matches,2023-2024,Bundesliga
Niels Nkounkou,fr FRA,"DF,MF",Eint Frankfurt,22.0,2000.0,14.5,54,30,34,17,3,29,64,45.3,35,30,2,28,16,70,30,0,Matches,2023-2024,Bundesliga
Felix Nmecha,de GER,MF,Dortmund,22.0,2000.0,11.3,19,13,7,8,4,11,22,50.0,11,18,5,13,11,30,19,0,Matches,2023-2024,Bundesliga
Lukas Nmecha,de GER,FW,Wolfsburg,24.0,1998.0,0.5,1,1,0,0,1,0,0,,0,1,0,1,0,1,0,0,Matches,2023-2024,Bundesliga
Jonathan Norbye,no NOR,MF,RB Leipzig,16.0,2007.0,0.0,0,0,0,0,0,0,0,,0,0,0,0,0,0,0,0,Matches,2023-2024,Bundesliga
Alexander Nübel,de GER,GK,Stuttgart,26.0,1996.0,30.0,2,2,2,0,0,2,4,50.0,2,0,0,0,0,2,13,4,Matches,2023-2024,Bundesliga
Kasim Nuhu,gh GHA,DF,Hoffenheim,28.0,1995.0,0.1,0,0,0,0,0,0,0,,0,0,0,0,0,0,0,0,Matches,2023-2024,Bundesliga
Fabian Nürnberger,bg BUL,"DF,MF",Darmstadt 98,24.0,1999.0,16.8,29,22,22,6,1,22,41,53.7,19,11,1,10,17,46,26,0,Matches,2023-2024,Bundesliga
Tim Oermann,de GER,DF,Bochum,19.0,2003.0,7.9,19,11,11,4,4,9,14,64.3,5,15,6,9,2,21,22,0,Matches,2023-2024,Bundesliga
Masaya Okugawa,jp JPN,"FW,DF",Augsburg,27.0,1996.0,0.4,0,0,0,0,0,0,0,,0,0,0,0,0,0,2,0,Matches,2023-2024,Bundesliga
Finn Ole Becker,de GER,MF,Hoffenheim,23.0,2000.0,6.7,10,9,8,2,0,4,17,23.5,13,9,1,8,1,11,10,0,Matches,2023-2024,Bundesliga
Mathias Olesen,lu LUX,"MF,FW",Köln,22.0,2001.0,1.2,0,0,0,0,0,0,0,,0,0,0,0,2,2,2,0,Matches,2023-2024,Bundesliga
Dani Olmo,es ESP,MF,RB Leipzig,25.0,1998.0,16.1,26,18,14,8,4,10,22,45.5,12,7,0,7,13,39,12,1,Matches,2023-2024,Bundesliga
Jonas Omlin,ch SUI,GK,Gladbach,29.0,1994.0,7.0,1,0,1,0,0,1,1,100.0,0,0,0,0,0,1,3,0,Matches,2023-2024,Bundesliga
Karim Onisiwo,at AUT,"FW,MF",Mainz 05,31.0,1992.0,16.6,17,8,4,6,7,6,11,54.5,5,18,4,14,2,19,7,0,Matches,2023-2024,Bundesliga
Loïs Openda,be BEL,FW,RB Leipzig,23.0,2000.0,30.0,3,3,0,1,2,0,6,0.0,6,19,3,16,5,8,14,0,Matches,2023-2024,Bundesliga
Leon Opitz,de GER,"FW,DF",Werder Bremen,18.0,2005.0,0.2,2,2,1,1,0,2,3,66.7,1,0,0,0,0,2,0,0,Matches,2023-2024,Bundesliga
Willi Orban,hu HUN,DF,RB Leipzig,30.0,1992.0,17.6,20,12,8,10,2,9,18,50.0,9,22,13,9,16,36,76,1,Matches,2023-2024,Bundesliga
Ivan Ordets,ua UKR,DF,Bochum,31.0,1992.0,20.9,19,14,11,6,2,10,17,58.8,7,41,29,12,31,50,130,0,Matches,2023-2024,Bundesliga
Patrick Osterhage,de GER,MF,Bochum,23.0,2000.0,20.7,38,26,14,23,1,17,36,47.2,19,36,9,27,27,65,32,1,Matches,2023-2024,Bundesliga
Salih Özcan,tr TUR,MF,Dortmund,25.0,1998.0,13.2,20,12,11,8,1,10,18,55.6,8,28,3,25,17,37,18,1,Matches,2023-2024,Bundesliga
Willian Pacho,ec ECU,DF,Eint Frankfurt,21.0,2001.0,33.0,62,37,38,23,1,31,53,58.5,22,51,22,29,47,109,152,2,Matches,2023-2024,Bundesliga
Gonçalo Paciência,pt POR,"FW,MF",Bochum,28.0,1994.0,7.2,8,4,2,2,4,3,6,50.0,3,5,0,5,0,8,7,0,Matches,2023-2024,Bundesliga
Exequiel Palacios,ar ARG,MF,Leverkusen,24.0,1998.0,20.3,60,34,28,26,6,26,53,49.1,27,24,0,24,29,89,20,2,Matches,2023-2024,Bundesliga
Miloš Pantović,rs SRB,MF,Union Berlin,27.0,1996.0,0.2,0,0,0,0,0,0,0,,0,0,0,0,0,0,0,0,Matches,2023-2024,Bundesliga
Antonios Papadopoulos,de GER,DF,Dortmund,23.0,1999.0,1.3,6,3,6,0,0,6,7,85.7,1,3,2,1,2,8,7,0,Matches,2023-2024,Bundesliga
Merveille Papela,de GER,"MF,DF",Mainz 05,22.0,2001.0,2.9,5,4,2,3,0,0,4,0.0,4,1,0,1,4,9,2,0,Matches,2023-2024,Bundesliga
Leart Paqarada,xk KVX,DF,Köln,28.0,1994.0,11.9,21,11,9,9,3,11,22,50.0,11,17,5,12,10,31,30,1,Matches,2023-2024,Bundesliga
Kevin Paredes,us USA,"FW,MF",Wolfsburg,20.0,2003.0,15.9,42,21,22,13,7,20,34,58.8,14,27,2,25,23,65,26,0,Matches,2023-2024,Bundesliga
Felix Passlack,de GER,DF,Bochum,25.0,1998.0,10.7,21,14,9,10,2,14,24,58.3,10,13,2,11,10,31,21,0,Matches,2023-2024,Bundesliga
Jiří Pavlenka,cz CZE,GK,Werder Bremen,31.0,1992.0,7.0,0,0,0,0,0,0,0,,0,0,0,0,0,0,2,0,Matches,2023-2024,Bundesliga
Aleksandar Pavlovic,de GER,MF,Bayern Munich,19.0,2004.0,13.6,28,16,10,14,4,17,33,51.5,16,13,3,10,17,45,12,0,Matches,2023-2024,Bundesliga
Mads Pedersen,dk DEN,DF,Augsburg,26.0,1996.0,19.8,64,39,31,27,6,24,44,54.5,20,20,3,17,19,83,46,0,Matches,2023-2024,Bundesliga
Jordan Pefok,us USA,FW,Gladbach,27.0,1996.0,15.8,10,4,0,8,2,3,8,37.5,5,12,3,9,5,15,28,0,Matches,2023-2024,Bundesliga
Jordan Pefok,us USA,FW,Union Berlin,27.0,1996.0,0.3,0,0,0,0,0,0,0,,0,1,1,0,0,0,0,0,Matches,2023-2024,Bundesliga
Dženan Pejčinović,de GER,FW,Wolfsburg,18.0,2005.0,0.4,0,0,0,0,0,0,0,,0,1,0,1,0,0,0,0,Matches,2023-2024,Bundesliga
Daniel Peretz,il ISR,GK,Bayern Munich,23.0,2000.0,0.2,0,0,0,0,0,0,0,,0,0,0,0,0,0,0,0,Matches,2023-2024,Bundesliga
Matteo Perez Vinlöf,se SWE,FW,Bayern Munich,17.0,2005.0,0.2,0,0,0,0,0,0,0,,0,0,0,0,1,1,0,0,Matches,2023-2024,Bundesliga
Pavao Pervan,at AUT,GK,Wolfsburg,35.0,1987.0,9.0,0,0,0,0,0,0,0,,0,0,0,0,0,0,4,0,Matches,2023-2024,Bundesliga
Jens Petter Hauge,no NOR,"MF,FW",Eint Frankfurt,23.0,1999.0,1.6,2,1,1,0,1,2,7,28.6,5,5,1,4,0,2,1,0,Matches,2023-2024,Bundesliga
Luca Pfeiffer,de GER,"FW,MF",Darmstadt 98,26.0,1996.0,18.0,11,6,2,6,3,5,11,45.5,6,5,1,4,2,13,21,0,Matches,2023-2024,Bundesliga
Patric Pfeiffer,de GER,DF,Augsburg,23.0,1999.0,5.7,11,7,6,4,1,5,6,83.3,1,10,6,4,11,22,21,0,Matches,2023-2024,Bundesliga
Maximilian Philipp,de GER,"FW,MF",Freiburg,29.0,1994.0,3.6,8,5,4,4,0,1,6,16.7,5,7,0,7,1,9,3,0,Matches,2023-2024,Bundesliga
Florian Pick,de GER,"MF,FW",Heidenheim,27.0,1995.0,3.6,4,4,3,0,1,2,3,66.7,1,2,0,2,2,6,2,0,Matches,2023-2024,Bundesliga
Amos Pieper,de GER,DF,Werder Bremen,25.0,1998.0,6.6,14,11,8,6,0,7,13,53.8,6,12,7,5,9,23,36,1,Matches,2023-2024,Bundesliga
Marvin Pieringer,de GER,"MF,FW",Heidenheim,23.0,1999.0,16.8,19,12,5,11,3,8,20,40.0,12,28,4,24,12,31,21,0,Matches,2023-2024,Bundesliga
Alassane Pléa,fr FRA,"FW,MF",Gladbach,30.0,1993.0,21.3,17,7,5,8,4,7,15,46.7,8,11,0,11,2,19,6,0,Matches,2023-2024,Bundesliga
Ole Pohlmann,de GER,MF,Dortmund,22.0,2001.0,0.6,1,0,0,1,0,1,2,50.0,1,0,0,0,0,1,1,0,Matches,2023-2024,Bundesliga
Sebastian Polter,de GER,FW,Darmstadt 98,32.0,1991.0,5.0,1,0,1,0,0,0,1,0.0,1,5,1,4,0,1,4,0,Matches,2023-2024,Bundesliga
Yussuf Poulsen,dk DEN,FW,RB Leipzig,29.0,1994.0,13.5,13,8,1,9,3,4,14,28.6,10,13,3,10,4,17,15,0,Matches,2023-2024,Bundesliga
Grischa Prömel,de GER,MF,Hoffenheim,28.0,1995.0,23.8,32,18,11,15,6,14,32,43.8,18,22,6,16,22,54,36,0,Matches,2023-2024,Bundesliga
Gustavo Puerta,co COL,"DF,MF",Leverkusen,20.0,2003.0,0.5,5,3,2,2,1,1,2,50.0,1,2,0,2,0,5,0,0,Matches,2023-2024,Bundesliga
Luca Raimund,de GER,"FW,MF",Stuttgart,18.0,2005.0,0.3,3,1,2,1,0,0,0,,0,2,0,2,0,3,0,0,Matches,2023-2024,Bundesliga
Grant Ranos,am ARM,"MF,FW",Gladbach,20.0,2003.0,0.5,1,0,0,0,1,0,0,,0,0,0,0,0,1,0,0,Matches,2023-2024,Bundesliga
Nicolai Rapp,de GER,DF,Werder Bremen,26.0,1996.0,0.8,3,2,2,1,0,2,2,100.0,0,2,0,2,2,5,8,0,Matches,2023-2024,Bundesliga
David Raum,de GER,DF,RB Leipzig,25.0,1998.0,30.4,58,35,24,29,5,34,58,58.6,24,51,9,42,27,85,82,2,Matches,2023-2024,Bundesliga
Rocco Reitz,de GER,MF,Gladbach,21.0,2002.0,23.7,61,36,28,29,4,28,55,50.9,27,61,20,41,44,105,31,1,Matches,2023-2024,Bundesliga
Marco Reus,de GER,"MF,FW",Dortmund,34.0,1989.0,17.8,37,25,20,14,3,12,27,44.4,15,17,2,15,5,42,18,0,Matches,2023-2024,Bundesliga
Elvis Rexhbeçaj,xk KVX,MF,Augsburg,25.0,1997.0,22.1,30,19,14,13,3,18,36,50.0,18,32,7,25,20,50,20,0,Matches,2023-2024,Bundesliga
Gio Reyna,us USA,"MF,FW",Dortmund,20.0,2002.0,3.1,9,6,3,4,2,2,5,40.0,3,5,1,4,2,11,5,0,Matches,2023-2024,Bundesliga
Marco Richter,de GER,"MF,FW",Mainz 05,25.0,1997.0,8.0,10,4,5,3,2,4,11,36.4,7,9,0,9,2,12,1,0,Matches,2023-2024,Bundesliga
Clemens Riedel,de GER,DF,Darmstadt 98,20.0,2003.0,8.4,22,13,16,5,1,15,24,62.5,9,11,3,8,11,33,26,0,Matches,2023-2024,Bundesliga
Manuel Riemann,de GER,GK,Bochum,34.0,1988.0,33.0,2,1,2,0,0,2,4,50.0,2,0,0,0,1,3,25,1,Matches,2023-2024,Bundesliga
Sebastian Rode,de GER,MF,Eint Frankfurt,32.0,1990.0,0.7,6,4,0,5,1,4,6,66.7,2,0,0,0,1,7,1,0,Matches,2023-2024,Bundesliga
Rogério,br BRA,DF,Wolfsburg,25.0,1998.0,10.1,14,6,7,5,2,10,14,71.4,4,16,5,11,5,19,23,1,Matches,2023-2024,Bundesliga
Merlin Röhl,de GER,"MF,FW",Freiburg,21.0,2002.0,16.4,21,13,10,9,2,8,21,38.1,13,27,3,24,9,30,22,0,Matches,2023-2024,Bundesliga
Frank Ronstadt,de GER,"DF,MF",Darmstadt 98,26.0,1997.0,0.8,1,0,0,1,0,0,1,0.0,1,1,0,1,1,2,3,0,Matches,2023-2024,Bundesliga
Anthony Rouault,fr FRA,DF,Stuttgart,22.0,2001.0,11.2,21,12,14,5,2,13,21,61.9,8,14,8,6,8,29,28,0,Matches,2023-2024,Bundesliga
Jérôme Roussillon,fr FRA,DF,Union Berlin,30.0,1993.0,8.4,16,9,6,7,3,8,12,66.7,4,13,4,9,5,21,26,0,Matches,2023-2024,Bundesliga
Fabian Rüdlin,de GER,MF,Freiburg,26.0,1997.0,0.1,1,0,0,0,1,0,0,,0,0,0,0,0,1,0,0,Matches,2023-2024,Bundesliga
Julian Ryerson,no NOR,DF,Dortmund,25.0,1997.0,19.6,41,23,26,11,4,27,47,57.4,20,31,7,24,10,51,35,3,Matches,2023-2024,Bundesliga
Frederik Rønnow,dk DEN,GK,Union Berlin,30.0,1992.0,33.0,1,1,1,0,0,0,0,,0,0,0,0,1,2,20,2,Matches,2023-2024,Bundesliga
Marcel Sabitzer,at AUT,MF,Dortmund,29.0,1994.0,21.8,39,24,18,20,1,23,42,54.8,19,31,12,19,12,51,34,0,Matches,2023-2024,Bundesliga
Roland Sallai,hu HUN,"MF,FW",Freiburg,26.0,1997.0,20.4,17,10,5,5,7,8,20,40.0,12,21,1,20,6,23,23,0,Matches,2023-2024,Bundesliga
Diadie Samassékou,ml MLI,MF,Hoffenheim,27.0,1996.0,0.0,0,0,0,0,0,0,0,,0,0,0,0,1,1,0,0,Matches,2023-2024,Bundesliga
Jadon Sancho,eng ENG,"FW,MF",Dortmund,23.0,2000.0,10.5,5,4,1,3,1,0,4,0.0,4,11,0,11,4,9,6,0,Matches,2023-2024,Bundesliga
Leroy Sané,de GER,FW,Bayern Munich,27.0,1996.0,23.7,15,8,6,6,3,4,19,21.1,15,12,0,12,7,22,3,0,Matches,2023-2024,Bundesliga
Amin Sarr,se SWE,"FW,MF",Wolfsburg,22.0,2001.0,4.3,3,2,1,2,0,1,2,50.0,1,6,1,5,2,5,1,0,Matches,2023-2024,Bundesliga
Bouna Sarr,sn SEN,DF,Bayern Munich,31.0,1992.0,1.2,2,0,1,1,0,2,2,100.0,0,3,0,3,0,2,1,0,Matches,2023-2024,Bundesliga
Joe Scally,us USA,DF,Gladbach,20.0,2002.0,24.8,41,28,21,17,3,23,40,57.5,17,31,11,20,18,59,78,2,Matches,2023-2024,Bundesliga
András Schäfer,hu HUN,MF,Union Berlin,24.0,1999.0,13.5,29,16,9,15,5,11,20,55.0,9,25,4,21,20,49,25,0,Matches,2023-2024,Bundesliga
Patrik Schick,cz CZE,FW,Leverkusen,27.0,1996.0,11.8,6,4,0,3,3,1,5,20.0,4,2,0,2,1,7,7,0,Matches,2023-2024,Bundesliga
Stefan Schimmer,de GER,"MF,FW",Heidenheim,29.0,1994.0,1.7,1,1,0,1,0,0,3,0.0,3,2,0,2,1,2,6,0,Matches,2023-2024,Bundesliga
Xaver Schlager,at AUT,MF,RB Leipzig,25.0,1997.0,27.5,81,50,35,38,8,21,53,39.6,32,41,8,33,19,100,27,0,Matches,2023-2024,Bundesliga
Keven Schlotterbeck,de GER,DF,Bochum,26.0,1997.0,24.3,42,22,26,14,2,25,30,83.3,5,33,23,10,33,75,104,2,Matches,2023-2024,Bundesliga
Nico Schlotterbeck,de GER,DF,Dortmund,23.0,1999.0,31.8,70,50,36,27,7,41,65,63.1,24,52,25,27,45,115,101,3,Matches,2023-2024,Bundesliga
Romano Schmid,at AUT,"MF,FW",Werder Bremen,23.0,2000.0,28.9,35,20,7,22,6,14,46,30.4,32,36,7,29,11,46,17,2,Matches,2023-2024,Bundesliga
Kenneth Schmidt,de GER,DF,Freiburg,21.0,2002.0,0.8,2,2,2,0,0,2,4,50.0,2,1,0,1,1,3,2,0,Matches,2023-2024,Bundesliga
Benno Schmitz,de GER,DF,Köln,28.0,1994.0,12.8,27,15,20,7,0,17,34,50.0,17,19,4,15,7,34,29,0,Matches,2023-2024,Bundesliga
Fabian Schnellhardt,de GER,MF,Darmstadt 98,29.0,1994.0,2.6,4,1,2,1,1,1,3,33.3,2,1,0,1,4,8,5,0,Matches,2023-2024,Bundesliga
Jan Schöppner,de GER,MF,Heidenheim,24.0,1999.0,22.2,48,26,26,20,2,21,42,50.0,21,37,7,30,26,74,57,0,Matches,2023-2024,Bundesliga
Marcel Schuhen,de GER,GK,Darmstadt 98,30.0,1993.0,31.0,1,0,1,0,0,1,3,33.3,2,0,0,0,2,3,11,4,Matches,2023-2024,Bundesliga
Marvin Schwäbe,de GER,GK,Köln,28.0,1995.0,34.0,1,0,1,0,0,1,1,100.0,0,0,0,0,0,1,10,1,Matches,2023-2024,Bundesliga
Alexander Schwolow,de GER,GK,Union Berlin,31.0,1992.0,1.0,0,0,0,0,0,0,0,,0,0,0,0,0,0,2,0,Matches,2023-2024,Bundesliga
Nicolas Seiwald,at AUT,MF,RB Leipzig,22.0,2001.0,8.0,33,18,16,15,2,16,25,64.0,9,12,2,10,8,41,15,0,Matches,2023-2024,Bundesliga
Davie Selke,de GER,FW,Köln,28.0,1995.0,14.1,4,2,1,3,0,0,2,0.0,2,5,3,2,0,4,20,0,Matches,2023-2024,Bundesliga
Benjamin Šeško,si SVN,FW,RB Leipzig,20.0,2003.0,17.0,13,5,2,7,4,2,9,22.2,7,23,2,21,3,16,27,0,Matches,2023-2024,Bundesliga
Kevin Sessa,de GER,"MF,FW",Heidenheim,23.0,2000.0,11.2,17,10,9,6,2,7,16,43.8,9,12,1,11,4,21,17,0,Matches,2023-2024,Bundesliga
Aaron Seydel,de GER,FW,Darmstadt 98,27.0,1996.0,6.9,3,2,0,2,1,0,3,0.0,3,8,2,6,1,4,9,0,Matches,2023-2024,Bundesliga
Tim Siersleben,de GER,DF,Heidenheim,23.0,2000.0,10.1,27,11,21,6,0,8,20,40.0,12,16,10,6,21,48,29,1,Matches,2023-2024,Bundesliga
Kiliann Sildillia,fr FRA,DF,Freiburg,21.0,2002.0,20.1,43,19,28,8,7,26,42,61.9,16,33,15,18,22,65,64,0,Matches,2023-2024,Bundesliga
Mohamed Simakan,fr FRA,DF,RB Leipzig,23.0,2000.0,23.8,48,29,28,19,1,32,44,72.7,12,36,14,22,29,77,69,0,Matches,2023-2024,Bundesliga
Xavi Simons,nl NED,MF,RB Leipzig,20.0,2003.0,29.5,30,17,10,11,9,15,31,48.4,16,23,0,23,16,46,4,0,Matches,2023-2024,Bundesliga
Tim Skarke,de GER,"FW,DF",Darmstadt 98,26.0,1996.0,26.7,26,16,12,10,4,10,28,35.7,18,25,2,23,6,32,20,0,Matches,2023-2024,Bundesliga
Ellyes Skhiri,tn TUN,MF,Eint Frankfurt,28.0,1995.0,24.1,44,24,18,19,7,19,36,52.8,17,33,4,29,39,83,47,2,Matches,2023-2024,Bundesliga
Robert Skov,dk DEN,"DF,FW",Hoffenheim,27.0,1996.0,14.0,24,16,15,8,1,17,36,47.2,19,17,4,13,10,34,23,1,Matches,2023-2024,Bundesliga
Hrvoje Smolčić,hr CRO,DF,Eint Frankfurt,22.0,2000.0,3.9,7,3,7,0,0,4,5,80.0,1,3,1,2,6,13,23,1,Matches,2023-2024,Bundesliga
Danilo Soares,br BRA,DF,Bochum,31.0,1991.0,3.9,10,6,5,3,2,5,8,62.5,3,6,0,6,7,17,11,0,Matches,2023-2024,Bundesliga
Borna Sosa,hr CRO,"FW,DF",Stuttgart,25.0,1998.0,0.5,0,0,0,0,0,0,1,0.0,1,0,0,0,0,0,0,0,Matches,2023-2024,Bundesliga
Anton Stach,de GER,MF,Hoffenheim,24.0,1998.0,25.8,73,42,40,27,6,33,63,52.4,30,38,12,26,72,145,67,1,Matches,2023-2024,Bundesliga
Anton Stach,de GER,MF,Mainz 05,24.0,1998.0,1.9,3,0,2,0,1,2,4,50.0,2,5,0,5,2,5,5,0,Matches,2023-2024,Bundesliga
Jens Stage,dk DEN,MF,Werder Bremen,26.0,1996.0,25.9,52,22,21,23,8,18,50,36.0,32,42,23,19,23,75,55,0,Matches,2023-2024,Bundesliga
Josip Stanišić,hr CRO,DF,Leverkusen,23.0,2000.0,14.0,38,20,19,13,6,22,33,66.7,11,18,3,15,9,47,26,0,Matches,2023-2024,Bundesliga
Niklas Stark,de GER,DF,Werder Bremen,28.0,1995.0,12.1,26,15,13,11,2,12,18,66.7,6,14,7,7,19,45,61,1,Matches,2023-2024,Bundesliga
Pascal Stenzel,de GER,DF,Stuttgart,27.0,1996.0,11.8,18,8,7,9,2,10,30,33.3,20,22,8,14,15,33,26,0,Matches,2023-2024,Bundesliga
Leonidas Stergiou,ch SUI,DF,Stuttgart,21.0,2002.0,6.6,15,8,7,7,1,9,13,69.2,4,8,1,7,5,20,13,0,Matches,2023-2024,Bundesliga
Angelo Stiller,de GER,MF,Hoffenheim,22.0,2001.0,0.9,0,0,0,0,0,0,1,0.0,1,2,0,2,0,0,3,0,Matches,2023-2024,Bundesliga
Angelo Stiller,de GER,MF,Stuttgart,22.0,2001.0,29.9,55,33,15,34,6,24,42,57.1,18,41,13,28,28,83,25,2,Matches,2023-2024,Bundesliga
Kevin Stöger,at AUT,MF,Bochum,29.0,1993.0,29.6,49,30,21,21,7,25,63,39.7,38,46,4,42,19,68,18,0,Matches,2023-2024,Bundesliga
Filip Stojilković,ch SUI,"FW,MF",Darmstadt 98,23.0,2000.0,1.7,1,1,0,0,1,0,0,,0,0,0,0,0,1,1,0,Matches,2023-2024,Bundesliga
Niklas Süle,de GER,DF,Dortmund,27.0,1995.0,16.8,18,10,14,3,1,11,16,68.8,5,25,14,11,25,43,58,2,Matches,2023-2024,Bundesliga
Mattias Svanberg,se SWE,MF,Wolfsburg,24.0,1999.0,19.1,37,17,8,19,10,12,38,31.6,26,25,5,20,21,58,28,0,Matches,2023-2024,Bundesliga
Attila Szalai,hu HUN,DF,Hoffenheim,25.0,1998.0,3.2,3,1,3,0,0,1,4,25.0,3,6,2,4,1,4,7,0,Matches,2023-2024,Bundesliga
Attila Szalai,hu HUN,DF,Freiburg,25.0,1998.0,1.1,1,1,1,0,0,1,2,50.0,1,5,2,3,1,2,11,1,Matches,2023-2024,Bundesliga
Jonathan Tah,de GER,DF,Leverkusen,27.0,1996.0,29.2,19,9,10,7,2,5,16,31.3,11,28,23,5,23,42,97,1,Matches,2023-2024,Bundesliga
Edmond Tapsoba,bf BFA,DF,Leverkusen,24.0,1999.0,23.2,34,25,17,15,2,17,24,70.8,7,21,10,11,24,58,52,3,Matches,2023-2024,Bundesliga
Mathys Tel,fr FRA,"FW,MF",Bayern Munich,18.0,2005.0,11.7,12,2,3,4,5,4,6,66.7,2,11,0,11,6,18,6,0,Matches,2023-2024,Bundesliga
Nathan Tella,ng NGA,"DF,MF",Leverkusen,24.0,1999.0,9.1,13,8,6,5,2,5,10,50.0,5,10,0,10,3,16,8,0,Matches,2023-2024,Bundesliga
Norman Theuerkauf,de GER,"MF,DF",Heidenheim,36.0,1987.0,14.0,24,16,13,7,4,13,22,59.1,9,16,6,10,14,38,21,0,Matches,2023-2024,Bundesliga
Jan Thielmann,de GER,"FW,DF",Köln,21.0,2002.0,17.5,28,18,13,9,6,12,24,50.0,12,31,6,25,8,36,28,0,Matches,2023-2024,Bundesliga
Denis Thomalla,de GER,"MF,FW",Heidenheim,30.0,1992.0,5.0,9,6,4,4,1,5,11,45.5,6,3,2,1,4,13,13,0,Matches,2023-2024,Bundesliga
Phillip Tietz,de GER,FW,Augsburg,26.0,1997.0,26.5,23,14,7,13,3,6,15,40.0,9,17,3,14,6,29,35,0,Matches,2023-2024,Bundesliga
Steffen Tigges,de GER,FW,Köln,25.0,1998.0,8.1,10,6,4,5,1,3,7,42.9,4,4,2,2,1,11,12,0,Matches,2023-2024,Bundesliga
Umut Tohumcu,de GER,MF,Hoffenheim,18.0,2004.0,11.2,16,12,9,7,0,6,19,31.6,13,11,1,10,6,22,12,0,Matches,2023-2024,Bundesliga
Tiago Tomás,pt POR,"FW,MF",Wolfsburg,21.0,2002.0,11.5,5,2,3,0,2,1,6,16.7,5,13,0,13,3,8,9,0,Matches,2023-2024,Bundesliga
Fabio Torsiello,it ITA,"FW,DF",Darmstadt 98,18.0,2005.0,1.7,1,0,1,0,0,1,8,12.5,7,1,0,1,1,2,1,0,Matches,2023-2024,Bundesliga
Lucas Tousart,fr FRA,MF,Union Berlin,26.0,1997.0,17.5,35,20,14,17,4,17,37,45.9,20,32,9,23,25,60,41,0,Matches,2023-2024,Bundesliga
Omar Traoré,de GER,DF,Heidenheim,25.0,1998.0,27.5,60,33,33,21,6,32,56,57.1,24,32,7,25,40,100,54,1,Matches,2023-2024,Bundesliga
Kevin Trapp,de GER,GK,Eint Frankfurt,33.0,1990.0,32.0,0,0,0,0,0,0,0,,0,0,0,0,1,1,9,1,Matches,2023-2024,Bundesliga
Christopher Trimmel,at AUT,DF,Union Berlin,36.0,1987.0,18.3,23,15,12,10,1,13,33,39.4,20,16,3,13,13,36,57,0,Matches,2023-2024,Bundesliga
Tuta,br BRA,DF,Eint Frankfurt,24.0,1999.0,28.9,63,33,38,19,6,39,59,66.1,20,29,12,17,36,99,99,0,Matches,2023-2024,Bundesliga
Lukas Ullrich,de GER,"DF,FW",Gladbach,19.0,2004.0,0.5,1,0,1,0,0,1,4,25.0,3,0,0,0,0,1,1,0,Matches,2023-2024,Bundesliga
Sven Ulreich,de GER,GK,Bayern Munich,34.0,1988.0,11.0,1,0,1,0,0,1,1,100.0,0,0,0,0,0,1,3,2,Matches,2023-2024,Bundesliga
Deniz Undav,de GER,"FW,MF",Stuttgart,27.0,1996.0,23.2,28,13,6,8,14,4,15,26.7,11,17,0,17,6,34,5,0,Matches,2023-2024,Bundesliga
Dayot Upamecano,fr FRA,DF,Bayern Munich,24.0,1998.0,19.6,34,21,21,11,2,15,29,51.7,14,19,7,12,19,53,56,3,Matches,2023-2024,Bundesliga
Mark Uth,de GER,"MF,FW",Köln,31.0,1991.0,4.1,8,4,2,3,3,4,12,33.3,8,6,0,6,1,9,2,0,Matches,2023-2024,Bundesliga
Josha Vagnoman,de GER,DF,Stuttgart,22.0,2000.0,13.1,28,18,15,11,2,15,30,50.0,15,11,5,6,2,30,16,1,Matches,2023-2024,Bundesliga
Ruben Vargas,ch SUI,"MF,FW",Augsburg,24.0,1998.0,21.8,23,10,6,10,7,10,25,40.0,15,19,4,15,7,30,17,0,Matches,2023-2024,Bundesliga
Miloš Veljković,rs SRB,DF,Werder Bremen,27.0,1995.0,21.3,31,15,17,13,1,16,31,51.6,15,31,20,11,17,48,57,0,Matches,2023-2024,Bundesliga
Yorbe Vertessen,be BEL,"FW,MF",Union Berlin,22.0,2001.0,6.6,3,2,0,3,0,1,4,25.0,3,8,0,8,1,4,3,0,Matches,2023-2024,Bundesliga
Oscar Vilhelmsson,se SWE,"FW,MF",Darmstadt 98,19.0,2003.0,15.3,13,6,3,7,3,7,10,70.0,3,15,5,10,3,16,19,0,Matches,2023-2024,Bundesliga
Kevin Vogt,de GER,DF,Hoffenheim,31.0,1991.0,14.7,14,10,7,7,0,8,13,61.5,5,16,13,3,9,23,54,0,Matches,2023-2024,Bundesliga
Kevin Vogt,de GER,DF,Union Berlin,31.0,1991.0,14.7,10,9,6,4,0,6,12,50.0,6,22,15,7,7,17,72,2,Matches,2023-2024,Bundesliga
Kevin Volland,de GER,"FW,MF",Union Berlin,31.0,1992.0,14.9,22,9,8,8,6,8,20,40.0,12,8,0,8,6,28,12,0,Matches,2023-2024,Bundesliga
Aster Vranckx,be BEL,MF,Wolfsburg,20.0,2002.0,12.8,32,15,11,11,10,15,28,53.6,13,17,6,11,14,46,29,0,Matches,2023-2024,Bundesliga
Luca Waldschmidt,de GER,"MF,FW",Köln,27.0,1996.0,12.7,19,12,4,12,3,5,16,31.3,11,18,3,15,6,25,8,1,Matches,2023-2024,Bundesliga
Kjell-Arik Wätjen,de GER,"MF,FW",Dortmund,17.0,2006.0,1.2,3,2,2,1,0,2,5,40.0,3,1,1,0,0,3,3,0,Matches,2023-2024,Bundesliga
Wout Weghorst,nl NED,FW,Hoffenheim,30.0,1992.0,22.0,13,6,4,7,2,9,15,60.0,6,25,8,17,6,19,24,0,Matches,2023-2024,Bundesliga
Julian Weigl,de GER,MF,Gladbach,27.0,1995.0,30.7,66,40,28,32,6,41,67,61.2,26,47,14,33,48,114,61,1,Matches,2023-2024,Bundesliga
Nelson Weiper,de GER,"FW,MF",Mainz 05,18.0,2005.0,1.4,2,1,2,0,0,2,3,66.7,1,1,0,1,1,3,0,0,Matches,2023-2024,Bundesliga
Mitchell Weiser,de GER,"DF,MF",Werder Bremen,29.0,1994.0,29.3,64,38,29,25,10,31,53,58.5,22,36,6,30,20,84,43,0,Matches,2023-2024,Bundesliga
Noah Weißhaupt,de GER,"DF,FW",Freiburg,21.0,2001.0,8.4,9,4,6,0,3,5,11,45.5,6,8,1,7,8,17,12,0,Matches,2023-2024,Bundesliga
Timo Werner,de GER,"FW,MF",RB Leipzig,27.0,1996.0,2.3,2,1,0,1,1,0,0,,0,1,0,1,1,3,0,0,Matches,2023-2024,Bundesliga
Silvan Widmer,ch SUI,DF,Mainz 05,30.0,1993.0,13.8,23,10,12,8,3,17,28,60.7,11,18,5,13,16,39,37,0,Matches,2023-2024,Bundesliga
Patrick Wimmer,at AUT,"FW,MF",Wolfsburg,22.0,2001.0,6.5,14,5,5,5,4,8,18,44.4,10,14,0,14,3,17,7,0,Matches,2023-2024,Bundesliga
Jonas Wind,dk DEN,FW,Wolfsburg,24.0,1999.0,29.5,13,10,4,6,3,7,17,41.2,10,13,4,9,3,16,21,0,Matches,2023-2024,Bundesliga
Florian Wirtz,de GER,MF,Leverkusen,20.0,2003.0,26.4,27,18,7,14,6,9,29,31.0,20,36,2,34,9,36,3,0,Matches,2023-2024,Bundesliga
Maximilian Wittek,de GER,"DF,FW",Bochum,27.0,1995.0,11.9,23,17,9,11,3,13,21,61.9,8,12,1,11,18,41,23,0,Matches,2023-2024,Bundesliga
Maximilian Wöber,at AUT,DF,Gladbach,25.0,1998.0,23.0,66,31,40,25,1,31,53,58.5,22,47,26,21,38,104,111,0,Matches,2023-2024,Bundesliga
Marius Wolf,de GER,DF,Dortmund,28.0,1995.0,13.0,20,12,8,11,1,11,23,47.8,12,12,2,10,8,28,20,0,Matches,2023-2024,Bundesliga
Nick Woltemade,de GER,"FW,MF",Werder Bremen,21.0,2002.0,13.2,34,23,7,20,7,15,21,71.4,6,12,0,12,5,39,17,0,Matches,2023-2024,Bundesliga
Jeong Woo-yeong,kr KOR,"MF,FW",Stuttgart,23.0,1999.0,7.0,15,9,6,8,1,6,8,75.0,2,5,0,5,7,22,5,0,Matches,2023-2024,Bundesliga
Granit Xhaka,ch SUI,MF,Leverkusen,30.0,1992.0,31.3,29,21,11,14,4,9,30,30.0,21,29,8,21,19,48,42,0,Matches,2023-2024,Bundesliga
Dan-Axel Zagadou,fr FRA,DF,Stuttgart,24.0,1999.0,16.1,21,14,16,5,0,4,8,50.0,4,23,18,5,20,41,78,1,Matches,2023-2024,Bundesliga
Bryan Zaragoza,es ESP,"FW,MF",Bayern Munich,22.0,2001.0,2.0,4,4,2,1,1,3,3,100.0,0,0,0,0,2,6,0,0,Matches,2023-2024,Bundesliga
Robin Zentner,de GER,GK,Mainz 05,28.0,1994.0,30.0,2,2,2,0,0,2,5,40.0,3,1,0,1,1,3,19,1,Matches,2023-2024,Bundesliga
Cedric Zesiger,ch SUI,DF,Wolfsburg,25.0,1998.0,18.2,19,9,13,4,2,10,22,45.5,12,32,21,11,15,34,88,1,Matches,2023-2024,Bundesliga
Michael Zetterer,de GER,GK,Werder Bremen,28.0,1995.0,27.0,3,1,3,0,0,3,3,100.0,0,0,0,0,0,3,7,3,Matches,2023-2024,Bundesliga
Christoph Zimmermann,de GER,DF,Darmstadt 98,30.0,1993.0,13.6,33,21,26,7,0,19,39,48.7,20,21,14,7,21,54,66,1,Matches,2023-2024,Bundesliga
Simon Zoller,de GER,"FW,MF",Bochum,32.0,1991.0,0.5,0,0,0,0,0,0,0,,0,1,0,1,0,0,0,0,Matches,2023-2024,Bundesliga
Lovro Zvonarek,hr CRO,"FW,MF",Bayern Munich,18.0,2005.0,1.8,0,0,0,0,0,0,5,0.0,5,3,0,3,0,0,2,0,Matches,2023-2024,Bundesliga
Gennaro Acampora,it ITA,"MF,FW",Spezia,26.0,1994.0,4.9,6,4,1,4,1,2,7,28.6,5,4,1,3,4,10,4,0,Matches,2020-2021,Serie-A
Francesco Acerbi,it ITA,DF,Lazio,32.0,1988.0,31.3,51,32,34,13,4,18,40,45.0,22,24,15,9,76,127,121,2,Matches,2020-2021,Serie-A
Andrea Adorante,it ITA,FW,Parma,20.0,2000.0,0.1,0,0,0,0,0,0,0,,0,0,0,0,0,0,0,0,Matches,2020-2021,Serie-A
Lucien Agoume,fr FRA,MF,Spezia,18.0,2002.0,8.9,18,10,11,7,0,6,19,31.6,13,10,5,5,15,33,10,0,Matches,2020-2021,Serie-A
Kevin Agudelo,co COL,FW,Spezia,21.0,1998.0,15.1,39,28,9,15,15,12,34,35.3,22,30,0,30,10,49,2,0,Matches,2020-2021,Serie-A
Jean-Daniel Akpa-Akpro,ci CIV,MF,Lazio,27.0,1992.0,11.7,38,25,13,22,3,8,27,29.6,19,24,6,18,18,56,13,0,Matches,2020-2021,Serie-A
Luis Alberto,es ESP,MF,Lazio,27.0,1992.0,29.1,43,24,15,19,9,15,73,20.5,58,41,2,39,13,56,11,1,Matches,2020-2021,Serie-A
Bruno Alves,pt POR,DF,Parma,38.0,1981.0,18.1,13,10,10,3,0,7,9,77.8,2,17,12,5,26,39,81,0,Matches,2020-2021,Serie-A
Wisdom Amey,it ITA,DF,Bologna,14.0,2005.0,0.0,0,0,0,0,0,0,0,,0,0,0,0,0,0,0,0,Matches,2020-2021,Serie-A
Sofyan Amrabat,ma MAR,MF,Fiorentina,23.0,1996.0,27.1,39,22,11,24,4,18,48,37.5,30,30,5,25,23,62,12,0,Matches,2020-2021,Serie-A
Djavan Anderson,nl NED,DF,Lazio,25.0,1995.0,0.8,0,0,0,0,0,0,1,0.0,1,1,0,1,1,1,0,0,Matches,2020-2021,Serie-A
Nícolas Andrade,br BRA,GK,Udinese,32.0,1988.0,2.0,0,0,0,0,0,0,0,,0,0,0,0,0,0,0,0,Matches,2020-2021,Serie-A
Davide Angelo Ghislandi,it ITA,DF,Atalanta,19.0,2001.0,0.1,0,0,0,0,0,0,0,,0,0,0,0,0,0,1,0,Matches,2020-2021,Serie-A
Philip Ankhrah,gh GHA,MF,Hellas Verona,17.0,2002.0,0.1,0,0,0,0,0,0,0,,0,1,0,1,0,0,0,0,Matches,2020-2021,Serie-A
Cristian Ansaldi,ar ARG,"DF,FW",Torino,33.0,1986.0,21.6,48,33,25,14,9,24,38,63.2,14,21,7,14,16,64,38,0,Matches,2020-2021,Serie-A
Valentin Antov,bg BUL,DF,Bologna,19.0,2000.0,2.6,4,2,3,1,0,3,10,30.0,7,6,5,1,4,8,13,0,Matches,2020-2021,Serie-A
Nicolò Armini,it ITA,DF,Lazio,19.0,2001.0,0.1,0,0,0,0,0,0,0,,0,0,0,0,0,0,0,0,Matches,2020-2021,Serie-A
Tolgay Arslan,de GER,MF,Udinese,29.0,1990.0,20.2,52,32,24,24,4,25,54,46.3,29,22,2,20,22,74,15,1,Matches,2020-2021,Serie-A
Kwadwo Asamoah,gh GHA,"DF,MF",Cagliari,31.0,1988.0,2.5,4,3,2,2,0,2,3,66.7,1,5,1,4,4,8,2,1,Matches,2020-2021,Serie-A
Kristoffer Askildsen,no NOR,MF,Sampdoria,19.0,2001.0,1.1,0,0,0,0,0,0,0,,0,2,0,2,3,3,3,0,Matches,2020-2021,Serie-A
Emil Audero,id IDN,GK,Sampdoria,23.0,1997.0,37.0,1,1,1,0,0,1,2,50.0,1,0,0,0,1,2,16,0,Matches,2020-2021,Serie-A
Tommaso Augello,it ITA,DF,Sampdoria,25.0,1994.0,35.7,42,30,27,10,5,23,39,59.0,16,22,2,20,32,74,76,1,Matches,2020-2021,Serie-A
Kaan Ayhan,tr TUR,DF,Sassuolo,25.0,1994.0,8.8,15,9,8,5,2,8,13,61.5,5,9,5,4,16,31,33,0,Matches,2020-2021,Serie-A
Milan Badelj,hr CRO,MF,Genoa,31.0,1989.0,26.8,56,27,27,22,7,26,84,31.0,58,51,10,41,87,143,45,1,Matches,2020-2021,Serie-A
Tiemoué Bakayoko,fr FRA,MF,Napoli,25.0,1994.0,21.8,69,41,21,41,7,23,40,57.5,17,24,2,22,36,105,13,2,Matches,2020-2021,Serie-A
Keita Baldé,sn SEN,FW,Sampdoria,25.0,1995.0,13.3,9,6,2,6,1,4,10,40.0,6,10,1,9,0,9,3,0,Matches,2020-2021,Serie-A
Botond Balogh,hu HUN,DF,Parma,18.0,2002.0,1.8,9,7,9,0,0,2,5,40.0,3,4,3,1,2,11,8,0,Matches,2020-2021,Serie-A
Mattia Bani,it ITA,DF,Genoa,26.0,1993.0,10.2,10,5,5,5,0,5,12,41.7,7,16,11,5,27,37,44,0,Matches,2020-2021,Serie-A
Mattia Bani,it ITA,DF,Parma,26.0,1993.0,12.7,20,11,15,4,1,4,8,50.0,4,10,6,4,33,53,50,0,Matches,2020-2021,Serie-A
Antonín Barák,cz CZE,MF,Hellas Verona,25.0,1994.0,30.7,30,19,8,16,6,14,47,29.8,33,26,7,19,12,42,38,1,Matches,2020-2021,Serie-A
Federico Barba,it ITA,DF,Benevento,26.0,1993.0,29.5,31,16,22,8,1,21,35,60.0,14,39,18,21,48,79,94,4,Matches,2020-2021,Serie-A
Nicolò Barella,it ITA,MF,Inter,23.0,1997.0,32.2,58,31,23,29,6,23,72,31.9,49,29,4,25,26,84,14,0,Matches,2020-2021,Serie-A
Antonio Barreca,it ITA,DF,Fiorentina,25.0,1995.0,0.9,1,0,0,1,0,1,1,100.0,0,0,0,0,0,1,1,0,Matches,2020-2021,Serie-A
Musa Barrow,gm GAM,"FW,MF",Bologna,21.0,1998.0,32.5,26,10,8,10,8,10,25,40.0,15,37,2,35,11,37,15,0,Matches,2020-2021,Serie-A
Paolo Bartolomei,it ITA,MF,Spezia,30.0,1989.0,3.6,6,2,3,1,2,4,7,57.1,3,1,0,1,1,7,2,0,Matches,2020-2021,Serie-A
Daniele Baselli,it ITA,MF,Torino,28.0,1992.0,4.4,12,7,3,6,3,6,10,60.0,4,2,0,2,9,21,5,0,Matches,2020-2021,Serie-A
Alessandro Bastoni,it ITA,DF,Inter,21.0,1999.0,32.5,36,22,13,21,2,17,27,63.0,10,34,16,18,40,76,75,0,Matches,2020-2021,Serie-A
Simone Bastoni,it ITA,DF,Spezia,23.0,1996.0,16.9,50,29,26,22,2,27,52,51.9,25,19,1,18,16,66,31,0,Matches,2020-2021,Serie-A
Bastos,ao ANG,DF,Lazio,29.0,1991.0,0.7,3,1,2,0,1,3,5,60.0,2,1,0,1,0,3,3,0,Matches,2020-2021,Serie-A
Rodrigo Becão,br BRA,DF,Udinese,24.0,1996.0,30.9,59,33,36,20,3,27,49,55.1,22,48,27,21,68,127,94,2,Matches,2020-2021,Serie-A
Valon Behrami,ch SUI,MF,Genoa,35.0,1985.0,9.9,21,9,9,10,2,9,26,34.6,17,13,5,8,9,30,13,0,Matches,2020-2021,Serie-A
Andrea Belotti,it ITA,FW,Torino,26.0,1993.0,32.1,30,18,4,16,10,11,35,31.4,24,27,4,23,12,42,21,0,Matches,2020-2021,Serie-A
Ahmad Benali,ly LBY,MF,Crotone,28.0,1992.0,13.5,19,11,10,9,0,11,38,28.9,27,15,2,13,6,25,15,0,Matches,2020-2021,Serie-A
Ismaël Bennacer,dz ALG,MF,Milan,22.0,1997.0,14.7,39,18,17,21,1,15,32,46.9,17,10,1,9,20,59,12,0,Matches,2020-2021,Serie-A
Rodrigo Bentancur,uy URU,MF,Juventus,23.0,1997.0,25.8,63,33,21,37,5,20,59,33.9,39,35,12,23,47,110,46,1,Matches,2020-2021,Serie-A
Alessandro Berardi,it ITA,GK,Hellas Verona,29.0,1991.0,0.3,0,0,0,0,0,0,0,,0,0,0,0,0,0,0,0,Matches,2020-2021,Serie-A
Domenico Berardi,it ITA,FW,Sassuolo,25.0,1994.0,27.5,42,22,17,11,14,21,62,33.9,41,23,1,22,26,68,34,0,Matches,2020-2021,Serie-A
Álex Berenguer,es ESP,MF,Torino,25.0,1995.0,1.5,2,0,0,0,2,2,5,40.0,3,2,0,2,0,2,1,0,Matches,2020-2021,Serie-A
Bartosz Bereszyński,pl POL,DF,Sampdoria,28.0,1992.0,29.0,66,44,37,22,7,41,73,56.2,32,40,20,20,42,108,88,0,Matches,2020-2021,Serie-A
Federico Bernardeschi,it ITA,"MF,DF",Juventus,26.0,1994.0,10.8,9,4,3,5,1,4,20,20.0,16,6,2,4,14,23,7,1,Matches,2020-2021,Serie-A
Marco Bertini,it ITA,MF,Lazio,17.0,2002.0,0.1,1,0,1,0,0,0,0,,0,0,0,0,0,1,0,0,Matches,2020-2021,Serie-A
Daniel Bessa,it ITA,MF,Hellas Verona,27.0,1993.0,6.8,15,8,3,11,1,6,14,42.9,8,5,1,4,2,17,0,0,Matches,2020-2021,Serie-A
Cristiano Biraghi,it ITA,DF,Fiorentina,27.0,1992.0,31.1,42,23,19,15,8,27,45,60.0,18,23,9,14,27,69,56,3,Matches,2020-2021,Serie-A
Davide Biraschi,it ITA,DF,Genoa,26.0,1994.0,10.2,17,9,12,5,0,5,10,50.0,5,12,6,6,21,38,26,0,Matches,2020-2021,Serie-A
Jeremie Boga,ci CIV,"FW,MF",Sassuolo,23.0,1997.0,19.8,11,9,5,0,6,3,11,27.3,8,10,0,10,8,19,7,0,Matches,2020-2021,Serie-A
Giacomo Bonaventura,it ITA,MF,Fiorentina,30.0,1989.0,25.1,34,19,16,13,5,16,53,30.2,37,26,2,24,39,73,12,0,Matches,2020-2021,Serie-A
Federico Bonazzoli,it ITA,FW,Torino,23.0,1997.0,6.3,6,4,0,4,2,2,13,15.4,11,3,0,3,2,8,3,0,Matches,2020-2021,Serie-A
Federico Bonazzoli,it ITA,FW,Sampdoria,23.0,1997.0,1.5,0,0,0,0,0,0,0,,0,1,0,1,0,0,0,0,Matches,2020-2021,Serie-A
Kevin Bonifazi,it ITA,DF,Udinese,24.0,1996.0,27.4,32,21,24,6,2,8,23,34.8,15,33,20,13,50,82,85,1,Matches,2020-2021,Serie-A
Leonardo Bonucci,it ITA,DF,Juventus,33.0,1987.0,22.5,19,14,10,8,1,6,14,42.9,8,24,13,11,33,52,67,0,Matches,2020-2021,Serie-A
Mehdi Bourabia,ma MAR,MF,Sassuolo,28.0,1991.0,5.9,6,5,1,4,1,2,7,28.6,5,14,6,8,12,18,8,0,Matches,2020-2021,Serie-A
Edoardo Bove,it ITA,MF,Roma,18.0,2002.0,0.1,0,0,0,0,0,0,1,0.0,1,0,0,0,0,0,0,0,Matches,2020-2021,Serie-A
Jayden Braaf,nl NED,FW,Udinese,17.0,2002.0,1.3,0,0,0,0,0,0,1,0.0,1,0,0,0,0,0,0,0,Matches,2020-2021,Serie-A
Gleison Bremer,br BRA,DF,Torino,23.0,1997.0,32.6,51,34,36,14,1,21,36,58.3,15,54,21,33,70,121,142,1,Matches,2020-2021,Serie-A
Marcelo Brozović,hr CRO,MF,Inter,27.0,1992.0,28.7,54,29,23,24,7,20,61,32.8,41,43,17,26,40,94,38,0,Matches,2020-2021,Serie-A
Gastón Brugman,uy URU,MF,Parma,27.0,1992.0,18.0,35,19,18,15,2,11,44,25.0,33,33,4,29,45,80,34,0,Matches,2020-2021,Serie-A
Juan Brunetta,ar ARG,"FW,MF",Parma,23.0,1997.0,5.3,2,2,0,2,0,1,6,16.7,5,5,0,5,1,3,2,0,Matches,2020-2021,Serie-A
Gianluigi Buffon,it ITA,GK,Juventus,42.0,1978.0,8.0,0,0,0,0,0,0,0,,0,0,0,0,0,0,3,1,Matches,2020-2021,Serie-A
Alessandro Buongiorno,it ITA,DF,Torino,21.0,1999.0,9.5,12,5,8,4,0,7,12,58.3,5,15,9,6,11,23,44,1,Matches,2020-2021,Serie-A
Maxime Busi,be BEL,DF,Parma,20.0,1999.0,13.3,23,13,19,3,1,11,28,39.3,17,14,1,13,16,39,32,0,Matches,2020-2021,Serie-A
Martín Cáceres,uy URU,DF,Fiorentina,33.0,1987.0,24.9,28,12,16,11,1,15,35,42.9,20,20,14,6,14,42,52,1,Matches,2020-2021,Serie-A
Felipe Caicedo,ec ECU,FW,Lazio,31.0,1988.0,10.3,10,7,4,4,2,1,8,12.5,7,7,0,7,4,14,2,0,Matches,2020-2021,Serie-A
Arturo Calabresi,it ITA,"DF,FW",Bologna,24.0,1996.0,0.2,0,0,0,0,0,0,0,,0,0,0,0,0,0,2,0,Matches,2020-2021,Serie-A
Arturo Calabresi,it ITA,DF,Cagliari,24.0,1996.0,0.2,0,0,0,0,0,0,1,0.0,1,0,0,0,0,0,0,0,Matches,2020-2021,Serie-A
Davide Calabria,it ITA,DF,Milan,23.0,1996.0,29.4,101,64,61,32,8,54,90,60.0,36,42,9,33,37,138,82,1,Matches,2020-2021,Serie-A
Riccardo Calafiori,it ITA,DF,Roma,18.0,2002.0,0.7,1,0,1,0,0,1,4,25.0,3,1,0,1,0,1,0,0,Matches,2020-2021,Serie-A
Mattia Caldara,it ITA,DF,Atalanta,26.0,1994.0,1.2,1,0,0,1,0,1,1,100.0,0,3,2,1,4,5,3,0,Matches,2020-2021,Serie-A
Luca Caldirola,it ITA,DF,Benevento,29.0,1991.0,17.5,21,13,13,6,2,10,22,45.5,12,20,15,5,20,41,56,0,Matches,2020-2021,Serie-A
Hakan Çalhanoğlu,tr TUR,"MF,FW",Milan,26.0,1994.0,29.0,26,7,3,17,6,7,28,25.0,21,21,6,15,15,41,24,1,Matches,2020-2021,Serie-A
Fabrizio Caligara,it ITA,"MF,FW",Cagliari,20.0,2000.0,2.0,6,4,2,2,2,6,9,66.7,3,9,2,7,3,9,3,0,Matches,2020-2021,Serie-A
José Callejón,es ESP,"FW,MF",Fiorentina,33.0,1987.0,7.4,10,7,0,6,4,5,9,55.6,4,4,1,3,4,14,5,0,Matches,2020-2021,Serie-A
Drissa Camara,ci CIV,MF,Parma,18.0,2002.0,0.2,0,0,0,0,0,0,0,,0,0,0,0,0,0,0,0,Matches,2020-2021,Serie-A
Antonio Candreva,it ITA,MF,Sampdoria,33.0,1987.0,27.8,28,19,17,9,2,21,53,39.6,32,24,3,21,9,37,27,1,Matches,2020-2021,Serie-A
Elio Capradossi,ug UGA,DF,Spezia,24.0,1996.0,1.0,2,1,2,0,0,2,2,100.0,0,0,0,0,1,3,5,0,Matches,2020-2021,Serie-A
Gianluca Caprari,it ITA,"MF,FW",Benevento,27.0,1993.0,20.7,16,11,5,5,6,6,31,19.4,25,19,1,18,18,34,8,0,Matches,2020-2021,Serie-A
Francesco Caputo,it ITA,FW,Sassuolo,32.0,1987.0,18.9,0,0,0,0,0,0,2,0.0,2,4,0,4,1,1,3,0,Matches,2020-2021,Serie-A
Andrea Carboni,it ITA,DF,Cagliari,19.0,2001.0,12.1,34,23,23,11,0,15,28,53.6,13,15,4,11,14,48,52,0,Matches,2020-2021,Serie-A
Giuseppe Caso,it ITA,"DF,FW",Genoa,21.0,1998.0,0.6,0,0,0,0,0,0,0,,0,0,0,0,0,0,0,0,Matches,2020-2021,Serie-A
Francesco Cassata,it ITA,"DF,FW",Genoa,23.0,1997.0,2.5,7,6,7,0,0,4,7,57.1,3,0,0,0,3,10,1,0,Matches,2020-2021,Serie-A
Samu Castillejo,es ESP,FW,Milan,25.0,1995.0,13.1,24,12,9,14,1,14,40,35.0,26,21,0,21,6,30,9,0,Matches,2020-2021,Serie-A
Gaetano Castrovilli,it ITA,MF,Fiorentina,23.0,1997.0,25.9,33,19,15,11,7,11,42,26.2,31,25,2,23,34,67,14,0,Matches,2020-2021,Serie-A
Danilo Cataldi,it ITA,MF,Lazio,25.0,1994.0,6.3,7,2,1,5,1,4,18,22.2,14,3,1,2,9,16,7,0,Matches,2020-2021,Serie-A
Federico Ceccherini,it ITA,DF,Hellas Verona,28.0,1992.0,19.3,16,12,10,6,0,2,7,28.6,5,15,8,7,40,56,60,0,Matches,2020-2021,Serie-A
Federico Ceccherini,it ITA,DF,Fiorentina,28.0,1992.0,3.0,4,1,1,3,0,1,1,100.0,0,6,5,1,7,11,15,0,Matches,2020-2021,Serie-A
Luca Ceppitelli,it ITA,DF,Cagliari,30.0,1989.0,16.3,25,19,13,10,2,14,26,53.8,12,23,12,11,25,50,58,1,Matches,2020-2021,Serie-A
Alberto Cerri,it ITA,FW,Cagliari,24.0,1996.0,4.1,3,2,0,2,1,0,5,0.0,5,4,2,2,2,5,6,0,Matches,2020-2021,Serie-A
Julian Chabot,de GER,DF,Spezia,22.0,1998.0,18.4,48,34,28,16,4,23,37,62.2,14,25,13,12,37,85,43,1,Matches,2020-2021,Serie-A
Giorgio Chiellini,it ITA,DF,Juventus,35.0,1984.0,15.4,12,9,9,3,0,5,11,45.5,6,18,13,5,27,39,56,0,Matches,2020-2021,Serie-A
Federico Chiesa,it ITA,DF,Fiorentina,22.0,1997.0,2.7,6,2,2,2,2,3,8,37.5,5,3,1,2,1,7,3,0,Matches,2020-2021,Serie-A
Federico Chiesa,it ITA,"MF,DF",Juventus,22.0,1997.0,24.6,47,26,21,14,12,19,50,38.0,31,23,1,22,12,59,16,0,Matches,2020-2021,Serie-A
Vlad Chiricheș,ro ROU,DF,Sassuolo,30.0,1989.0,20.4,38,23,34,3,1,21,35,60.0,14,31,21,10,50,88,59,2,Matches,2020-2021,Serie-A
Luca Cigarini,it ITA,MF,Crotone,34.0,1986.0,10.3,26,14,11,12,3,12,28,42.9,16,10,1,9,12,38,9,0,Matches,2020-2021,Serie-A
Antonio Cioffi,it ITA,FW,Napoli,17.0,2002.0,0.1,0,0,0,0,0,0,0,,0,1,0,1,1,1,0,0,Matches,2020-2021,Serie-A
Ebrima Colley,gm GAM,"MF,FW",Hellas Verona,20.0,2000.0,8.2,11,4,2,6,3,3,11,27.3,8,6,0,6,6,17,1,0,Matches,2020-2021,Serie-A
Omar Colley,gm GAM,DF,Sampdoria,27.0,1992.0,28.8,28,16,19,8,1,13,23,56.5,10,43,29,14,68,96,133,1,Matches,2020-2021,Serie-A
Simone Colombi,it ITA,GK,Parma,29.0,1991.0,2.0,0,0,0,0,0,0,0,,0,0,0,0,0,0,2,0,Matches,2020-2021,Serie-A
Lorenzo Colombo,it ITA,FW,Milan,18.0,2002.0,1.0,2,1,1,1,0,0,3,0.0,3,0,0,0,0,2,3,0,Matches,2020-2021,Serie-A
Andrea Consigli,it ITA,GK,Sassuolo,33.0,1987.0,37.0,2,2,2,0,0,2,2,100.0,0,0,0,0,0,2,14,4,Matches,2020-2021,Serie-A
Andrea Conti,it ITA,DF,Milan,26.0,1994.0,0.3,1,1,1,0,0,0,1,0.0,1,0,0,0,1,2,0,0,Matches,2020-2021,Serie-A
Andrea Conti,it ITA,DF,Parma,26.0,1994.0,9.0,21,10,16,4,1,13,26,50.0,13,13,4,9,16,37,23,0,Matches,2020-2021,Serie-A
Alex Cordaz,it ITA,GK,Crotone,37.0,1983.0,36.0,0,0,0,0,0,0,0,,0,0,0,0,1,1,7,2,Matches,2020-2021,Serie-A
Andreas Cornelius,dk DEN,FW,Parma,27.0,1993.0,21.1,11,4,1,5,5,2,12,16.7,10,9,2,7,1,12,25,1,Matches,2020-2021,Serie-A
Joaquín Correa,ar ARG,FW,Lazio,25.0,1994.0,21.5,21,12,6,11,4,7,25,28.0,18,14,0,14,7,28,12,0,Matches,2020-2021,Serie-A
Félix Correia,pt POR,MF,Juventus,19.0,2001.0,0.1,0,0,0,0,0,0,0,,0,0,0,0,0,0,1,0,Matches,2020-2021,Serie-A
Douglas Costa,br BRA,"MF,FW",Juventus,29.0,1990.0,0.5,1,0,1,0,0,1,3,33.3,2,0,0,0,0,1,0,0,Matches,2020-2021,Serie-A
Angelo da Costa Júnior,br BRA,GK,Bologna,36.0,1983.0,6.0,0,0,0,0,0,0,0,,0,0,0,0,0,0,2,3,Matches,2020-2021,Serie-A
Mamadou Coulibaly,sn SEN,MF,Udinese,21.0,1999.0,2.0,10,8,5,5,0,0,0,,0,2,0,2,1,11,0,0,Matches,2020-2021,Serie-A
Alessio Cragno,it ITA,GK,Cagliari,26.0,1994.0,34.0,0,0,0,0,0,0,1,0.0,1,0,0,0,1,1,10,0,Matches,2020-2021,Serie-A
Gian Crespi,it ITA,GK,Crotone,19.0,2001.0,1.0,0,0,0,0,0,0,0,,0,0,0,0,0,0,0,0,Matches,2020-2021,Serie-A
Domenico Criscito,it ITA,DF,Genoa,33.0,1986.0,19.2,43,22,29,11,3,22,39,56.4,17,27,14,13,44,87,51,0,Matches,2020-2021,Serie-A
Bryan Cristante,it ITA,"DF,MF",Roma,25.0,1995.0,23.9,27,20,10,14,3,10,28,35.7,18,21,7,14,40,67,61,1,Matches,2020-2021,Serie-A
Giovanni Crociata,it ITA,DF,Crotone,22.0,1997.0,0.3,1,0,0,1,0,0,1,0.0,1,1,0,1,0,1,0,0,Matches,2020-2021,Serie-A
Juan Cuadrado,co COL,"DF,MF",Juventus,32.0,1988.0,24.2,43,25,22,15,6,29,60,48.3,31,16,2,14,43,86,22,2,Matches,2020-2021,Serie-A
Giuseppe Cuomo,it ITA,DF,Crotone,22.0,1998.0,8.9,26,19,17,9,0,9,14,64.3,5,10,2,8,18,44,19,1,Matches,2020-2021,Serie-A
Patrick Cutrone,it ITA,FW,Fiorentina,22.0,1998.0,2.2,4,3,1,2,1,1,2,50.0,1,1,0,1,1,5,0,0,Matches,2020-2021,Serie-A
Wylan Cyprien,fr FRA,MF,Parma,25.0,1995.0,4.6,9,4,5,3,1,2,4,50.0,2,13,8,5,5,14,6,1,Matches,2020-2021,Serie-A
Lennart-Marten Czyborra,de GER,DF,Genoa,21.0,1999.0,13.0,19,10,7,7,5,11,19,57.9,8,6,1,5,17,36,27,0,Matches,2020-2021,Serie-A
Danilo D'Ambrosio,it ITA,DF,Inter,31.0,1988.0,7.8,15,9,6,7,2,6,15,40.0,9,9,7,2,4,19,15,0,Matches,2020-2021,Serie-A
Bryan Dabo,bf BFA,MF,Benevento,28.0,1992.0,12.4,11,8,5,3,3,5,16,31.3,11,7,1,6,13,24,16,0,Matches,2020-2021,Serie-A
Diogo Dalot,pt POR,DF,Milan,21.0,1999.0,12.1,32,17,23,6,3,17,34,50.0,17,18,5,13,25,57,42,0,Matches,2020-2021,Serie-A
Mikkel Damsgaard,dk DEN,"MF,FW",Sampdoria,20.0,2000.0,19.7,42,21,14,20,8,22,70,31.4,48,40,4,36,24,66,17,0,Matches,2020-2021,Serie-A
Danilo,br BRA,"DF,MF",Juventus,29.0,1991.0,32.4,62,31,37,16,9,35,66,53.0,31,32,12,20,66,128,68,2,Matches,2020-2021,Serie-A
Andrea Danzi,it ITA,DF,Hellas Verona,21.0,1999.0,1.2,0,0,0,0,0,0,1,0.0,1,0,0,0,3,3,1,0,Matches,2020-2021,Serie-A
Ebrima Darboe,gm GAM,MF,Roma,19.0,2001.0,3.6,5,2,3,1,1,3,10,30.0,7,3,0,3,8,13,0,1,Matches,2020-2021,Serie-A
Matteo Darmian,it ITA,DF,Parma,30.0,1989.0,2.3,6,5,3,3,0,4,7,57.1,3,2,0,2,6,12,7,0,Matches,2020-2021,Serie-A
Matteo Darmian,it ITA,DF,Inter,30.0,1989.0,12.9,30,16,12,7,11,16,28,57.1,12,9,2,7,17,47,35,0,Matches,2020-2021,Serie-A
Paweł Dawidowicz,pl POL,DF,Hellas Verona,25.0,1995.0,20.7,42,28,30,10,2,14,24,58.3,10,28,19,9,27,69,62,1,Matches,2020-2021,Serie-A
Sebastien De Maio,fr FRA,DF,Udinese,33.0,1987.0,9.5,15,10,6,9,0,4,5,80.0,1,16,9,7,18,33,41,0,Matches,2020-2021,Serie-A
Rodrigo De Paul,ar ARG,MF,Udinese,26.0,1994.0,35.6,41,24,17,22,2,15,60,25.0,45,32,1,31,17,58,20,1,Matches,2020-2021,Serie-A
Mattia De Sciglio,it ITA,DF,Juventus,27.0,1992.0,0.3,0,0,0,0,0,0,0,,0,0,0,0,0,0,1,0,Matches,2020-2021,Serie-A
Lorenzo De Silvestri,it ITA,DF,Bologna,32.0,1988.0,23.8,34,24,18,13,3,16,37,43.2,21,37,10,27,30,64,62,3,Matches,2020-2021,Serie-A
Grégoire Defrel,mq MTQ,"MF,FW",Sassuolo,29.0,1991.0,14.8,13,8,5,5,3,5,12,41.7,7,9,0,9,7,20,5,0,Matches,2020-2021,Serie-A
Alessandro Deiola,it ITA,MF,Spezia,24.0,1995.0,4.0,6,3,2,3,1,5,13,38.5,8,3,1,2,3,9,1,0,Matches,2020-2021,Serie-A
Alessandro Deiola,it ITA,MF,Cagliari,24.0,1995.0,6.8,13,5,5,4,4,8,23,34.8,15,7,2,5,11,24,11,0,Matches,2020-2021,Serie-A
Lorenzo Del Pinto,it ITA,MF,Benevento,30.0,1990.0,0.1,0,0,0,0,0,0,2,0.0,2,0,0,0,0,0,0,0,Matches,2020-2021,Serie-A
Cristian Dell'Orco,it ITA,DF,Spezia,26.0,1994.0,2.9,1,0,1,0,0,1,3,33.3,2,8,5,3,7,8,9,1,Matches,2020-2021,Serie-A
Merih Demiral,tr TUR,DF,Juventus,22.0,1998.0,10.4,12,9,8,4,0,5,13,38.5,8,16,9,7,21,33,40,0,Matches,2020-2021,Serie-A
Diego Demme,de GER,MF,Napoli,28.0,1991.0,17.7,56,32,26,22,8,23,63,36.5,40,14,1,13,11,67,15,1,Matches,2020-2021,Serie-A
Stefano Denswil,sr SUR,DF,Bologna,27.0,1993.0,1.3,2,1,1,1,0,0,1,0.0,1,1,0,1,1,3,1,0,Matches,2020-2021,Serie-A
Fabio Depaoli,it ITA,DF,Benevento,23.0,1997.0,12.4,25,13,15,6,4,15,32,46.9,17,16,4,12,12,37,38,0,Matches,2020-2021,Serie-A
Fabio Depaoli,it ITA,MF,Sampdoria,23.0,1997.0,0.9,1,0,0,1,0,0,2,0.0,2,0,0,0,1,2,1,0,Matches,2020-2021,Serie-A
Fabio Depaoli,it ITA,DF,Atalanta,23.0,1997.0,2.1,3,2,0,1,2,1,2,50.0,1,4,0,4,3,6,2,0,Matches,2020-2021,Serie-A
Kastriot Dermaku,al ALB,DF,Parma,28.0,1992.0,1.1,1,1,1,0,0,0,0,,0,2,1,1,2,3,8,0,Matches,2020-2021,Serie-A
Kiril Despodov,bg BUL,FW,Cagliari,23.0,1996.0,0.1,1,1,0,1,0,1,1,100.0,0,0,0,0,0,1,0,0,Matches,2020-2021,Serie-A
Mattia Destro,it ITA,FW,Genoa,29.0,1991.0,17.8,6,3,0,3,3,2,9,22.2,7,11,0,11,4,10,8,0,Matches,2020-2021,Serie-A
Gerard Deulofeu,es ESP,"FW,MF",Udinese,26.0,1994.0,6.6,2,2,1,1,0,2,12,16.7,10,2,0,2,3,5,0,0,Matches,2020-2021,Serie-A
Jacopo Dezi,it ITA,"FW,MF",Parma,28.0,1992.0,0.9,4,3,0,2,2,3,6,50.0,3,2,0,2,0,4,0,0,Matches,2020-2021,Serie-A
Samuel Di Carmine,it ITA,FW,Hellas Verona,31.0,1988.0,5.6,1,2,0,1,0,0,3,0.0,3,1,0,1,0,1,5,0,Matches,2020-2021,Serie-A
Samuel Di Carmine,it ITA,FW,Crotone,31.0,1988.0,5.3,2,2,1,0,1,1,3,33.3,2,2,0,2,0,2,5,0,Matches,2020-2021,Serie-A
Giovanni Di Lorenzo,it ITA,DF,Napoli,26.0,1993.0,36.0,79,50,54,21,4,43,75,57.3,32,37,13,24,35,114,64,1,Matches,2020-2021,Serie-A
Alessandro Di Pardo,it ITA,"FW,DF",Juventus,21.0,1999.0,0.2,0,0,0,0,0,0,0,,0,1,1,0,0,0,0,0,Matches,2020-2021,Serie-A
Giuseppe Di Serio,it ITA,"FW,MF",Benevento,19.0,2001.0,3.2,2,2,1,1,0,0,4,0.0,4,5,0,5,0,2,4,0,Matches,2020-2021,Serie-A
Amad Diallo,ci CIV,MF,Atalanta,18.0,2002.0,0.2,0,0,0,0,0,0,0,,0,0,0,0,0,0,0,0,Matches,2020-2021,Serie-A
Amadou Diambo,gh GHA,FW,Benevento,19.0,2001.0,0.0,0,0,0,0,0,0,0,,0,0,0,0,0,0,0,0,Matches,2020-2021,Serie-A
Amadou Diawara,gn GUI,MF,Roma,23.0,1997.0,7.3,10,8,4,6,0,2,8,25.0,6,11,2,9,12,22,4,0,Matches,2020-2021,Serie-A
Brahim Díaz,ma MAR,"MF,FW",Milan,20.0,1999.0,13.6,18,10,7,7,4,10,23,43.5,13,10,0,10,2,20,2,0,Matches,2020-2021,Serie-A
Daan Dierckx,be BEL,DF,Parma,17.0,2003.0,5.2,5,4,5,0,0,3,5,60.0,2,10,6,4,13,18,21,0,Matches,2020-2021,Serie-A
Mitchell Dijks,nl NED,DF,Bologna,27.0,1993.0,16.5,21,14,15,5,1,12,21,57.1,9,17,2,15,17,38,35,0,Matches,2020-2021,Serie-A
Federico Dimarco,it ITA,DF,Hellas Verona,22.0,1997.0,29.0,32,19,23,7,2,13,28,46.4,15,18,9,9,47,79,50,1,Matches,2020-2021,Serie-A
Koffi Djidji,ci CIV,DF,Crotone,27.0,1992.0,16.9,39,28,30,8,1,10,20,50.0,10,35,20,15,28,67,73,0,Matches,2020-2021,Serie-A
Berat Djimsiti,al ALB,DF,Atalanta,27.0,1993.0,29.2,41,29,27,12,2,17,34,50.0,17,34,20,14,62,103,89,1,Matches,2020-2021,Serie-A
Nicolás Domínguez,ar ARG,MF,Bologna,22.0,1998.0,13.9,48,28,26,17,5,15,37,40.5,22,26,7,19,24,72,20,0,Matches,2020-2021,Serie-A
Gianluigi Donnarumma,it ITA,GK,Milan,21.0,1999.0,37.0,0,0,0,0,0,0,1,0.0,1,1,0,1,1,1,23,2,Matches,2020-2021,Serie-A
Bartłomiej Drągowski,pl POL,GK,Fiorentina,22.0,1997.0,35.0,1,0,1,0,0,1,1,100.0,0,0,0,0,1,2,13,1,Matches,2020-2021,Serie-A
Denis Drăguș,ro ROU,"FW,MF",Crotone,21.0,1999.0,2.0,3,1,0,0,3,0,4,0.0,4,4,0,4,1,4,0,0,Matches,2020-2021,Serie-A
Radu Drăgușin,ro ROU,DF,Juventus,18.0,2002.0,0.0,0,0,0,0,0,0,0,,0,0,0,0,0,0,0,0,Matches,2020-2021,Serie-A
Léo Duarte,br BRA,DF,Milan,24.0,1996.0,0.2,1,1,0,1,0,0,0,,0,0,0,0,1,2,0,0,Matches,2020-2021,Serie-A
Alfred Duncan,gh GHA,MF,Fiorentina,27.0,1993.0,1.8,3,0,1,1,1,0,2,0.0,2,2,0,2,2,5,0,0,Matches,2020-2021,Serie-A
Alfred Duncan,gh GHA,MF,Cagliari,27.0,1993.0,11.9,18,10,8,9,1,4,21,19.0,17,8,0,8,16,34,8,1,Matches,2020-2021,Serie-A
Paulo Dybala,ar ARG,FW,Juventus,26.0,1993.0,12.6,14,8,3,4,7,2,14,14.3,12,15,0,15,1,15,1,0,Matches,2020-2021,Serie-A
Edin Džeko,ba BIH,FW,Roma,34.0,1986.0,20.3,8,6,2,3,3,3,9,33.3,6,9,4,5,1,9,11,0,Matches,2020-2021,Serie-A
Steeve-Mike Ebongue,fr FRA,MF,Genoa,19.0,2001.0,0.6,2,1,1,0,1,0,3,0.0,3,1,0,1,0,2,0,0,Matches,2020-2021,Serie-A
Simone Edera,it ITA,"DF,MF",Torino,23.0,1997.0,0.6,3,1,2,1,0,3,4,75.0,1,0,0,0,1,4,1,0,Matches,2020-2021,Serie-A
Albin Ekdal,se SWE,MF,Sampdoria,31.0,1989.0,25.5,56,29,21,32,3,23,65,35.4,42,31,12,19,49,105,35,0,Matches,2020-2021,Serie-A
Elif Elmas,mk MKD,"MF,FW",Napoli,20.0,1999.0,8.2,15,4,3,6,6,7,12,58.3,5,11,1,10,2,17,10,0,Matches,2020-2021,Serie-A
Alan Empereur,br BRA,DF,Hellas Verona,26.0,1994.0,2.4,0,0,0,0,0,0,0,,0,1,1,0,6,6,7,1,Matches,2020-2021,Serie-A
Christian Eriksen,dk DEN,MF,Inter,28.0,1992.0,15.4,12,6,6,4,2,7,20,35.0,13,16,1,15,9,21,13,1,Matches,2020-2021,Serie-A
Martin Erlic,hr CRO,DF,Spezia,22.0,1998.0,20.0,23,14,16,6,1,11,20,55.0,9,22,16,6,41,64,71,2,Matches,2020-2021,Serie-A
Gonzalo Escalante,ar ARG,MF,Lazio,27.0,1993.0,8.1,26,13,11,14,1,8,28,28.6,20,10,3,7,19,45,13,0,Matches,2020-2021,Serie-A
Nahuel Estévez,ar ARG,MF,Spezia,24.0,1995.0,19.6,13,5,4,6,3,5,32,15.6,27,23,5,18,20,33,22,1,Matches,2020-2021,Serie-A
Valentin Eysseric,fr FRA,"MF,FW",Fiorentina,28.0,1992.0,8.1,14,8,6,7,1,5,11,45.5,6,11,0,11,7,21,8,0,Matches,2020-2021,Serie-A
Nicolò Fagioli,it ITA,MF,Juventus,19.0,2001.0,0.2,0,0,0,0,0,0,0,,0,0,0,0,0,0,1,0,Matches,2020-2021,Serie-A
Iago Falque,es ESP,"MF,FW",Benevento,30.0,1990.0,4.0,4,2,2,2,0,1,6,16.7,5,4,1,3,0,4,1,0,Matches,2020-2021,Serie-A
Andri Fannar Baldursson,is ISL,MF,Bologna,18.0,2002.0,2.4,6,6,1,2,3,1,3,33.3,2,3,1,2,3,9,7,0,Matches,2020-2021,Serie-A
Paolo Faragò,it ITA,DF,Bologna,27.0,1993.0,0.3,1,1,1,0,0,1,2,50.0,1,1,0,1,0,1,0,0,Matches,2020-2021,Serie-A
Paolo Faragò,it ITA,DF,Cagliari,27.0,1993.0,4.1,13,9,10,3,0,9,20,45.0,11,3,2,1,6,19,15,0,Matches,2020-2021,Serie-A
Davide Faraoni,it ITA,DF,Hellas Verona,28.0,1991.0,32.1,62,33,36,19,7,28,51,54.9,23,48,17,31,49,111,83,1,Matches,2020-2021,Serie-A
Mohamed Fares,dz ALG,DF,Lazio,24.0,1996.0,12.7,20,15,9,7,4,11,19,57.9,8,14,1,13,16,36,21,0,Matches,2020-2021,Serie-A
Diego Farias,br BRA,FW,Spezia,30.0,1990.0,16.8,9,5,4,1,4,4,21,19.0,17,12,0,12,13,22,3,0,Matches,2020-2021,Serie-A
Andrea Favilli,it ITA,FW,Hellas Verona,23.0,1997.0,3.8,3,1,0,1,2,2,3,66.7,1,2,0,2,0,3,2,0,Matches,2020-2021,Serie-A
Federico Fazio,ar ARG,DF,Roma,33.0,1987.0,4.5,3,2,3,0,0,3,4,75.0,1,3,3,0,7,10,18,1,Matches,2020-2021,Serie-A
Luiz Felipe,it ITA,DF,Lazio,23.0,1997.0,10.1,32,20,19,11,2,16,24,66.7,8,20,9,11,21,53,29,1,Matches,2020-2021,Serie-A
Alex Ferrari,it ITA,DF,Sampdoria,26.0,1994.0,9.8,27,15,16,9,2,15,24,62.5,9,18,6,12,23,50,26,0,Matches,2020-2021,Serie-A
Salvador Ferrer,es ESP,DF,Spezia,22.0,1998.0,13.2,20,10,10,8,2,8,22,36.4,14,13,4,9,24,44,37,1,Matches,2020-2021,Serie-A
Marco Festa,it ITA,GK,Crotone,28.0,1992.0,1.0,0,0,0,0,0,0,0,,0,0,0,0,0,0,0,0,Matches,2020-2021,Serie-A
Fernando Forestieri,it ITA,"FW,MF",Udinese,30.0,1990.0,6.1,9,7,4,4,1,3,7,42.9,4,7,0,7,2,11,0,0,Matches,2020-2021,Serie-A
Daam Foulon,be BEL,DF,Benevento,21.0,1999.0,11.3,26,15,21,5,0,16,28,57.1,12,12,3,9,14,40,34,0,Matches,2020-2021,Serie-A
Gianluca Frabotta,it ITA,"DF,MF",Juventus,21.0,1999.0,7.7,7,4,5,0,2,5,12,41.7,7,9,1,8,14,21,15,0,Matches,2020-2021,Serie-A
Remo Freuler,ch SUI,MF,Atalanta,28.0,1992.0,30.1,63,39,17,38,8,32,76,42.1,44,52,4,48,39,102,27,2,Matches,2020-2021,Serie-A
Daniel Fuzato,br BRA,GK,Roma,23.0,1997.0,5.0,0,0,0,0,0,0,0,,0,1,0,1,0,0,1,1,Matches,2020-2021,Serie-A
Matteo Gabbia,it ITA,DF,Milan,20.0,1999.0,6.2,9,5,3,6,0,2,2,100.0,0,8,6,2,3,12,21,0,Matches,2020-2021,Serie-A
Manolo Gabbiadini,it ITA,FW,Sampdoria,28.0,1991.0,9.7,2,2,0,2,0,0,1,0.0,1,3,1,2,3,5,5,0,Matches,2020-2021,Serie-A
Roberto Gagliardini,it ITA,MF,Inter,26.0,1994.0,13.7,30,17,17,8,5,5,28,17.9,23,15,3,12,19,49,16,0,Matches,2020-2021,Serie-A
Riccardo Gagliolo,se SWE,DF,Parma,30.0,1990.0,21.7,45,18,35,8,2,28,45,62.2,17,34,7,27,36,81,64,1,Matches,2020-2021,Serie-A
Adolfo Gaich,ar ARG,FW,Benevento,21.0,1999.0,8.5,9,4,1,7,1,1,13,7.7,12,4,0,4,2,11,4,0,Matches,2020-2021,Serie-A
Andrey Galabinov,bg BUL,FW,Spezia,31.0,1988.0,4.8,2,1,1,1,0,1,3,33.3,2,2,0,2,0,2,5,0,Matches,2020-2021,Serie-A
Manuel Gasparini,it ITA,GK,Udinese,18.0,2002.0,0.0,0,0,0,0,0,0,0,,0,0,0,0,0,0,0,0,Matches,2020-2021,Serie-A
Gervinho,ci CIV,FW,Parma,33.0,1987.0,22.5,5,1,2,2,1,1,14,7.1,13,11,1,10,10,15,3,0,Matches,2020-2021,Serie-A
Paolo Ghiglione,it ITA,"DF,MF",Genoa,23.0,1997.0,15.1,27,15,17,8,2,13,28,46.4,15,14,2,12,13,40,25,0,Matches,2020-2021,Serie-A
Faouzi Ghoulam,dz ALG,"DF,FW",Napoli,29.0,1991.0,3.2,6,5,3,2,1,0,1,0.0,1,4,2,2,3,9,1,0,Matches,2020-2021,Serie-A
Kamil Glik,pl POL,DF,Benevento,32.0,1988.0,35.6,44,24,33,10,1,25,53,47.2,28,37,31,6,62,106,153,0,Matches,2020-2021,Serie-A
Diego Godín,uy URU,DF,Cagliari,34.0,1986.0,27.9,60,32,51,9,0,24,39,61.5,15,41,24,17,56,116,117,0,Matches,2020-2021,Serie-A
Amer Gojak,ba BIH,"MF,FW",Torino,23.0,1997.0,5.3,1,0,1,0,0,1,7,14.3,6,5,0,5,3,4,1,0,Matches,2020-2021,Serie-A
Edoardo Goldaniga,it ITA,DF,Genoa,26.0,1993.0,20.6,28,18,21,7,0,14,23,60.9,9,17,7,10,38,66,62,1,Matches,2020-2021,Serie-A
Vladimir Golemić,si SVN,DF,Crotone,29.0,1991.0,26.0,33,16,17,13,3,14,19,73.7,5,38,26,12,40,73,97,2,Matches,2020-2021,Serie-A
Pierluigi Gollini,it ITA,GK,Atalanta,25.0,1995.0,24.0,1,0,1,0,0,1,2,50.0,1,1,0,1,1,2,11,0,Matches,2020-2021,Serie-A
Tomislav Gomelt,hr CRO,MF,Crotone,25.0,1995.0,0.2,1,1,0,1,0,0,0,,0,0,0,0,1,2,0,0,Matches,2020-2021,Serie-A
Papu Gómez,ar ARG,"MF,FW",Atalanta,32.0,1988.0,7.4,3,2,2,1,0,2,8,25.0,6,8,1,7,1,4,1,0,Matches,2020-2021,Serie-A
Robin Gosens,de GER,DF,Atalanta,26.0,1994.0,28.0,46,35,20,15,11,17,41,41.5,24,50,7,43,41,87,34,0,Matches,2020-2021,Serie-A
Alberto Grassi,it ITA,"MF,DF",Parma,25.0,1995.0,13.1,30,11,14,13,3,8,29,27.6,21,22,9,13,26,56,32,0,Matches,2020-2021,Serie-A
Koray Günter,de GER,DF,Hellas Verona,25.0,1994.0,19.6,20,10,10,9,1,4,9,44.4,5,27,21,6,70,90,87,0,Matches,2020-2021,Serie-A
Manu Gyabuaa,it ITA,MF,Atalanta,18.0,2001.0,0.0,0,0,0,0,0,0,0,,0,0,0,0,0,0,0,0,Matches,2020-2021,Serie-A
Emmanuel Gyasi,gh GHA,FW,Spezia,26.0,1994.0,31.7,30,16,16,10,4,9,31,29.0,22,13,2,11,14,44,8,0,Matches,2020-2021,Serie-A
Achraf Hakimi,ma MAR,DF,Inter,21.0,1998.0,29.6,53,32,23,19,11,23,48,47.9,25,31,1,30,22,75,23,1,Matches,2020-2021,Serie-A
Samir Handanović,si SVN,GK,Inter,36.0,1984.0,36.0,1,0,1,0,0,1,1,100.0,0,0,0,0,0,1,6,3,Matches,2020-2021,Serie-A
Lukáš Haraslín,sk SVK,"FW,MF",Sassuolo,24.0,1996.0,3.7,8,4,2,5,1,2,5,40.0,3,1,0,1,0,8,2,0,Matches,2020-2021,Serie-A
Hans Hateboer,nl NED,DF,Atalanta,26.0,1994.0,19.6,28,17,12,14,2,13,23,56.5,10,8,1,7,17,45,9,0,Matches,2020-2021,Serie-A
Eduardo Henrique,br BRA,MF,Crotone,25.0,1995.0,10.3,5,2,1,4,0,3,12,25.0,9,6,1,5,7,12,7,1,Matches,2020-2021,Serie-A
Theo Hernández,fr FRA,DF,Milan,22.0,1997.0,32.6,48,29,22,21,5,19,38,50.0,19,29,6,23,34,82,64,5,Matches,2020-2021,Serie-A
Hernani,br BRA,MF,Parma,26.0,1994.0,24.3,51,25,21,27,3,29,66,43.9,37,35,4,31,31,82,40,1,Matches,2020-2021,Serie-A
Përparim Hetemaj,fi FIN,MF,Benevento,33.0,1986.0,24.6,44,27,21,18,5,26,61,42.6,35,41,5,36,22,66,24,1,Matches,2020-2021,Serie-A
Aaron Hickey,sct SCO,DF,Bologna,18.0,2002.0,8.4,12,8,10,2,0,7,17,41.2,10,6,1,5,15,27,15,1,Matches,2020-2021,Serie-A
Wesley Hoedt,nl NED,DF,Lazio,26.0,1994.0,10.6,22,16,18,4,0,10,17,58.8,7,9,5,4,17,39,48,1,Matches,2020-2021,Serie-A
Elseid Hysaj,al ALB,DF,Napoli,26.0,1994.0,19.6,29,17,16,11,2,17,33,51.5,16,18,4,14,30,59,52,0,Matches,2020-2021,Serie-A
Simone Iacoponi,it ITA,DF,Parma,33.0,1987.0,13.3,22,12,16,5,1,13,26,50.0,13,9,4,5,11,33,42,1,Matches,2020-2021,Serie-A
Roger Ibanez,br BRA,DF,Roma,21.0,1998.0,26.6,59,37,28,25,6,25,45,55.6,20,38,17,21,68,127,78,3,Matches,2020-2021,Serie-A
Zlatan Ibrahimović,se SWE,FW,Milan,38.0,1981.0,16.6,5,4,0,4,1,3,6,50.0,3,5,3,2,6,11,27,1,Matches,2020-2021,Serie-A
Igor,br BRA,DF,Fiorentina,22.0,1998.0,13.0,15,9,9,6,0,7,12,58.3,5,17,9,8,23,38,34,0,Matches,2020-2021,Serie-A
Ivan Ilić,rs SRB,MF,Hellas Verona,19.0,2001.0,20.4,26,14,11,11,4,7,21,33.3,14,17,5,12,27,53,26,0,Matches,2020-2021,Serie-A
Josip Iličić,si SVN,"MF,FW",Atalanta,32.0,1988.0,17.0,9,4,1,5,3,5,21,23.8,16,12,0,12,2,11,0,1,Matches,2020-2021,Serie-A
Ciro Immobile,it ITA,FW,Lazio,30.0,1990.0,31.7,14,13,4,6,4,7,22,31.8,15,13,1,12,6,20,9,0,Matches,2020-2021,Serie-A
Riccardo Improta,it ITA,"DF,MF",Benevento,26.0,1993.0,25.9,39,23,25,8,6,21,45,46.7,24,23,4,19,28,67,47,0,Matches,2020-2021,Serie-A
Roberto Inglese,it ITA,FW,Parma,28.0,1991.0,6.4,5,2,1,2,2,2,11,18.2,9,10,0,10,0,5,3,0,Matches,2020-2021,Serie-A
Lorenzo Insigne,it ITA,FW,Napoli,29.0,1991.0,31.8,26,18,8,12,6,13,72,18.1,59,30,1,29,37,63,6,1,Matches,2020-2021,Serie-A
Roberto Insigne,it ITA,"MF,FW",Benevento,26.0,1994.0,17.8,16,10,8,3,5,7,27,25.9,20,10,0,10,7,23,9,0,Matches,2020-2021,Serie-A
Artur Ioniță,md MDA,MF,Benevento,29.0,1990.0,31.5,47,22,11,31,5,17,63,27.0,46,38,14,24,19,66,28,0,Matches,2020-2021,Serie-A
Ardian Ismajli,al ALB,DF,Spezia,23.0,1996.0,14.4,19,9,10,8,1,8,13,61.5,5,10,7,3,23,42,52,1,Matches,2020-2021,Serie-A
Armando Izzo,it ITA,DF,Torino,28.0,1992.0,22.3,30,16,13,13,4,13,33,39.4,20,22,9,13,53,83,62,0,Matches,2020-2021,Serie-A
Mato Jajalo,ba BIH,MF,Udinese,32.0,1988.0,0.4,1,1,1,0,0,1,1,100.0,0,1,0,1,2,3,0,0,Matches,2020-2021,Serie-A
Jakub Jankto,cz CZE,MF,Sampdoria,24.0,1996.0,26.8,28,17,14,7,7,11,35,31.4,24,16,1,15,24,52,34,0,Matches,2020-2021,Serie-A
Juan Jesus,br BRA,DF,Roma,29.0,1991.0,1.7,3,1,2,1,0,2,4,50.0,2,1,0,1,2,5,5,0,Matches,2020-2021,Serie-A
Hamed Junior Traorè,ci CIV,"MF,FW",Sassuolo,20.0,2000.0,19.9,29,17,10,10,9,14,35,40.0,21,27,3,24,18,47,9,0,Matches,2020-2021,Serie-A
Musa Juwara,gm GAM,"MF,DF",Bologna,18.0,2001.0,0.5,2,2,2,0,0,1,3,33.3,2,1,0,1,0,2,0,0,Matches,2020-2021,Serie-A
Nikola Kalinić,hr CRO,FW,Hellas Verona,32.0,1988.0,11.8,5,1,2,2,1,0,3,0.0,3,6,0,6,1,6,7,0,Matches,2020-2021,Serie-A
Yayah Kallon,sl SLE,FW,Genoa,19.0,2001.0,0.5,0,0,0,0,0,0,0,,0,0,0,0,0,0,0,0,Matches,2020-2021,Serie-A
Pierre Kalulu,fr FRA,DF,Milan,20.0,2000.0,8.1,18,14,11,6,1,10,14,71.4,4,9,3,6,19,37,20,0,Matches,2020-2021,Serie-A
Yann Karamoh,fr FRA,"FW,MF",Parma,22.0,1998.0,14.4,27,17,8,12,7,11,31,35.5,20,6,0,6,4,31,11,0,Matches,2020-2021,Serie-A
Isaac Karamoko,fr FRA,DF,Sassuolo,18.0,2002.0,0.0,1,0,0,0,1,1,1,100.0,0,0,0,0,0,1,0,0,Matches,2020-2021,Serie-A
Augustus Kargbo,sl SLE,FW,Crotone,20.0,1999.0,0.4,0,0,0,0,0,0,0,,0,0,0,0,0,0,0,0,Matches,2020-2021,Serie-A
Rick Karsdorp,nl NED,DF,Roma,25.0,1995.0,28.3,36,23,19,12,5,21,48,43.8,27,18,1,17,30,66,32,0,Matches,2020-2021,Serie-A
Franck Kessié,ci CIV,MF,Milan,23.0,1996.0,35.8,53,30,28,19,6,20,38,52.6,18,47,15,32,46,99,51,0,Matches,2020-2021,Serie-A
Omar Khailoti,it ITA,DF,Bologna,18.0,2001.0,0.3,0,0,0,0,0,0,0,,0,2,0,2,1,1,0,0,Matches,2020-2021,Serie-A
Simon Kjær,dk DEN,DF,Milan,31.0,1989.0,26.6,45,26,23,20,2,18,30,60.0,12,42,26,16,42,87,125,0,Matches,2020-2021,Serie-A
Ragnar Klavan,ee EST,DF,Cagliari,34.0,1985.0,8.6,15,9,9,5,1,7,11,63.6,4,9,4,5,8,23,34,0,Matches,2020-2021,Serie-A
Justin Kluivert,nl NED,MF,Roma,21.0,1999.0,0.2,0,0,0,0,0,0,0,,0,0,0,0,0,0,0,0,Matches,2020-2021,Serie-A
Aleksandr Kokorin,ru RUS,"FW,MF",Fiorentina,29.0,1991.0,1.0,1,0,0,1,0,0,1,0.0,1,1,0,1,0,1,0,0,Matches,2020-2021,Serie-A
Aleksandar Kolarov,rs SRB,DF,Inter,34.0,1985.0,4.3,4,4,0,4,0,1,2,50.0,1,2,0,2,7,11,8,0,Matches,2020-2021,Serie-A
Márk Kosznovszky,hu HUN,MF,Parma,18.0,2002.0,1.0,2,2,1,1,0,1,4,25.0,3,2,0,2,1,3,1,0,Matches,2020-2021,Serie-A
Christian Kouamé,ci CIV,FW,Fiorentina,22.0,1997.0,11.1,9,4,2,4,3,4,12,33.3,8,9,1,8,5,14,4,0,Matches,2020-2021,Serie-A
Kalidou Koulibaly,sn SEN,DF,Napoli,29.0,1991.0,24.5,36,24,25,7,4,19,32,59.4,13,46,26,20,29,65,64,2,Matches,2020-2021,Serie-A
Viktor Kovalenko,ua UKR,FW,Atalanta,24.0,1996.0,0.0,0,0,0,0,0,0,0,,0,0,0,0,0,0,1,0,Matches,2020-2021,Serie-A
Rade Krunić,ba BIH,"MF,FW",Milan,26.0,1993.0,8.0,15,12,6,6,3,7,17,41.2,10,12,2,10,10,25,9,0,Matches,2020-2021,Serie-A
Juraj Kucka,sk SVK,"MF,FW",Parma,33.0,1987.0,25.9,67,36,21,37,9,26,74,35.1,48,25,3,22,28,95,25,0,Matches,2020-2021,Serie-A
Dejan Kulusevski,se SWE,"MF,FW",Juventus,20.0,2000.0,21.4,33,19,12,10,11,14,43,32.6,29,22,0,22,9,42,2,1,Matches,2020-2021,Serie-A
Marash Kumbulla,al ALB,DF,Roma,20.0,2000.0,15.1,16,11,8,7,1,5,17,29.4,12,12,5,7,24,40,38,1,Matches,2020-2021,Serie-A
Jasmin Kurtić,si SVN,MF,Parma,31.0,1989.0,30.4,46,28,22,21,3,21,70,30.0,49,22,2,20,33,79,57,1,Matches,2020-2021,Serie-A
Giorgos Kyriakopoulos,gr GRE,DF,Sassuolo,24.0,1996.0,16.2,35,18,17,12,6,8,28,28.6,20,16,5,11,15,50,42,0,Matches,2020-2021,Serie-A
Antonino La Gumina,it ITA,FW,Sampdoria,24.0,1996.0,3.8,3,2,0,1,2,0,3,0.0,3,5,1,4,3,6,5,0,Matches,2020-2021,Serie-A
Sam Lammers,nl NED,"FW,MF",Atalanta,23.0,1997.0,3.2,2,0,0,2,0,0,6,0.0,6,0,0,0,0,2,3,0,Matches,2020-2021,Serie-A
Gianluca Lapadula,pe PER,FW,Benevento,30.0,1990.0,28.5,22,12,3,13,6,6,25,24.0,19,18,3,15,5,27,16,0,Matches,2020-2021,Serie-A
Danilo Larangeira,br BRA,DF,Bologna,36.0,1984.0,34.8,33,24,23,10,0,8,29,27.6,21,58,36,22,51,84,127,2,Matches,2020-2021,Serie-A
Kevin Lasagna,it ITA,FW,Udinese,27.0,1992.0,12.3,6,1,2,3,1,3,14,21.4,11,11,0,11,6,12,7,0,Matches,2020-2021,Serie-A
Kevin Lasagna,it ITA,FW,Hellas Verona,27.0,1992.0,14.1,7,3,0,5,2,1,5,20.0,4,12,1,11,1,8,11,0,Matches,2020-2021,Serie-A
Vincent Laurini,fr FRA,DF,Parma,31.0,1989.0,9.7,16,11,8,6,2,7,9,77.8,2,8,4,4,17,33,22,1,Matches,2020-2021,Serie-A
Darko Lazović,rs SRB,"DF,MF",Hellas Verona,29.0,1990.0,27.8,29,17,8,17,4,20,42,47.6,22,17,7,10,20,49,29,0,Matches,2020-2021,Serie-A
Manuel Lazzari,it ITA,DF,Lazio,26.0,1993.0,29.0,24,14,15,4,5,14,39,35.9,25,22,3,19,18,42,28,0,Matches,2020-2021,Serie-A
Rafael Leão,pt POR,FW,Milan,21.0,1999.0,21.4,13,6,4,7,2,6,15,40.0,9,17,0,17,4,17,14,1,Matches,2020-2021,Serie-A
Lucas Leiva,br BRA,MF,Lazio,33.0,1987.0,23.7,68,32,38,28,2,30,86,34.9,56,21,0,21,57,125,21,0,Matches,2020-2021,Serie-A
Lukas Lerager,dk DEN,MF,Genoa,27.0,1993.0,12.9,24,13,14,9,1,11,30,36.7,19,13,3,10,14,38,25,1,Matches,2020-2021,Serie-A
Mehdi Léris,dz ALG,"DF,MF",Sampdoria,22.0,1998.0,4.3,11,5,6,4,1,6,16,37.5,10,12,2,10,12,23,15,0,Matches,2020-2021,Serie-A
Karlo Letica,hr CRO,GK,Sampdoria,23.0,1997.0,1.0,0,0,0,0,0,0,0,,0,0,0,0,0,0,2,0,Matches,2020-2021,Serie-A
Gaetano Letizia,it ITA,DF,Benevento,30.0,1990.0,17.4,36,25,19,13,4,17,36,47.2,19,15,3,12,20,56,42,1,Matches,2020-2021,Serie-A
Matthijs de Ligt,nl NED,DF,Juventus,20.0,1999.0,24.7,37,19,20,16,1,18,28,64.3,10,42,21,21,31,68,64,0,Matches,2020-2021,Serie-A
Karol Linetty,pl POL,MF,Torino,25.0,1995.0,20.4,38,28,13,19,6,16,45,35.6,29,19,5,14,15,53,7,0,Matches,2020-2021,Serie-A
Pol Lirola,es ESP,"DF,FW",Fiorentina,22.0,1997.0,5.5,13,8,8,2,3,6,12,50.0,6,6,3,3,6,19,9,0,Matches,2020-2021,Serie-A
Fernando Llorente,es ESP,FW,Udinese,35.0,1985.0,7.9,4,1,2,2,0,2,5,40.0,3,3,0,3,2,6,17,0,Matches,2020-2021,Serie-A
Fernando Llorente,es ESP,"FW,MF",Napoli,35.0,1985.0,0.6,0,0,0,0,0,0,0,,0,0,0,0,0,0,0,0,Matches,2020-2021,Serie-A
Stanislav Lobotka,sk SVK,MF,Napoli,25.0,1994.0,1.7,1,1,0,1,0,0,1,0.0,1,1,1,0,0,1,1,1,Matches,2020-2021,Serie-A
Manuel Locatelli,it ITA,MF,Sassuolo,22.0,1998.0,32.0,81,47,43,28,10,29,56,51.8,27,35,15,20,51,132,65,1,Matches,2020-2021,Serie-A
Maxime Lopez,fr FRA,MF,Sassuolo,22.0,1997.0,20.7,24,13,15,6,3,14,41,34.1,27,9,0,9,16,40,10,1,Matches,2020-2021,Serie-A
Pau López,es ESP,GK,Roma,25.0,1994.0,20.2,2,0,2,0,0,2,2,100.0,0,1,0,1,0,2,7,4,Matches,2020-2021,Serie-A
Matteo Lovato,it ITA,DF,Hellas Verona,20.0,2000.0,15.4,21,12,14,5,2,10,21,47.6,11,20,10,10,37,58,48,1,Matches,2020-2021,Serie-A
Hirving Lozano,mx MEX,FW,Napoli,25.0,1995.0,21.8,29,18,10,13,6,10,36,27.8,26,37,1,36,18,47,14,0,Matches,2020-2021,Serie-A
José Luis Palomino,ar ARG,DF,Atalanta,30.0,1990.0,27.0,67,33,41,19,7,24,48,50.0,24,30,16,14,79,146,60,2,Matches,2020-2021,Serie-A
Romelu Lukaku,be BEL,FW,Inter,27.0,1993.0,32.0,11,1,1,6,4,6,14,42.9,8,11,1,10,3,14,34,0,Matches,2020-2021,Serie-A
Saša Lukić,rs SRB,MF,Torino,23.0,1996.0,23.4,32,13,11,18,3,15,50,30.0,35,23,5,18,17,49,17,0,Matches,2020-2021,Serie-A
Senad Lulić,ba BIH,DF,Lazio,34.0,1986.0,8.0,14,7,6,5,3,7,15,46.7,8,10,1,9,4,18,13,0,Matches,2020-2021,Serie-A
Sebastiano Luperto,it ITA,DF,Crotone,23.0,1996.0,20.9,38,20,28,8,2,16,27,59.3,11,17,7,10,27,65,74,1,Matches,2020-2021,Serie-A
Lyanco,br BRA,DF,Torino,23.0,1997.0,21.8,21,14,13,6,2,8,14,57.1,6,36,26,10,46,67,76,0,Matches,2020-2021,Serie-A
Charalambos Lykogiannis,gr GRE,DF,Cagliari,26.0,1993.0,26.9,34,21,22,9,3,22,38,57.9,16,34,13,21,32,66,94,0,Matches,2020-2021,Serie-A
Lisandro Magallán,ar ARG,DF,Crotone,26.0,1993.0,24.2,54,31,28,24,2,17,42,40.5,25,29,15,14,44,98,78,1,Matches,2020-2021,Serie-A
Christian Maggio,it ITA,DF,Benevento,38.0,1982.0,3.3,9,4,2,7,0,3,9,33.3,6,4,1,3,2,11,6,0,Matches,2020-2021,Serie-A
Giulio Maggiore,it ITA,MF,Spezia,22.0,1998.0,24.6,61,36,26,28,7,21,53,39.6,32,33,6,27,19,80,25,1,Matches,2020-2021,Serie-A
Francesco Magnanelli,it ITA,MF,Sassuolo,35.0,1984.0,4.9,7,5,2,5,0,3,10,30.0,7,6,2,4,13,20,10,0,Matches,2020-2021,Serie-A
Giangiacomo Magnani,it ITA,DF,Hellas Verona,24.0,1995.0,16.8,26,15,14,9,3,9,16,56.3,7,25,16,9,44,70,105,1,Matches,2020-2021,Serie-A
Jean-Victor Makengo,fr FRA,MF,Udinese,22.0,1998.0,5.8,8,7,5,3,0,3,13,23.1,10,7,1,6,5,13,7,0,Matches,2020-2021,Serie-A
Nikola Maksimović,rs SRB,DF,Napoli,28.0,1991.0,13.4,18,9,11,6,1,9,18,50.0,9,15,6,9,21,39,49,3,Matches,2020-2021,Serie-A
Kévin Malcuit,ma MAR,DF,Fiorentina,29.0,1991.0,2.3,5,3,2,2,1,0,1,0.0,1,5,0,5,3,8,6,0,Matches,2020-2021,Serie-A
Kévin Malcuit,ma MAR,"FW,MF",Napoli,29.0,1991.0,0.4,2,1,2,0,0,0,1,0.0,1,0,0,0,2,4,2,0,Matches,2020-2021,Serie-A
Daniel Maldini,it ITA,"FW,DF",Milan,18.0,2001.0,0.3,1,0,0,1,0,0,2,0.0,2,0,0,0,0,1,0,0,Matches,2020-2021,Serie-A
Ruslan Malinovskyi,ua UKR,"MF,FW",Atalanta,27.0,1993.0,20.8,19,8,2,13,4,8,23,34.8,15,16,1,15,2,21,4,0,Matches,2020-2021,Serie-A
Dennis Man,ro ROU,"FW,MF",Parma,21.0,1998.0,7.8,12,6,6,4,2,6,21,28.6,15,5,0,5,2,14,6,0,Matches,2020-2021,Serie-A
Gianluca Mancini,it ITA,DF,Roma,24.0,1996.0,31.7,50,29,29,19,2,18,31,58.1,13,38,18,20,72,122,77,3,Matches,2020-2021,Serie-A
Rolando Mandragora,it ITA,MF,Udinese,23.0,1997.0,4.4,8,5,3,4,1,3,10,30.0,7,10,3,7,6,14,5,0,Matches,2020-2021,Serie-A
Rolando Mandragora,it ITA,MF,Torino,23.0,1997.0,16.9,19,4,4,9,6,7,30,23.3,23,19,6,13,20,39,19,0,Matches,2020-2021,Serie-A
Mario Mandžukić,hr CRO,FW,Milan,34.0,1986.0,2.4,7,6,2,4,1,2,3,66.7,1,0,0,0,2,9,3,0,Matches,2020-2021,Serie-A
Niccolò Manfredini,it ITA,GK,Benevento,32.0,1988.0,1.0,0,0,0,0,0,0,0,,0,0,0,0,0,0,2,1,Matches,2020-2021,Serie-A
Kostas Manolas,gr GRE,DF,Napoli,29.0,1991.0,25.5,31,18,24,7,0,17,24,70.8,7,22,13,9,23,54,82,2,Matches,2020-2021,Serie-A
Juan Manuel Ramos,uy URU,DF,Spezia,23.0,1996.0,3.3,5,0,3,0,2,4,7,57.1,3,1,0,1,2,7,6,0,Matches,2020-2021,Serie-A
Federico Marchetti,it ITA,GK,Genoa,37.0,1983.0,3.7,1,0,1,0,0,1,1,100.0,0,0,0,0,0,1,2,1,Matches,2020-2021,Serie-A
Riccardo Marchizza,it ITA,DF,Spezia,22.0,1998.0,17.3,20,11,12,5,3,12,21,57.1,9,13,4,9,11,31,27,0,Matches,2020-2021,Serie-A
Gian Marco Ferrari,it ITA,DF,Sassuolo,28.0,1992.0,33.5,32,20,15,14,3,10,23,43.5,13,46,37,9,50,82,100,1,Matches,2020-2021,Serie-A
Răzvan Marin,ro ROU,MF,Cagliari,24.0,1996.0,32.9,54,33,26,22,6,27,53,50.9,26,29,10,19,29,83,15,0,Matches,2020-2021,Serie-A
Marlon,br BRA,DF,Sassuolo,24.0,1995.0,19.4,19,13,13,6,0,13,18,72.2,5,23,17,6,27,46,44,2,Matches,2020-2021,Serie-A
Luca Marrone,it ITA,DF,Crotone,30.0,1990.0,17.6,25,18,16,9,0,13,21,61.9,8,22,11,11,26,51,56,1,Matches,2020-2021,Serie-A
Lautaro Martínez,ar ARG,FW,Inter,22.0,1997.0,28.5,25,12,5,11,9,7,24,29.2,17,31,1,30,27,52,16,0,Matches,2020-2021,Serie-A
Lucas Martínez Quarta,ar ARG,DF,Fiorentina,24.0,1996.0,16.5,32,20,17,11,4,18,41,43.9,23,27,9,18,39,71,48,0,Matches,2020-2021,Serie-A
Adam Marušić,me MNE,DF,Lazio,27.0,1992.0,33.0,38,22,22,15,1,20,40,50.0,20,38,6,32,40,78,54,0,Matches,2020-2021,Serie-A
Andrea Masiello,it ITA,DF,Genoa,34.0,1986.0,28.5,38,22,29,6,3,23,48,47.9,25,32,13,19,52,90,107,3,Matches,2020-2021,Serie-A
Giuseppe Mastinu,it ITA,FW,Spezia,28.0,1991.0,0.4,1,1,0,0,1,1,1,100.0,0,1,0,1,0,1,0,0,Matches,2020-2021,Serie-A
Ryder Matos,br BRA,MF,Udinese,27.0,1993.0,0.1,0,0,0,0,0,0,0,,0,0,0,0,0,0,0,0,Matches,2020-2021,Serie-A
Federico Mattiello,it ITA,DF,Spezia,25.0,1995.0,0.4,0,0,0,0,0,0,0,,0,0,0,0,0,0,0,0,Matches,2020-2021,Serie-A
Borja Mayoral,es ESP,FW,Roma,23.0,1997.0,17.2,3,2,0,0,3,1,10,10.0,9,5,0,5,0,3,5,2,Matches,2020-2021,Serie-A
Antonio Mazzotta,it ITA,DF,Crotone,30.0,1989.0,0.6,1,1,0,1,0,0,0,,0,0,0,0,0,1,1,0,Matches,2020-2021,Serie-A
Ibrahima Mbaye,sn SEN,DF,Bologna,25.0,1994.0,4.8,6,5,5,1,0,3,5,60.0,2,5,3,2,1,7,10,0,Matches,2020-2021,Serie-A
Weston McKennie,us USA,MF,Juventus,21.0,1998.0,18.9,34,19,9,20,5,12,33,36.4,21,21,3,18,28,62,26,0,Matches,2020-2021,Serie-A
Gary Medel,cl CHI,"DF,MF",Bologna,32.0,1987.0,5.7,12,9,6,5,1,4,10,40.0,6,8,6,2,7,19,10,0,Matches,2020-2021,Serie-A
Soualiho Meïté,fr FRA,MF,Torino,26.0,1994.0,10.2,11,7,6,4,1,5,16,31.3,11,18,1,17,10,21,9,1,Matches,2020-2021,Serie-A
Soualiho Meïté,fr FRA,MF,Milan,26.0,1994.0,6.5,18,10,10,6,2,8,17,47.1,9,9,2,7,8,26,16,0,Matches,2020-2021,Serie-A
Filippo Melegoni,it ITA,"MF,DF",Genoa,21.0,1999.0,4.3,7,6,2,5,0,3,6,50.0,3,5,0,5,5,12,8,0,Matches,2020-2021,Serie-A
Arthur Melo,br BRA,MF,Juventus,23.0,1996.0,12.9,17,9,7,10,0,12,31,38.7,19,6,1,5,18,35,9,1,Matches,2020-2021,Serie-A
Alex Meret,it ITA,GK,Napoli,23.0,1997.0,22.0,0,0,0,0,0,0,1,0.0,1,0,0,0,0,0,5,0,Matches,2020-2021,Serie-A
Yıldırım Mert Çetin,tr TUR,DF,Hellas Verona,23.0,1997.0,4.6,8,4,3,5,0,2,6,33.3,4,7,5,2,14,22,11,1,Matches,2020-2021,Serie-A
Dries Mertens,be BEL,"FW,MF",Napoli,33.0,1987.0,16.2,16,14,4,7,5,5,25,20.0,20,7,1,6,9,25,3,1,Matches,2020-2021,Serie-A
Junior Messias,br BRA,"MF,FW",Crotone,29.0,1991.0,35.7,60,35,26,24,10,22,70,31.4,48,32,12,20,35,95,40,0,Matches,2020-2021,Serie-A
Petar Mićin,rs SRB,MF,Udinese,21.0,1998.0,0.2,0,0,0,0,0,0,0,,0,0,0,0,0,0,0,0,Matches,2020-2021,Serie-A
Valentin Mihaila,ro ROU,"FW,MF",Parma,20.0,2000.0,7.8,2,1,1,1,0,0,10,0.0,10,8,1,7,5,7,8,0,Matches,2020-2021,Serie-A
Nikola Milenković,rs SRB,DF,Fiorentina,22.0,1997.0,33.7,49,29,33,14,2,21,33,63.6,12,42,33,9,44,93,122,1,Matches,2020-2021,Serie-A
Sergej Milinković-Savić,rs SRB,MF,Lazio,25.0,1995.0,30.5,59,40,20,30,9,27,84,32.1,57,52,12,40,33,92,47,0,Matches,2020-2021,Serie-A
Vanja Milinković-Savić,rs SRB,GK,Torino,23.0,1997.0,5.0,1,1,1,0,0,1,1,100.0,0,0,0,0,0,1,1,3,Matches,2020-2021,Serie-A
Vincenzo Millico,it ITA,"FW,MF",Torino,19.0,2000.0,0.2,0,0,0,0,0,0,0,,0,0,0,0,0,0,0,0,Matches,2020-2021,Serie-A
Aleksei Miranchuk,ru RUS,"MF,FW",Atalanta,24.0,1995.0,7.5,24,13,8,9,7,6,9,66.7,3,1,0,1,3,27,1,0,Matches,2020-2021,Serie-A
Antonio Mirante,it ITA,GK,Roma,37.0,1983.0,12.8,0,0,0,0,0,0,1,0.0,1,1,0,1,0,0,7,2,Matches,2020-2021,Serie-A
Henrikh Mkhitaryan,am ARM,"MF,FW",Roma,31.0,1989.0,30.5,58,24,13,27,18,13,62,21.0,49,34,0,34,39,97,10,0,Matches,2020-2021,Serie-A
Johan Mojica,co COL,DF,Atalanta,27.0,1992.0,3.3,4,4,3,1,0,2,3,66.7,1,3,0,3,7,11,6,0,Matches,2020-2021,Serie-A
Nahuel Molina,ar ARG,DF,Udinese,22.0,1998.0,20.3,27,18,13,10,4,16,42,38.1,26,26,4,22,21,48,49,1,Matches,2020-2021,Serie-A
Salvatore Molina,it ITA,"MF,DF",Crotone,28.0,1992.0,25.7,39,22,18,14,7,29,45,64.4,16,30,8,22,17,56,41,0,Matches,2020-2021,Serie-A
Gabriele Moncini,it ITA,"FW,MF",Benevento,24.0,1996.0,4.0,2,1,2,0,0,0,1,0.0,1,2,0,2,2,4,4,0,Matches,2020-2021,Serie-A
Cristóbal Montiel,es ESP,"MF,FW",Fiorentina,20.0,2000.0,0.0,0,0,0,0,0,0,1,0.0,1,0,0,0,0,0,0,0,Matches,2020-2021,Serie-A
Lorenzo Montipò,it ITA,GK,Benevento,24.0,1996.0,37.0,0,0,0,0,0,0,0,,0,1,0,1,0,0,16,3,Matches,2020-2021,Serie-A
Luca Mora,it ITA,MF,Spezia,32.0,1988.0,1.3,3,1,1,2,0,2,4,50.0,2,2,1,1,0,3,2,0,Matches,2020-2021,Serie-A
Álvaro Morata,es ESP,FW,Juventus,27.0,1992.0,22.4,17,12,2,10,5,4,28,14.3,24,22,2,20,5,22,21,0,Matches,2020-2021,Serie-A
Raúl Moro,es ESP,FW,Lazio,17.0,2002.0,0.1,0,0,0,0,0,0,1,0.0,1,0,0,0,0,0,0,0,Matches,2020-2021,Serie-A
Mert Müldür,tr TUR,DF,Sassuolo,21.0,1999.0,18.6,43,20,26,9,8,27,53,50.9,26,17,1,16,36,79,41,0,Matches,2020-2021,Serie-A
Luis Muriel,co COL,FW,Atalanta,29.0,1991.0,16.0,20,9,4,8,8,9,26,34.6,17,17,0,17,7,27,4,0,Matches,2020-2021,Serie-A
Vedat Muriqi,xk KVX,FW,Lazio,26.0,1994.0,9.2,3,1,0,2,1,0,8,0.0,8,9,2,7,3,6,20,0,Matches,2020-2021,Serie-A
Nicola Murru,it ITA,DF,Torino,25.0,1994.0,6.3,9,6,1,5,3,3,5,60.0,2,11,1,10,12,21,24,0,Matches,2020-2021,Serie-A
Mateo Musacchio,ar ARG,DF,Lazio,29.0,1990.0,2.5,1,1,1,0,0,0,0,,0,5,2,3,2,3,5,0,Matches,2020-2021,Serie-A
Mateo Musacchio,ar ARG,DF,Milan,29.0,1990.0,0.4,2,1,2,0,0,2,3,66.7,1,1,0,1,3,5,0,0,Matches,2020-2021,Serie-A
Juan Musso,ar ARG,GK,Udinese,26.0,1994.0,35.0,1,1,1,0,0,1,1,100.0,0,0,0,0,1,2,8,1,Matches,2020-2021,Serie-A
Joakim Mæhle,dk DEN,DF,Atalanta,23.0,1997.0,13.5,18,10,7,5,6,8,19,42.1,11,17,2,15,11,29,5,0,Matches,2020-2021,Serie-A
Radja Nainggolan,be BEL,MF,Cagliari,32.0,1988.0,20.5,41,26,22,14,5,19,34,55.9,15,18,0,18,15,56,15,1,Matches,2020-2021,Serie-A
Radja Nainggolan,be BEL,MF,Inter,32.0,1988.0,0.5,0,0,0,0,0,0,0,,0,0,0,0,1,1,0,0,Matches,2020-2021,Serie-A
Nahitan Nández,uy URU,"MF,DF",Cagliari,24.0,1995.0,30.4,56,28,23,23,10,25,68,36.8,43,26,4,22,23,79,49,0,Matches,2020-2021,Serie-A
Ilija Nestorovski,mk MKD,"FW,MF",Udinese,30.0,1990.0,7.8,6,4,2,3,1,2,13,15.4,11,5,0,5,1,7,7,0,Matches,2020-2021,Serie-A
Nicolas Nkoulou,cm CMR,DF,Torino,30.0,1990.0,15.1,14,9,11,3,0,7,12,58.3,5,28,14,14,33,47,71,1,Matches,2020-2021,Serie-A
Bram Nuytinck,nl NED,DF,Udinese,30.0,1990.0,18.2,21,15,10,9,2,13,20,65.0,7,30,17,13,25,46,77,0,Matches,2020-2021,Serie-A
Simeon Nwankwo,ng NGA,FW,Crotone,28.0,1992.0,32.7,9,2,2,6,1,3,22,13.6,19,21,5,16,6,15,51,0,Matches,2020-2021,Serie-A
M'Bala Nzola,ao ANG,FW,Spezia,23.0,1996.0,21.1,12,5,2,6,4,4,7,57.1,3,15,1,14,3,15,20,0,Matches,2020-2021,Serie-A
Pedro Obiang,gq EQG,MF,Sassuolo,28.0,1992.0,16.3,35,22,17,15,3,12,36,33.3,24,26,7,19,22,57,27,0,Matches,2020-2021,Serie-A
Brian Oddei,it ITA,"FW,MF",Sassuolo,17.0,2002.0,0.5,2,1,1,1,0,2,3,66.7,1,1,0,1,0,2,1,0,Matches,2020-2021,Serie-A
Stefano Okaka,it ITA,FW,Udinese,30.0,1989.0,16.5,10,7,2,5,3,2,10,20.0,8,7,1,6,2,12,19,0,Matches,2020-2021,Serie-A
Christian Oliva,uy URU,MF,Cagliari,24.0,1996.0,4.3,10,4,6,3,1,6,17,35.3,11,11,1,10,8,18,7,0,Matches,2020-2021,Serie-A
Maximiliano Olivera,uy URU,DF,Fiorentina,28.0,1992.0,1.0,2,0,1,1,0,1,1,100.0,0,3,1,2,0,2,8,0,Matches,2020-2021,Serie-A
Jérôme Onguéné,cm CMR,DF,Genoa,22.0,1997.0,2.0,2,1,2,0,0,2,7,28.6,5,2,0,2,2,4,8,0,Matches,2020-2021,Serie-A
Riccardo Orsolini,it ITA,"FW,MF",Bologna,23.0,1997.0,19.5,37,18,13,12,12,16,39,41.0,23,22,3,19,10,47,22,0,Matches,2020-2021,Serie-A
Victor Osimhen,ng NGA,FW,Napoli,21.0,1998.0,17.5,22,15,2,6,14,3,15,20.0,12,6,0,6,7,29,10,0,Matches,2020-2021,Serie-A
Yordan Osorio,ve VEN,DF,Parma,26.0,1994.0,20.1,22,14,13,9,0,9,24,37.5,15,30,18,12,53,75,77,1,Matches,2020-2021,Serie-A
David Ospina,co COL,GK,Napoli,31.0,1988.0,16.0,0,0,0,0,0,0,0,,0,0,0,0,0,0,4,0,Matches,2020-2021,Serie-A
Adam Ounas,dz ALG,"FW,MF",Crotone,23.0,1996.0,13.3,9,4,4,4,1,0,7,0.0,7,12,1,11,3,12,4,0,Matches,2020-2021,Serie-A
Adam Ounas,dz ALG,"MF,FW",Cagliari,23.0,1996.0,3.4,3,2,3,0,0,0,11,0.0,11,5,0,5,3,6,0,0,Matches,2020-2021,Serie-A
Thomas Ouwejan,nl NED,DF,Udinese,23.0,1996.0,4.6,4,1,0,3,1,2,9,22.2,7,4,0,4,5,9,6,0,Matches,2020-2021,Serie-A
Daniele Padelli,it ITA,GK,Inter,34.0,1985.0,0.5,0,0,0,0,0,0,0,,0,0,0,0,0,0,0,0,Matches,2020-2021,Serie-A
Mattia Pagliuca,it ITA,MF,Bologna,18.0,2002.0,0.1,0,0,0,0,0,0,0,,0,0,0,0,1,1,0,0,Matches,2020-2021,Serie-A
Rodrigo Palacio,ar ARG,FW,Bologna,38.0,1982.0,27.8,13,6,2,3,8,1,15,6.7,14,18,0,18,7,20,29,0,Matches,2020-2021,Serie-A
Alberto Paleari,it ITA,GK,Genoa,27.0,1992.0,2.3,0,0,0,0,0,0,0,,0,0,0,0,0,0,1,0,Matches,2020-2021,Serie-A
Antonio Palumbo,it ITA,MF,Sampdoria,23.0,1996.0,0.1,0,0,0,0,0,0,1,0.0,1,0,0,0,0,0,0,0,Matches,2020-2021,Serie-A
Martin Palumbo,no NOR,MF,Udinese,18.0,2002.0,0.7,0,0,0,0,0,0,0,,0,5,0,5,1,1,0,0,Matches,2020-2021,Serie-A
Goran Pandev,mk MKD,"FW,MF",Genoa,37.0,1983.0,15.6,9,5,1,6,2,4,10,40.0,6,6,0,6,2,11,7,1,Matches,2020-2021,Serie-A
Ivor Pandur,hr CRO,GK,Hellas Verona,20.0,2000.0,3.7,0,0,0,0,0,0,0,,0,0,0,0,0,0,0,0,Matches,2020-2021,Serie-A
Vittorio Parigini,it ITA,"MF,DF",Genoa,24.0,1996.0,0.6,5,2,4,0,1,0,1,0.0,1,0,0,0,0,5,0,0,Matches,2020-2021,Serie-A
Marco Parolo,it ITA,"DF,MF",Lazio,35.0,1985.0,7.3,21,8,8,11,2,8,20,40.0,12,20,6,14,14,35,31,0,Matches,2020-2021,Serie-A
Mario Pašalić,hr CRO,MF,Atalanta,25.0,1995.0,12.5,26,15,5,17,4,12,19,63.2,7,12,1,11,8,34,6,0,Matches,2020-2021,Serie-A
Christian Pastina,it ITA,DF,Benevento,19.0,2001.0,1.3,0,0,0,0,0,0,1,0.0,1,1,0,1,1,1,8,0,Matches,2020-2021,Serie-A
Javier Pastore,ar ARG,"MF,FW",Roma,31.0,1989.0,0.9,2,2,2,0,0,2,2,100.0,0,0,0,0,0,2,0,0,Matches,2020-2021,Serie-A
Patric,es ESP,DF,Lazio,27.0,1993.0,17.7,30,16,15,11,4,13,24,54.2,11,13,3,10,18,48,51,1,Matches,2020-2021,Serie-A
Leonardo Pavoletti,it ITA,FW,Cagliari,31.0,1988.0,17.6,7,3,2,5,0,1,20,5.0,19,4,2,2,4,11,32,0,Matches,2020-2021,Serie-A
Nehuén Paz,ar ARG,DF,Bologna,27.0,1993.0,4.0,9,4,4,5,0,6,7,85.7,1,4,2,2,11,20,16,0,Matches,2020-2021,Serie-A
Pedro,es ESP,"MF,FW",Roma,33.0,1987.0,17.7,22,14,6,11,5,7,35,20.0,28,10,0,10,9,31,2,1,Matches,2020-2021,Serie-A
João Pedro,it ITA,"FW,MF",Cagliari,28.0,1992.0,36.1,13,6,2,6,5,2,27,7.4,25,32,6,26,13,26,28,0,Matches,2020-2021,Serie-A
Gianluca Pegolo,it ITA,GK,Sassuolo,39.0,1981.0,1.0,0,0,0,0,0,0,0,,0,0,0,0,0,0,1,0,Matches,2020-2021,Serie-A
Graziano Pellè,it ITA,FW,Parma,35.0,1985.0,6.8,2,2,0,1,1,1,8,12.5,7,3,0,3,2,4,8,0,Matches,2020-2021,Serie-A
Lorenzo Pellegrini,it ITA,MF,Roma,24.0,1996.0,28.9,40,24,13,20,7,21,60,35.0,39,37,2,35,42,82,23,1,Matches,2020-2021,Serie-A
Luca Pellegrini,it ITA,"DF,MF",Genoa,21.0,1999.0,7.1,9,6,6,2,1,4,10,40.0,6,11,2,9,8,17,13,1,Matches,2020-2021,Serie-A
Federico Peluso,it ITA,DF,Sassuolo,36.0,1984.0,2.3,1,1,1,0,0,1,2,50.0,1,2,2,0,3,4,12,0,Matches,2020-2021,Serie-A
Andreas Pereira,br BRA,"FW,MF",Lazio,24.0,1996.0,6.0,5,0,1,3,1,2,12,16.7,10,6,0,6,1,6,4,0,Matches,2020-2021,Serie-A
Pedro Pereira,pt POR,DF,Crotone,22.0,1998.0,28.3,50,32,29,17,4,21,40,52.5,19,33,11,22,19,69,61,0,Matches,2020-2021,Serie-A
Gastón Pereiro,uy URU,"MF,DF",Cagliari,25.0,1995.0,3.0,3,1,2,1,0,1,2,50.0,1,2,0,2,1,4,2,1,Matches,2020-2021,Serie-A
Bruno Peres,br BRA,DF,Roma,30.0,1990.0,15.9,21,11,11,7,3,13,24,54.2,11,18,4,14,27,48,11,0,Matches,2020-2021,Serie-A
Roberto Pereyra,ar ARG,"MF,FW",Udinese,29.0,1991.0,32.5,18,11,7,8,3,7,23,30.4,16,24,5,19,27,45,24,0,Matches,2020-2021,Serie-A
Carles Pérez,es ESP,"MF,FW",Roma,22.0,1998.0,8.6,9,4,3,6,0,6,31,19.4,25,9,0,9,6,15,1,0,Matches,2020-2021,Serie-A
Mattia Perin,it ITA,GK,Genoa,27.0,1992.0,32.0,0,0,0,0,0,0,0,,0,0,0,0,1,1,6,0,Matches,2020-2021,Serie-A
Ivan Perišić,hr CRO,"DF,FW",Inter,31.0,1989.0,19.9,22,13,11,6,5,12,33,36.4,21,33,4,29,19,41,36,1,Matches,2020-2021,Serie-A
Matteo Pessina,it ITA,MF,Atalanta,23.0,1997.0,18.3,14,7,4,6,4,7,24,29.2,17,17,2,15,17,31,7,1,Matches,2020-2021,Serie-A
Andrea Petagna,it ITA,FW,Napoli,25.0,1995.0,10.7,2,0,0,2,0,2,7,28.6,5,4,0,4,1,3,7,0,Matches,2020-2021,Serie-A
Jacopo Petriccione,it ITA,MF,Crotone,25.0,1995.0,10.6,14,8,6,7,1,9,24,37.5,15,11,2,9,8,22,11,0,Matches,2020-2021,Serie-A
Jens Petter Hauge,no NOR,FW,Milan,20.0,1999.0,5.9,7,4,3,3,1,6,10,60.0,4,4,0,4,1,8,3,0,Matches,2020-2021,Serie-A
Germán Pezzella,ar ARG,DF,Fiorentina,29.0,1991.0,30.5,34,20,22,12,0,18,32,56.3,14,26,14,12,36,70,109,1,Matches,2020-2021,Serie-A
Giuseppe Pezzella,it ITA,DF,Parma,22.0,1997.0,20.3,34,19,23,9,2,22,41,53.7,19,22,9,13,12,46,52,3,Matches,2020-2021,Serie-A
Cristiano Piccini,it ITA,DF,Atalanta,27.0,1992.0,0.7,1,1,1,0,0,0,1,0.0,1,1,0,1,0,1,0,0,Matches,2020-2021,Serie-A
Roberto Piccoli,it ITA,FW,Spezia,19.0,2001.0,7.8,7,3,0,4,3,2,4,50.0,2,4,0,4,2,9,5,0,Matches,2020-2021,Serie-A
Andrea Pinamonti,it ITA,FW,Inter,21.0,1999.0,1.9,0,0,0,0,0,0,0,,0,1,0,1,1,1,2,0,Matches,2020-2021,Serie-A
Carlo Pinsoglio,it ITA,GK,Juventus,30.0,1990.0,0.3,0,0,0,0,0,0,0,,0,0,0,0,0,0,0,0,Matches,2020-2021,Serie-A
Fabio Pisacane,it ITA,DF,Cagliari,34.0,1986.0,2.5,3,2,2,1,0,3,7,42.9,4,8,5,3,1,4,9,1,Matches,2020-2021,Serie-A
Marko Pjaca,hr CRO,"FW,MF",Genoa,25.0,1995.0,15.8,13,6,6,3,4,4,16,25.0,12,7,2,5,7,20,12,0,Matches,2020-2021,Serie-A
Tommaso Pobega,it ITA,MF,Spezia,21.0,1999.0,13.7,24,12,7,13,4,11,31,35.5,20,10,2,8,9,33,22,0,Matches,2020-2021,Serie-A
Andrea Poli,it ITA,MF,Bologna,30.0,1989.0,4.3,9,7,4,2,3,6,12,50.0,6,7,1,6,7,16,7,0,Matches,2020-2021,Serie-A
Matteo Politano,it ITA,"FW,MF",Napoli,26.0,1993.0,21.2,24,16,13,9,2,11,47,23.4,36,14,1,13,14,38,18,0,Matches,2020-2021,Serie-A
Manolo Portanova,it ITA,"MF,FW",Genoa,20.0,2000.0,0.7,3,3,1,1,1,0,2,0.0,2,3,1,2,1,4,2,0,Matches,2020-2021,Serie-A
Manolo Portanova,it ITA,MF,Juventus,20.0,2000.0,0.8,2,0,2,0,0,0,2,0.0,2,4,1,3,0,2,1,0,Matches,2020-2021,Serie-A
Ivan Provedel,it ITA,GK,Spezia,26.0,1994.0,29.0,2,0,2,0,0,2,6,33.3,4,0,0,0,2,4,20,1,Matches,2020-2021,Serie-A
Erick Pulgar,cl CHI,MF,Fiorentina,26.0,1994.0,22.2,41,18,17,23,1,22,49,44.9,27,24,10,14,41,82,45,1,Matches,2020-2021,Serie-A
Ignacio Pussetto,ar ARG,FW,Udinese,24.0,1995.0,8.4,16,8,5,6,5,6,17,35.3,11,14,0,14,13,29,6,0,Matches,2020-2021,Serie-A
Fabio Quagliarella,it ITA,FW,Sampdoria,37.0,1983.0,24.5,12,8,4,4,4,2,19,10.5,17,14,1,13,7,19,10,0,Matches,2020-2021,Serie-A
Simone Rabbi,it ITA,"FW,DF",Bologna,18.0,2001.0,0.4,0,0,0,0,0,0,1,0.0,1,0,0,0,0,0,0,0,Matches,2020-2021,Serie-A
Adrien Rabiot,fr FRA,MF,Juventus,25.0,1995.0,25.7,72,42,24,41,7,28,60,46.7,32,32,11,21,43,115,29,1,Matches,2020-2021,Serie-A
Ivan Radovanović,rs SRB,"DF,MF",Genoa,31.0,1988.0,24.8,18,15,13,5,0,12,31,38.7,19,39,21,18,37,55,114,2,Matches,2020-2021,Serie-A
Ionuț Radu,ro ROU,GK,Inter,23.0,1997.0,1.5,0,0,0,0,0,0,0,,0,0,0,0,0,0,1,0,Matches,2020-2021,Serie-A
Ștefan Radu,ro ROU,DF,Lazio,33.0,1986.0,27.3,43,24,20,19,4,25,40,62.5,15,27,14,13,45,88,73,1,Matches,2020-2021,Serie-A
Rafael,br BRA,GK,Spezia,38.0,1982.0,2.3,0,0,0,0,0,0,0,,0,0,0,0,0,0,0,0,Matches,2020-2021,Serie-A
Antonio Raimondo,it ITA,FW,Bologna,16.0,2004.0,0.0,0,0,0,0,0,0,0,,0,0,0,0,0,0,0,0,Matches,2020-2021,Serie-A
Gastón Ramírez,uy URU,"FW,MF",Sampdoria,29.0,1990.0,10.8,31,15,10,17,4,8,27,29.6,19,19,3,16,4,35,13,0,Matches,2020-2021,Serie-A
Aaron Ramsey,wls WAL,MF,Juventus,29.0,1990.0,12.1,22,14,8,13,1,8,25,32.0,17,13,2,11,7,29,8,2,Matches,2020-2021,Serie-A
Andrea Ranocchia,it ITA,DF,Inter,32.0,1988.0,7.8,13,10,6,6,1,7,8,87.5,1,5,3,2,12,25,19,0,Matches,2020-2021,Serie-A
Giacomo Raspadori,it ITA,"FW,MF",Sassuolo,20.0,2000.0,13.7,5,3,1,1,3,0,4,0.0,4,13,5,8,2,7,9,0,Matches,2020-2021,Serie-A
Federico Ravaglia,it ITA,GK,Bologna,20.0,1999.0,4.0,0,0,0,0,0,0,1,0.0,1,0,0,0,0,0,2,0,Matches,2020-2021,Serie-A
Ante Rebić,hr CRO,FW,Milan,26.0,1993.0,19.7,26,9,4,8,14,8,37,21.6,29,21,1,20,7,33,17,0,Matches,2020-2021,Serie-A
Arkadiusz Reca,pl POL,DF,Crotone,25.0,1995.0,25.7,34,16,15,11,8,10,45,22.2,35,30,3,27,50,84,64,0,Matches,2020-2021,Serie-A
Vasco Regini,it ITA,DF,Sampdoria,29.0,1990.0,1.0,2,2,2,0,0,2,2,100.0,0,1,1,0,1,3,5,0,Matches,2020-2021,Serie-A
Pepe Reina,es ESP,GK,Lazio,37.0,1982.0,29.0,0,0,0,0,0,0,1,0.0,1,0,0,0,1,1,6,0,Matches,2020-2021,Serie-A
Bryan Reynolds,us USA,DF,Roma,19.0,2001.0,3.1,4,2,1,1,2,1,5,20.0,4,4,0,4,6,10,4,0,Matches,2020-2021,Serie-A
Franck Ribéry,fr FRA,FW,Fiorentina,37.0,1983.0,23.9,24,11,4,9,11,5,29,17.2,24,11,2,9,3,27,1,0,Matches,2020-2021,Serie-A
Federico Ricci,it ITA,FW,Sassuolo,26.0,1994.0,0.0,0,0,0,0,0,0,0,,0,0,0,0,0,0,0,0,Matches,2020-2021,Serie-A
Giacomo Ricci,it ITA,DF,Parma,23.0,1996.0,0.7,3,1,1,2,0,0,0,,0,2,2,0,1,4,4,0,Matches,2020-2021,Serie-A
Matteo Ricci,it ITA,MF,Spezia,26.0,1994.0,24.8,40,23,14,24,2,27,52,51.9,25,24,4,20,34,74,13,0,Matches,2020-2021,Serie-A
Tomás Rincón,ve VEN,MF,Torino,32.0,1988.0,31.6,68,38,27,33,8,36,71,50.7,35,32,7,25,31,99,44,0,Matches,2020-2021,Serie-A
Andrea Rispoli,it ITA,DF,Crotone,31.0,1988.0,7.2,6,3,2,3,1,2,7,28.6,5,12,3,9,5,11,15,1,Matches,2020-2021,Serie-A
Emmanuel Rivière,fr FRA,FW,Crotone,30.0,1990.0,7.1,2,1,2,0,0,0,3,0.0,3,5,1,4,1,3,0,0,Matches,2020-2021,Serie-A
Ricardo Rodríguez,ch SUI,DF,Torino,27.0,1992.0,13.8,21,14,11,8,2,13,22,59.1,9,16,5,11,20,41,43,0,Matches,2020-2021,Serie-A
Marko Rog,hr CRO,MF,Cagliari,25.0,1995.0,12.9,40,24,15,22,3,16,37,43.2,21,17,6,11,19,59,15,0,Matches,2020-2021,Serie-A
Rogério,br BRA,DF,Sassuolo,22.0,1998.0,20.9,26,13,19,5,2,19,27,70.4,8,26,5,21,31,57,53,0,Matches,2020-2021,Serie-A
Luis Rojas,cl CHI,"MF,FW",Crotone,18.0,2002.0,1.2,1,0,0,1,0,1,2,50.0,1,2,0,2,1,2,0,0,Matches,2020-2021,Serie-A
Alessio Romagnoli,it ITA,DF,Milan,25.0,1995.0,21.2,17,7,8,7,2,8,19,42.1,11,29,22,7,24,41,80,0,Matches,2020-2021,Serie-A
Cristian Romero,ar ARG,DF,Atalanta,22.0,1998.0,28.3,63,32,41,19,3,27,49,55.1,22,31,13,18,96,159,71,2,Matches,2020-2021,Serie-A
Cristiano Ronaldo,pt POR,FW,Juventus,35.0,1985.0,31.1,6,3,1,3,2,3,15,20.0,12,11,3,8,5,11,15,1,Matches,2020-2021,Serie-A
Marten de Roon,nl NED,MF,Atalanta,29.0,1991.0,33.6,80,48,30,36,14,36,84,42.9,48,44,9,35,69,149,40,0,Matches,2020-2021,Serie-A
Nicolò Rovella,it ITA,MF,Genoa,18.0,2001.0,13.2,29,16,15,11,3,9,32,28.1,23,11,0,11,20,49,19,1,Matches,2020-2021,Serie-A
Amir Rrahmani,xk KVX,DF,Napoli,26.0,1994.0,12.2,13,8,7,6,0,6,9,66.7,3,17,14,3,8,21,39,1,Matches,2020-2021,Serie-A
Kevin Rüegg,ch SUI,"DF,MF",Hellas Verona,21.0,1998.0,2.3,0,0,0,0,0,0,0,,0,3,0,3,2,2,3,0,Matches,2020-2021,Serie-A
Daniele Rugani,it ITA,DF,Cagliari,26.0,1994.0,11.1,24,11,10,12,2,10,20,50.0,10,15,10,5,15,39,46,0,Matches,2020-2021,Serie-A
Matteo Ruggeri,it ITA,DF,Atalanta,18.0,2002.0,2.3,3,0,1,2,0,2,3,66.7,1,2,0,2,4,7,2,0,Matches,2020-2021,Serie-A
Mário Rui,pt POR,DF,Napoli,29.0,1991.0,18.5,24,13,17,6,1,17,33,51.5,16,17,4,13,28,52,29,1,Matches,2020-2021,Serie-A
Fabián Ruiz Peña,es ESP,MF,Napoli,24.0,1996.0,28.5,58,31,26,21,11,25,70,35.7,45,33,3,30,36,94,32,1,Matches,2020-2021,Serie-A
Alexis Saelemaekers,be BEL,FW,Milan,21.0,1999.0,22.4,43,26,20,18,5,19,60,31.7,41,29,1,28,25,68,6,0,Matches,2020-2021,Serie-A
Jacopo Sala,it ITA,DF,Spezia,28.0,1991.0,4.2,17,9,14,1,2,8,22,36.4,14,5,2,3,5,22,6,0,Matches,2020-2021,Serie-A
Eddie Salcedo,it ITA,"MF,FW",Hellas Verona,18.0,2001.0,8.4,6,2,3,2,1,3,3,100.0,0,6,0,6,6,12,6,0,Matches,2020-2021,Serie-A
Antonio Sanabria,py PAR,FW,Torino,24.0,1996.0,10.9,8,3,0,4,4,2,9,22.2,7,5,0,5,5,13,8,0,Matches,2020-2021,Serie-A
Alexis Sánchez,cl CHI,FW,Inter,31.0,1988.0,12.7,14,8,4,4,6,5,18,27.8,13,11,0,11,7,21,1,1,Matches,2020-2021,Serie-A
Alex Sandro,br BRA,DF,Juventus,29.0,1991.0,20.6,37,23,19,13,5,13,25,52.0,12,20,4,16,31,68,57,0,Matches,2020-2021,Serie-A
Siriki Sanogo,ci CIV,MF,Benevento,18.0,2001.0,0.1,0,0,0,0,0,0,0,,0,0,0,0,0,0,0,0,Matches,2020-2021,Serie-A
Nicola Sansone,it ITA,"FW,MF",Bologna,28.0,1991.0,13.0,22,11,7,12,3,10,31,32.3,21,15,0,15,9,31,7,0,Matches,2020-2021,Serie-A
Federico Santander,py PAR,FW,Bologna,29.0,1991.0,0.4,0,0,0,0,0,0,0,,0,0,0,0,0,0,0,0,Matches,2020-2021,Serie-A
Davide Santon,it ITA,DF,Roma,29.0,1991.0,6.5,4,3,2,2,0,3,7,42.9,4,10,1,9,4,8,12,0,Matches,2020-2021,Serie-A
Samir Santos,br BRA,DF,Udinese,25.0,1994.0,24.6,40,23,26,12,2,13,29,44.8,16,33,17,16,58,98,60,1,Matches,2020-2021,Serie-A
Riccardo Saponara,it ITA,MF,Fiorentina,28.0,1991.0,0.6,2,1,0,2,0,1,3,33.3,2,0,0,0,1,3,0,0,Matches,2020-2021,Serie-A
Riccardo Saponara,it ITA,"FW,MF",Spezia,28.0,1991.0,4.3,4,1,1,0,3,1,3,33.3,2,1,0,1,1,5,4,0,Matches,2020-2021,Serie-A
Marco Sau,it ITA,"MF,FW",Benevento,32.0,1987.0,8.7,6,2,0,6,0,1,16,6.3,15,7,0,7,5,11,3,0,Matches,2020-2021,Serie-A
Gianluca Scamacca,it ITA,FW,Genoa,21.0,1999.0,15.0,19,10,6,7,6,7,19,36.8,12,21,4,17,9,28,12,0,Matches,2020-2021,Serie-A
Nicolás Schiappacasse,uy URU,MF,Sassuolo,21.0,1999.0,0.2,0,0,0,0,0,0,0,,0,0,0,0,0,0,0,0,Matches,2020-2021,Serie-A
Pasquale Schiattarella,it ITA,MF,Benevento,33.0,1987.0,25.0,37,22,25,12,0,19,47,40.4,28,19,5,14,32,69,29,2,Matches,2020-2021,Serie-A
Jerdy Schouten,nl NED,MF,Bologna,23.0,1997.0,27.9,50,25,23,25,2,16,37,43.2,21,36,13,23,79,129,37,6,Matches,2020-2021,Serie-A
Matteo Scozzarella,it ITA,MF,Parma,32.0,1988.0,1.7,4,0,3,1,0,2,3,66.7,1,3,1,2,6,10,0,0,Matches,2020-2021,Serie-A
Simone Scuffet,it ITA,GK,Udinese,24.0,1996.0,1.0,0,0,0,0,0,0,0,,0,0,0,0,0,0,0,0,Matches,2020-2021,Serie-A
Jacopo Segre,it ITA,MF,Torino,23.0,1997.0,2.1,5,2,2,1,2,2,5,40.0,3,0,0,0,0,5,1,0,Matches,2020-2021,Serie-A
Léo Sena,br BRA,MF,Spezia,24.0,1995.0,9.8,22,12,7,10,5,12,26,46.2,14,19,4,15,11,33,5,0,Matches,2020-2021,Serie-A
Stefano Sensi,it ITA,MF,Inter,24.0,1995.0,6.7,9,6,3,5,1,4,11,36.4,7,6,1,5,7,16,1,0,Matches,2020-2021,Serie-A
Luigi Sepe,it ITA,GK,Parma,29.0,1991.0,36.0,0,0,0,0,0,0,2,0.0,2,0,0,0,2,2,13,2,Matches,2020-2021,Serie-A
Stephan El Shaarawy,it ITA,"MF,FW",Roma,27.0,1992.0,6.4,4,3,0,3,1,2,9,22.2,7,3,1,2,3,7,2,0,Matches,2020-2021,Serie-A
Eldor Shomurodov,uz UZB,FW,Genoa,25.0,1995.0,18.6,28,14,7,13,8,9,37,24.3,28,17,2,15,6,34,11,0,Matches,2020-2021,Serie-A
Luca Siligardi,it ITA,"MF,FW",Crotone,32.0,1988.0,0.5,4,2,0,3,1,1,5,20.0,4,0,0,0,0,4,0,0,Matches,2020-2021,Serie-A
Luca Siligardi,it ITA,"FW,MF",Parma,32.0,1988.0,0.4,0,0,0,0,0,0,2,0.0,2,0,0,0,0,0,0,0,Matches,2020-2021,Serie-A
Adrien Silva,pt POR,MF,Sampdoria,31.0,1989.0,17.8,49,22,21,22,6,18,54,33.3,36,34,1,33,30,79,10,1,Matches,2020-2021,Serie-A
Marco Silvestri,it ITA,GK,Hellas Verona,29.0,1991.0,34.0,0,0,0,0,0,0,0,,0,0,0,0,0,0,14,1,Matches,2020-2021,Serie-A
Giovanni Simeone,ar ARG,FW,Cagliari,25.0,1995.0,19.3,24,11,2,15,7,7,31,22.6,24,23,1,22,10,34,18,0,Matches,2020-2021,Serie-A
Wilfried Singo,ci CIV,DF,Torino,19.0,2000.0,20.6,29,14,16,6,7,17,33,51.5,16,13,3,10,29,58,40,0,Matches,2020-2021,Serie-A
Salvatore Sirigu,it ITA,GK,Torino,33.0,1987.0,32.0,1,0,1,0,0,1,2,50.0,1,0,0,0,0,1,6,2,Matches,2020-2021,Serie-A
Łukasz Skorupski,pl POL,GK,Bologna,29.0,1991.0,28.0,1,1,1,0,0,1,4,25.0,3,0,0,0,0,1,23,5,Matches,2020-2021,Serie-A
Andreas Skov Olsen,dk DEN,"FW,DF",Bologna,20.0,1999.0,13.1,19,10,11,4,4,11,21,52.4,10,15,0,15,3,22,25,0,Matches,2020-2021,Serie-A
Milan Škriniar,sk SVK,DF,Inter,25.0,1995.0,30.9,48,32,29,16,3,23,34,67.6,11,30,19,11,30,78,89,1,Matches,2020-2021,Serie-A
Chris Smalling,eng ENG,DF,Roma,30.0,1989.0,12.3,14,8,5,7,2,6,10,60.0,4,17,11,6,28,42,46,1,Matches,2020-2021,Serie-A
Simon Sohm,ch SUI,MF,Parma,19.0,2001.0,10.0,18,12,11,6,1,11,26,42.3,15,8,0,8,5,23,7,0,Matches,2020-2021,Serie-A
Roberto Soriano,it ITA,MF,Bologna,29.0,1991.0,36.1,48,26,15,20,13,15,64,23.4,49,31,8,23,18,66,43,0,Matches,2020-2021,Serie-A
Riccardo Sottil,it ITA,"FW,MF",Cagliari,21.0,1999.0,13.2,7,3,2,3,2,0,7,0.0,7,4,0,4,5,12,3,0,Matches,2020-2021,Serie-A
Adama Soumaoro,fr FRA,DF,Bologna,28.0,1992.0,19.5,24,14,17,7,0,6,12,50.0,6,28,23,5,20,44,72,0,Matches,2020-2021,Serie-A
Leonardo Spinazzola,it ITA,DF,Roma,27.0,1993.0,23.6,12,6,3,9,0,8,20,40.0,12,16,1,15,25,37,31,0,Matches,2020-2021,Serie-A
Marco Sportiello,it ITA,GK,Atalanta,28.0,1992.0,14.0,2,2,2,0,0,1,3,33.3,2,0,0,0,2,4,5,1,Matches,2020-2021,Serie-A
Mattia Sprocati,it ITA,"MF,FW",Parma,27.0,1993.0,0.2,1,0,0,1,0,1,1,100.0,0,0,0,0,1,2,0,0,Matches,2020-2021,Serie-A
Thomas Strakosha,al ALB,GK,Lazio,25.0,1995.0,9.0,1,1,1,0,0,0,0,,0,0,0,0,1,2,4,0,Matches,2020-2021,Serie-A
Kevin Strootman,nl NED,MF,Genoa,30.0,1990.0,14.6,30,18,13,15,2,14,32,43.8,18,35,3,32,25,55,18,0,Matches,2020-2021,Serie-A
Jens Stryger Larsen,dk DEN,DF,Udinese,29.0,1991.0,29.3,17,11,14,3,0,8,25,32.0,17,26,11,15,24,41,65,0,Matches,2020-2021,Serie-A
Stefano Sturaro,it ITA,MF,Hellas Verona,27.0,1993.0,4.7,4,3,3,0,1,2,8,25.0,6,5,1,4,5,9,10,0,Matches,2020-2021,Serie-A
Stefano Sturaro,it ITA,MF,Genoa,27.0,1993.0,4.9,11,5,3,6,2,3,15,20.0,12,5,0,5,7,18,2,0,Matches,2020-2021,Serie-A
Bosko Sutalo,hr CRO,DF,Atalanta,20.0,2000.0,2.6,5,5,0,3,2,4,5,80.0,1,2,1,1,2,7,7,1,Matches,2020-2021,Serie-A
Mattias Svanberg,se SWE,MF,Bologna,21.0,1999.0,20.6,38,17,21,9,8,16,45,35.6,29,25,4,21,30,68,25,1,Matches,2020-2021,Serie-A
Wojciech Szczęsny,pl POL,GK,Juventus,30.0,1990.0,29.7,0,0,0,0,0,0,0,,0,2,0,2,3,3,5,1,Matches,2020-2021,Serie-A
Adrien Tameze,cm CMR,MF,Hellas Verona,26.0,1994.0,25.6,39,25,23,15,1,11,27,40.7,16,31,8,23,32,71,46,2,Matches,2020-2021,Serie-A
Ciprian Tătărușanu,ro ROU,GK,Milan,34.0,1986.0,1.0,0,0,0,0,0,0,0,,0,0,0,0,0,0,0,1,Matches,2020-2021,Serie-A
Andrés Tello,co COL,"DF,MF",Benevento,23.0,1996.0,4.6,9,6,8,0,1,5,20,25.0,15,8,1,7,6,15,6,0,Matches,2020-2021,Serie-A
Hidde ter Avest,nl NED,DF,Udinese,23.0,1997.0,3.9,5,2,3,2,0,2,5,40.0,3,3,1,2,2,7,5,0,Matches,2020-2021,Serie-A
Pietro Terracciano,it ITA,GK,Fiorentina,30.0,1990.0,3.0,0,0,0,0,0,0,0,,0,0,0,0,0,0,1,0,Matches,2020-2021,Serie-A
Claudio Terzi,it ITA,DF,Spezia,36.0,1984.0,20.8,33,20,19,14,0,19,28,67.9,9,23,12,11,36,69,55,1,Matches,2020-2021,Serie-A
Morten Thorsby,no NOR,MF,Sampdoria,24.0,1996.0,29.4,76,42,32,36,8,20,60,33.3,40,51,16,35,25,101,30,0,Matches,2020-2021,Serie-A
Jeremy Toljan,de GER,DF,Sassuolo,25.0,1994.0,16.6,21,12,16,3,2,12,27,44.4,15,15,7,8,13,34,28,0,Matches,2020-2021,Serie-A
Rafael Tolói,it ITA,DF,Atalanta,29.0,1990.0,28.2,51,23,21,26,4,26,48,54.2,22,37,7,30,33,84,66,0,Matches,2020-2021,Serie-A
Takehiro Tomiyasu,jp JPN,DF,Bologna,21.0,1998.0,30.2,47,31,27,14,6,21,34,61.8,13,37,19,18,54,101,106,0,Matches,2020-2021,Serie-A
Fikayo Tomori,eng ENG,DF,Milan,22.0,1997.0,16.3,28,18,17,9,2,8,14,57.1,6,32,20,12,18,46,61,1,Matches,2020-2021,Serie-A
Sandro Tonali,it ITA,MF,Milan,20.0,2000.0,14.8,28,19,14,13,1,13,28,46.4,15,18,5,13,22,50,18,0,Matches,2020-2021,Serie-A
Lorenzo Tonelli,it ITA,DF,Sampdoria,30.0,1990.0,19.8,33,18,20,11,2,10,21,47.6,11,21,14,7,25,58,94,1,Matches,2020-2021,Serie-A
Ernesto Torregrossa,ve VEN,FW,Sampdoria,28.0,1992.0,1.9,1,1,0,0,1,0,2,0.0,2,4,0,4,1,2,1,0,Matches,2020-2021,Serie-A
Mattéo Tramoni,fr FRA,"MF,FW",Cagliari,20.0,2000.0,0.8,4,2,2,1,1,1,2,50.0,1,5,0,5,1,5,2,0,Matches,2020-2021,Serie-A
Chaka Traorè,ci CIV,"FW,DF",Parma,15.0,2004.0,0.2,0,0,0,0,0,0,0,,0,0,0,0,0,0,1,1,Matches,2020-2021,Serie-A
Alessandro Tripaldelli,it ITA,DF,Cagliari,21.0,1999.0,3.3,13,6,5,6,2,5,6,83.3,1,6,1,5,3,16,15,0,Matches,2020-2021,Serie-A
Alessandro Tuia,it ITA,DF,Benevento,30.0,1990.0,19.6,39,17,34,4,1,15,25,60.0,10,22,10,12,36,75,91,1,Matches,2020-2021,Serie-A
Ľubomír Tupta,sk SVK,FW,Hellas Verona,22.0,1998.0,0.6,0,0,0,0,0,0,0,,0,0,0,0,0,0,0,0,Matches,2020-2021,Serie-A
Destiny Udogie,it ITA,"DF,MF",Hellas Verona,17.0,2002.0,1.9,6,4,2,2,2,2,2,100.0,0,3,0,3,2,8,4,0,Matches,2020-2021,Serie-A
Samir Ujkani,xk KVX,GK,Torino,32.0,1988.0,1.0,0,0,0,0,0,0,0,,0,0,0,0,0,0,1,0,Matches,2020-2021,Serie-A
Kacper Urbanski,pl POL,FW,Bologna,15.0,2004.0,0.0,0,0,0,0,0,0,0,,0,0,0,0,0,0,0,0,Matches,2020-2021,Serie-A
Lautaro Valenti,ar ARG,DF,Parma,21.0,1999.0,5.5,10,4,7,2,1,6,15,40.0,9,11,3,8,11,21,30,0,Matches,2020-2021,Serie-A
Borja Valero,es ESP,"MF,FW",Fiorentina,35.0,1985.0,5.5,13,9,7,4,2,3,15,20.0,12,6,1,5,6,19,2,0,Matches,2020-2021,Serie-A
Denis Vavro,sk SVK,DF,Lazio,24.0,1996.0,0.4,0,0,0,0,0,0,1,0.0,1,0,0,0,1,1,3,0,Matches,2020-2021,Serie-A
Matías Vecino,uy URU,MF,Inter,28.0,1991.0,3.1,1,1,0,0,1,0,5,0.0,5,7,1,6,4,5,3,0,Matches,2020-2021,Serie-A
Miguel Veloso,pt POR,MF,Hellas Verona,34.0,1986.0,14.6,24,17,10,10,4,12,34,35.3,22,12,1,11,12,36,25,0,Matches,2020-2021,Serie-A
Lorenzo Venuti,it ITA,DF,Fiorentina,25.0,1995.0,19.5,24,11,14,7,3,14,28,50.0,14,18,3,15,17,41,24,0,Matches,2020-2021,Serie-A
Daniele Verde,it ITA,FW,Spezia,24.0,1996.0,10.9,5,4,2,2,1,4,10,40.0,6,5,0,5,9,14,7,0,Matches,2020-2021,Serie-A
Simone Verdi,it ITA,"MF,FW",Torino,28.0,1992.0,18.0,19,12,10,6,3,6,19,31.6,13,8,0,8,8,27,2,2,Matches,2020-2021,Serie-A
Jordan Veretout,fr FRA,MF,Roma,27.0,1993.0,22.8,20,12,8,12,0,9,33,27.3,24,14,3,11,14,34,21,3,Matches,2020-2021,Serie-A
Edoardo Vergani,it ITA,FW,Bologna,19.0,2001.0,0.1,0,0,0,0,0,0,0,,0,0,0,0,0,0,0,0,Matches,2020-2021,Serie-A
Valerio Verre,it ITA,"FW,MF",Sampdoria,26.0,1994.0,11.1,11,7,2,7,2,4,19,21.1,15,14,2,12,9,20,3,0,Matches,2020-2021,Serie-A
Guglielmo Vicario,it ITA,GK,Cagliari,23.0,1996.0,4.0,0,0,0,0,0,0,0,,0,0,0,0,0,0,1,0,Matches,2020-2021,Serie-A
Arturo Vidal,cl CHI,MF,Inter,33.0,1987.0,12.6,27,14,8,13,6,12,41,29.3,29,23,3,20,29,56,11,0,Matches,2020-2021,Serie-A
Ronaldo Vieira,eng ENG,"MF,DF",Hellas Verona,22.0,1998.0,2.5,5,3,1,3,1,0,2,0.0,2,4,3,1,0,5,2,0,Matches,2020-2021,Serie-A
Luca Vignali,it ITA,DF,Spezia,24.0,1996.0,17.7,19,9,10,6,3,7,25,28.0,18,13,5,8,22,41,25,0,Matches,2020-2021,Serie-A
Emanuel Vignato,it ITA,"FW,MF",Bologna,19.0,2000.0,13.4,18,9,9,6,3,3,15,20.0,12,6,1,5,10,28,7,0,Matches,2020-2021,Serie-A
Gonzalo Villar,es ESP,MF,Roma,22.0,1998.0,20.7,44,18,14,24,6,18,61,29.5,43,25,3,22,22,66,14,1,Matches,2020-2021,Serie-A
Nicolas Viola,it ITA,MF,Benevento,30.0,1989.0,11.5,16,9,2,11,3,6,28,21.4,22,10,3,7,9,25,7,0,Matches,2020-2021,Serie-A
Dušan Vlahović,rs SRB,FW,Fiorentina,20.0,2000.0,32.5,13,4,3,4,6,5,16,31.3,11,16,2,14,4,17,15,0,Matches,2020-2021,Serie-A
Mërgim Vojvoda,xk KVX,"DF,FW",Torino,25.0,1995.0,15.1,24,14,18,5,1,12,22,54.5,10,19,4,15,18,42,35,1,Matches,2020-2021,Serie-A
Stefan de Vrij,nl NED,DF,Inter,28.0,1992.0,30.4,28,16,15,12,1,15,24,62.5,9,24,18,6,41,69,95,0,Matches,2020-2021,Serie-A
Giacomo Vrioni,al ALB,FW,Juventus,21.0,1998.0,0.0,0,0,0,0,0,0,0,,0,0,0,0,0,0,0,0,Matches,2020-2021,Serie-A
Miloš Vulić,rs SRB,MF,Crotone,23.0,1996.0,14.5,15,8,9,1,5,8,21,38.1,13,10,1,9,8,23,8,0,Matches,2020-2021,Serie-A
Walace,br BRA,MF,Udinese,25.0,1995.0,22.8,50,23,28,19,3,21,60,35.0,39,36,3,33,34,84,23,0,Matches,2020-2021,Serie-A
Sebastian Walukiewicz,pl POL,DF,Cagliari,20.0,2000.0,18.0,27,19,11,13,3,12,30,40.0,18,22,14,8,36,63,60,0,Matches,2020-2021,Serie-A
Maya Yoshida,jp JPN,DF,Sampdoria,31.0,1988.0,25.3,17,4,10,7,0,7,13,53.8,6,45,34,11,57,74,93,1,Matches,2020-2021,Serie-A
Ashley Young,eng ENG,DF,Inter,35.0,1985.0,15.8,15,7,8,4,3,3,13,23.1,10,13,0,13,6,21,31,0,Matches,2020-2021,Serie-A
Mattia Zaccagni,it ITA,MF,Hellas Verona,25.0,1995.0,29.0,27,13,8,11,8,8,25,32.0,17,28,4,24,27,54,13,1,Matches,2020-2021,Serie-A
Vasilios Zagaritis,gr GRE,DF,Parma,19.0,2001.0,0.7,0,0,0,0,0,0,0,,0,1,0,1,0,0,0,0,Matches,2020-2021,Serie-A
Miha Zajc,si SVN,MF,Genoa,26.0,1994.0,20.7,22,14,9,10,3,13,39,33.3,26,30,4,26,27,49,19,0,Matches,2020-2021,Serie-A
Nicola Zalewski,pl POL,MF,Roma,18.0,2002.0,0.1,1,1,0,1,0,1,1,100.0,0,0,0,0,0,1,0,0,Matches,2020-2021,Serie-A
Niccolò Zanellato,it ITA,MF,Crotone,22.0,1998.0,18.2,24,14,16,6,2,13,36,36.1,23,19,5,14,16,40,12,2,Matches,2020-2021,Serie-A
Cristián Zapata,co COL,DF,Genoa,33.0,1986.0,10.8,18,12,11,7,0,10,14,71.4,4,15,11,4,15,33,56,0,Matches,2020-2021,Serie-A
Duván Zapata,co COL,FW,Atalanta,29.0,1991.0,26.4,12,5,2,3,7,4,13,30.8,9,19,5,14,6,18,19,0,Matches,2020-2021,Serie-A
Gabriele Zappa,it ITA,DF,Cagliari,20.0,1999.0,26.6,34,17,16,15,3,22,49,44.9,27,36,4,32,24,58,50,0,Matches,2020-2021,Serie-A
Davide Zappacosta,it ITA,DF,Genoa,28.0,1992.0,22.7,33,16,15,13,5,15,30,50.0,15,17,1,16,18,51,41,0,Matches,2020-2021,Serie-A
Simone Zaza,it ITA,FW,Torino,29.0,1991.0,16.6,15,9,4,6,5,6,20,30.0,14,14,0,14,3,18,5,1,Matches,2020-2021,Serie-A
Marvin Zeegelaar,nl NED,DF,Udinese,29.0,1990.0,19.3,40,18,23,16,1,20,39,51.3,19,21,9,12,24,64,43,0,Matches,2020-2021,Serie-A
Piotr Zieliński,pl POL,MF,Napoli,26.0,1994.0,28.0,18,10,8,7,3,7,20,35.0,13,23,4,19,18,36,12,0,Matches,2020-2021,Serie-A
Joshua Zirkzee,nl NED,"FW,MF",Parma,19.0,2001.0,1.3,2,2,1,1,0,1,3,33.3,2,1,1,0,0,2,1,0,Matches,2020-2021,Serie-A
Jeroen Zoet,nl NED,GK,Spezia,29.0,1991.0,6.7,0,0,0,0,0,0,1,0.0,1,0,0,0,0,0,4,2,Matches,2020-2021,Serie-A
Filip Đuričić,rs SRB,"MF,FW",Sassuolo,28.0,1992.0,23.1,32,23,6,16,10,12,30,40.0,18,20,2,18,9,41,12,0,Matches,2020-2021,Serie-A
Tammy Abraham,eng ENG,FW,Roma,23.0,1997.0,34.3,27,13,7,14,6,9,22,40.9,13,17,3,14,5,32,27,0,Matches,2021-2022,Serie-A
Francesco Acerbi,it ITA,DF,Lazio,33.0,1988.0,28.2,25,12,15,9,1,12,19,63.2,7,37,28,9,34,59,92,0,Matches,2021-2022,Serie-A
Michel Aebischer,ch SUI,MF,Bologna,24.0,1997.0,4.9,14,5,5,8,1,6,11,54.5,5,4,1,3,6,20,3,0,Matches,2021-2022,Serie-A
Felix Afena-Gyan,gh GHA,"FW,MF",Roma,18.0,2003.0,7.4,10,3,1,6,3,4,7,57.1,3,4,0,4,3,13,0,0,Matches,2021-2022,Serie-A
Kevin Agudelo,co COL,"MF,FW",Spezia,22.0,1998.0,13.7,44,26,13,26,5,7,20,35.0,13,22,0,22,8,52,6,0,Matches,2021-2022,Serie-A
Ola Aina,ng NGA,DF,Torino,24.0,1996.0,16.0,27,19,11,10,6,15,23,65.2,8,17,3,14,28,55,30,0,Matches,2021-2022,Serie-A
Marley Aké,fr FRA,"FW,MF",Juventus,20.0,2001.0,0.9,0,0,0,0,0,0,2,0.0,2,0,0,0,1,1,0,0,Matches,2021-2022,Serie-A
Jean-Daniel Akpa-Akpro,ci CIV,MF,Lazio,28.0,1992.0,3.5,17,10,7,9,1,7,12,58.3,5,4,2,2,2,19,6,0,Matches,2021-2022,Serie-A
Luis Alberto,es ESP,MF,Lazio,28.0,1992.0,26.1,29,17,8,11,10,8,52,15.4,44,32,4,28,13,42,7,0,Matches,2021-2022,Serie-A
Giorgio Altare,it ITA,DF,Cagliari,22.0,1998.0,16.3,39,28,18,18,3,21,26,80.8,5,17,5,12,30,69,70,0,Matches,2021-2022,Serie-A
Wisdom Amey,it ITA,DF,Bologna,15.0,2005.0,0.8,3,2,1,1,1,2,3,66.7,1,2,0,2,3,6,1,0,Matches,2021-2022,Serie-A
Kelvin Amian,fr FRA,DF,Spezia,23.0,1998.0,29.4,66,42,43,18,5,30,41,73.2,11,39,21,18,32,98,75,0,Matches,2021-2022,Serie-A
Nadiem Amiri,de GER,"MF,FW",Genoa,24.0,1996.0,7.6,6,4,2,2,2,2,9,22.2,7,7,0,7,0,6,0,0,Matches,2021-2022,Serie-A
Ethan Ampadu,wls WAL,"MF,DF",Venezia,20.0,2000.0,25.4,67,43,37,27,3,24,58,41.4,34,49,19,30,51,118,76,0,Matches,2021-2022,Serie-A
Sofyan Amrabat,ma MAR,MF,Fiorentina,24.0,1996.0,10.5,24,13,9,13,2,11,19,57.9,8,25,8,17,5,29,6,1,Matches,2021-2022,Serie-A
Felipe Anderson,br BRA,FW,Lazio,28.0,1993.0,32.1,71,45,30,33,8,27,99,27.3,72,65,6,59,20,91,16,0,Matches,2021-2022,Serie-A
Ebenezer Annan,gh GHA,DF,Bologna,18.0,2002.0,0.3,1,1,1,0,0,0,0,,0,0,0,0,1,2,1,0,Matches,2021-2022,Serie-A
Cristian Ansaldi,ar ARG,DF,Torino,34.0,1986.0,7.7,20,9,11,7,2,10,13,76.9,3,9,1,8,6,26,10,0,Matches,2021-2022,Serie-A
Janis Antiste,fr FRA,FW,Spezia,18.0,2002.0,8.8,18,11,6,6,6,5,13,38.5,8,7,1,6,4,22,6,0,Matches,2021-2022,Serie-A
Mattia Aramu,it ITA,"MF,FW",Venezia,26.0,1995.0,23.3,20,15,5,9,6,8,33,24.2,25,20,2,18,8,28,19,0,Matches,2021-2022,Serie-A
Marko Arnautović,at AUT,FW,Bologna,32.0,1989.0,29.9,17,9,1,11,5,7,30,23.3,23,13,2,11,7,24,17,0,Matches,2021-2022,Serie-A
Tolgay Arslan,de GER,MF,Udinese,30.0,1990.0,18.4,35,20,15,16,4,19,50,38.0,31,17,4,13,13,48,23,1,Matches,2021-2022,Serie-A
Kristoffer Askildsen,no NOR,MF,Sampdoria,20.0,2001.0,8.4,18,6,7,11,0,9,19,47.4,10,14,7,7,15,33,15,0,Matches,2021-2022,Serie-A
Kristjan Asllani,al ALB,MF,Empoli,19.0,2002.0,15.0,18,9,9,8,1,11,29,37.9,18,16,7,9,19,37,15,1,Matches,2021-2022,Serie-A
Emil Audero,id IDN,GK,Sampdoria,24.0,1997.0,28.4,3,1,3,0,0,3,5,60.0,2,0,0,0,2,5,17,2,Matches,2021-2022,Serie-A
Tommaso Augello,it ITA,DF,Sampdoria,26.0,1994.0,26.6,36,20,22,8,6,17,29,58.6,12,19,4,15,29,65,68,1,Matches,2021-2022,Serie-A
Ramzi Aya,it ITA,DF,Salernitana,30.0,1990.0,1.5,1,1,1,0,0,1,1,100.0,0,0,0,0,0,1,4,0,Matches,2021-2022,Serie-A
Kaan Ayhan,tr TUR,DF,Sassuolo,26.0,1994.0,15.0,20,12,14,6,0,7,15,46.7,8,20,14,6,13,33,57,0,Matches,2021-2022,Serie-A
Milan Badelj,hr CRO,MF,Genoa,32.0,1989.0,31.6,64,37,25,30,9,34,80,42.5,46,39,7,32,85,149,43,0,Matches,2021-2022,Serie-A
Nicola Bagnolini,it ITA,GK,Bologna,17.0,2004.0,0.0,0,0,0,0,0,0,0,,0,0,0,0,0,0,0,0,Matches,2021-2022,Serie-A
Issa Bah,lu LUX,FW,Venezia,19.0,2002.0,0.1,0,0,0,0,0,0,0,,0,0,0,0,0,0,0,0,Matches,2021-2022,Serie-A
Nedim Bajrami,al ALB,"MF,FW",Empoli,22.0,1999.0,22.8,21,14,5,13,3,4,14,28.6,10,11,0,11,3,24,8,0,Matches,2021-2022,Serie-A
Tiemoué Bakayoko,fr FRA,MF,Milan,26.0,1994.0,5.6,19,13,9,7,3,5,16,31.3,11,8,1,7,9,28,10,2,Matches,2021-2022,Serie-A
Tommaso Baldanzi,it ITA,FW,Empoli,18.0,2003.0,0.2,0,0,0,0,0,0,0,,0,1,0,1,0,0,0,0,Matches,2021-2022,Serie-A
Keita Baldé,sn SEN,FW,Cagliari,26.0,1995.0,13.7,8,4,1,5,2,1,10,10.0,9,6,0,6,4,12,6,0,Matches,2021-2022,Serie-A
Fodé Ballo-Touré,sn SEN,DF,Milan,24.0,1997.0,5.0,18,14,5,13,0,4,9,44.4,5,6,2,4,3,21,5,0,Matches,2021-2022,Serie-A
Filippo Bandinelli,it ITA,MF,Empoli,26.0,1995.0,21.7,33,20,10,17,6,15,31,48.4,16,22,5,17,10,43,37,2,Matches,2021-2022,Serie-A
Mattia Bani,it ITA,DF,Genoa,27.0,1993.0,13.5,23,13,17,6,0,14,18,77.8,4,19,11,8,20,43,76,0,Matches,2021-2022,Serie-A
Antonín Barák,cz CZE,"MF,FW",Hellas Verona,26.0,1994.0,26.0,18,8,9,8,1,5,17,29.4,12,32,5,27,6,24,26,0,Matches,2021-2022,Serie-A
Francesco Bardi,it ITA,GK,Bologna,29.0,1992.0,2.0,0,0,0,0,0,0,0,,0,0,0,0,0,0,0,0,Matches,2021-2022,Serie-A
Nicolò Barella,it ITA,MF,Inter,24.0,1997.0,32.4,63,42,17,35,11,29,55,52.7,26,26,2,24,21,84,8,2,Matches,2021-2022,Serie-A
Musa Barrow,gm GAM,"FW,MF",Bologna,22.0,1998.0,23.7,12,4,4,4,4,6,20,30.0,14,20,1,19,6,18,8,0,Matches,2021-2022,Serie-A
Daniele Baselli,it ITA,"MF,FW",Torino,29.0,1992.0,1.7,3,3,2,0,1,2,6,33.3,4,0,0,0,1,4,2,0,Matches,2021-2022,Serie-A
Daniele Baselli,it ITA,MF,Cagliari,29.0,1992.0,3.2,6,5,3,1,2,1,5,20.0,4,2,0,2,2,8,5,0,Matches,2021-2022,Serie-A
Toma Bašić,hr CRO,MF,Lazio,24.0,1996.0,10.9,12,8,3,9,0,5,17,29.4,12,13,4,9,4,16,21,0,Matches,2021-2022,Serie-A
Alessandro Bastoni,it ITA,DF,Inter,22.0,1999.0,25.7,44,25,28,13,3,17,34,50.0,17,22,12,10,35,79,59,1,Matches,2021-2022,Serie-A
Simone Bastoni,it ITA,"MF,DF",Spezia,24.0,1996.0,25.4,52,34,28,17,7,21,65,32.3,44,38,11,27,30,82,31,0,Matches,2021-2022,Serie-A
Rodrigo Becão,br BRA,DF,Udinese,25.0,1996.0,34.8,81,46,49,30,2,34,60,56.7,26,45,20,25,42,123,89,3,Matches,2021-2022,Serie-A
Valon Behrami,ch SUI,"MF,FW",Genoa,36.0,1985.0,3.5,3,1,0,2,1,0,7,0.0,7,4,1,3,1,4,4,0,Matches,2021-2022,Serie-A
Vid Belec,si SVN,GK,Salernitana,31.0,1990.0,21.5,0,0,0,0,0,0,0,,0,0,0,0,0,0,9,1,Matches,2021-2022,Serie-A
Raoul Bellanova,it ITA,"DF,FW",Cagliari,21.0,2000.0,27.7,29,15,14,12,3,6,27,22.2,21,39,8,31,21,50,51,0,Matches,2021-2022,Serie-A
Andrea Belotti,it ITA,FW,Torino,27.0,1993.0,15.2,7,3,2,2,3,3,12,25.0,9,12,4,8,2,9,9,0,Matches,2021-2022,Serie-A
Marco Benassi,it ITA,"DF,MF",Fiorentina,26.0,1994.0,1.8,1,0,1,0,0,1,2,50.0,1,3,0,3,3,4,3,0,Matches,2021-2022,Serie-A
Marco Benassi,it ITA,MF,Empoli,26.0,1994.0,4.2,6,3,3,2,1,1,10,10.0,9,4,0,4,3,9,6,0,Matches,2021-2022,Serie-A
Filip Benković,hr CRO,"DF,FW",Udinese,24.0,1997.0,0.1,0,0,0,0,0,0,0,,0,0,0,0,0,0,0,0,Matches,2021-2022,Serie-A
Ismaël Bennacer,dz ALG,MF,Milan,23.0,1997.0,16.9,44,30,22,15,7,21,50,42.0,29,20,4,16,25,69,15,0,Matches,2021-2022,Serie-A
Rodrigo Bentancur,uy URU,MF,Juventus,24.0,1997.0,12.8,32,18,11,18,3,7,20,35.0,13,15,2,13,26,58,15,1,Matches,2021-2022,Serie-A
Alessandro Berardi,it ITA,GK,Hellas Verona,30.0,1991.0,1.0,0,0,0,0,0,0,0,,0,0,0,0,0,0,0,0,Matches,2021-2022,Serie-A
Domenico Berardi,it ITA,FW,Sassuolo,26.0,1994.0,31.3,32,19,9,16,7,15,57,26.3,42,39,2,37,31,63,23,0,Matches,2021-2022,Serie-A
Bartosz Bereszyński,pl POL,DF,Sampdoria,29.0,1992.0,32.7,64,38,34,25,5,37,80,46.3,43,38,12,26,42,106,73,1,Matches,2021-2022,Serie-A
Etrit Berisha,al ALB,GK,Torino,32.0,1989.0,10.0,0,0,0,0,0,0,0,,0,0,0,0,0,0,4,0,Matches,2021-2022,Serie-A
Federico Bernardeschi,it ITA,"MF,FW",Juventus,27.0,1994.0,16.4,16,10,7,4,5,6,13,46.2,7,12,4,8,5,21,15,0,Matches,2021-2022,Serie-A
Nicolò Bertola,it ITA,"MF,DF",Spezia,18.0,2003.0,0.4,3,2,3,0,0,3,4,75.0,1,0,0,0,3,6,1,0,Matches,2021-2022,Serie-A
Daniel Bessa,it ITA,MF,Hellas Verona,28.0,1993.0,8.5,7,2,3,3,1,4,15,26.7,11,13,3,10,5,12,11,0,Matches,2021-2022,Serie-A
Beto,gw GNB,FW,Udinese,23.0,1998.0,24.1,21,6,2,14,5,9,19,47.4,10,16,1,15,5,26,25,1,Matches,2021-2022,Serie-A
Luis Binks,eng ENG,DF,Bologna,19.0,2001.0,7.2,8,4,7,1,0,4,6,66.7,2,6,5,1,17,25,33,1,Matches,2021-2022,Serie-A
Cristiano Biraghi,it ITA,DF,Fiorentina,28.0,1992.0,35.0,37,24,17,15,5,22,53,41.5,31,28,10,18,19,56,31,1,Matches,2021-2022,Serie-A
Davide Biraschi,it ITA,DF,Genoa,27.0,1994.0,10.3,31,16,19,9,3,17,24,70.8,7,16,9,7,16,47,26,0,Matches,2021-2022,Serie-A
Bjarki Bjarkason,is ISL,MF,Venezia,21.0,2000.0,0.0,0,0,0,0,0,0,0,,0,0,0,0,0,0,0,0,Matches,2021-2022,Serie-A
Jeremie Boga,ci CIV,"FW,MF",Atalanta,24.0,1997.0,8.5,7,3,0,4,3,4,6,66.7,2,6,0,6,1,8,3,1,Matches,2021-2022,Serie-A
Jeremie Boga,ci CIV,"FW,MF",Sassuolo,24.0,1997.0,7.4,7,4,1,2,4,2,3,66.7,1,3,0,3,2,9,1,1,Matches,2021-2022,Serie-A
Luka Bogdan,hr CRO,DF,Salernitana,25.0,1996.0,4.4,6,3,6,0,0,4,8,50.0,4,3,2,1,6,12,21,0,Matches,2021-2022,Serie-A
Emil Bohinen,no NOR,MF,Salernitana,22.0,1999.0,7.8,15,9,4,9,2,10,20,50.0,10,17,3,14,12,27,14,0,Matches,2021-2022,Serie-A
Giacomo Bonaventura,it ITA,MF,Fiorentina,31.0,1989.0,25.2,33,17,12,16,5,21,46,45.7,25,20,2,18,14,47,9,1,Matches,2021-2022,Serie-A
Federico Bonazzoli,it ITA,"FW,MF",Salernitana,24.0,1997.0,20.7,24,12,9,8,7,6,25,24.0,19,17,1,16,6,30,7,0,Matches,2021-2022,Serie-A
Kevin Bonifazi,it ITA,DF,Bologna,25.0,1996.0,13.4,25,16,16,7,2,13,14,92.9,1,22,7,15,16,41,35,0,Matches,2021-2022,Serie-A
Leonardo Bonucci,it ITA,DF,Juventus,34.0,1987.0,22.3,14,5,4,10,0,8,13,61.5,5,22,17,5,26,40,82,0,Matches,2021-2022,Serie-A
Mehdi Bourabia,ma MAR,MF,Spezia,29.0,1991.0,3.1,5,1,2,3,0,3,11,27.3,8,7,6,1,3,8,10,0,Matches,2021-2022,Serie-A
Edoardo Bove,it ITA,"MF,DF",Roma,19.0,2002.0,0.8,1,1,1,0,0,0,2,0.0,2,1,0,1,1,2,0,0,Matches,2021-2022,Serie-A
Josip Brekalo,hr CRO,MF,Torino,23.0,1998.0,25.4,9,5,5,1,3,3,21,14.3,18,16,1,15,4,13,7,1,Matches,2021-2022,Serie-A
Gleison Bremer,br BRA,DF,Torino,24.0,1997.0,32.1,49,24,27,22,0,18,28,64.3,10,54,23,31,105,154,137,0,Matches,2021-2022,Serie-A
Marcelo Brozović,hr CRO,MF,Inter,28.0,1992.0,32.6,77,45,34,35,8,34,68,50.0,34,28,10,18,37,114,36,2,Matches,2021-2022,Serie-A
Aleksander Buksa,pl POL,FW,Genoa,18.0,2003.0,0.7,0,0,0,0,0,0,1,0.0,1,0,0,0,0,0,1,0,Matches,2021-2022,Serie-A
Alessandro Buongiorno,it ITA,DF,Torino,22.0,1999.0,13.1,20,9,9,8,3,9,13,69.2,4,12,6,6,31,51,44,0,Matches,2021-2022,Serie-A
Gianluca Busio,us USA,MF,Venezia,19.0,2002.0,21.7,53,28,27,20,6,28,63,44.4,35,45,13,32,21,74,30,1,Matches,2021-2022,Serie-A
Arthur Cabral,br BRA,FW,Fiorentina,23.0,1998.0,8.3,9,5,2,5,2,4,7,57.1,3,4,1,3,1,10,8,0,Matches,2021-2022,Serie-A
Jovane Cabral,cv CPV,FW,Lazio,23.0,1998.0,2.1,2,1,1,0,1,0,0,,0,1,1,0,1,3,1,0,Matches,2021-2022,Serie-A
Liberato Cacace,nz NZL,DF,Empoli,20.0,2000.0,5.2,15,6,8,4,3,8,8,100.0,0,7,2,5,8,23,9,0,Matches,2021-2022,Serie-A
Martín Cáceres,uy URU,DF,Cagliari,34.0,1987.0,9.2,13,7,5,5,3,4,12,33.3,8,12,3,9,14,27,21,0,Matches,2021-2022,Serie-A
Felipe Caicedo,ec ECU,FW,Genoa,32.0,1988.0,3.2,3,3,0,2,1,0,1,0.0,1,1,0,1,0,3,4,0,Matches,2021-2022,Serie-A
Felipe Caicedo,ec ECU,"FW,DF",Inter,32.0,1988.0,0.3,0,0,0,0,0,0,0,,0,1,0,1,0,0,0,0,Matches,2021-2022,Serie-A
Davide Calabria,it ITA,DF,Milan,24.0,1996.0,23.5,62,37,31,23,8,37,72,51.4,35,25,5,20,23,85,40,1,Matches,2021-2022,Serie-A
Riccardo Calafiori,it ITA,DF,Genoa,19.0,2002.0,0.9,1,0,0,0,1,1,2,50.0,1,2,1,1,2,3,4,0,Matches,2021-2022,Serie-A
Riccardo Calafiori,it ITA,DF,Roma,19.0,2002.0,1.9,5,4,2,2,1,1,5,20.0,4,3,0,3,3,8,1,0,Matches,2021-2022,Serie-A
Mattia Caldara,it ITA,DF,Venezia,27.0,1994.0,30.0,48,28,30,15,3,20,34,58.8,14,49,37,12,62,110,147,1,Matches,2021-2022,Serie-A
Hakan Çalhanoğlu,tr TUR,MF,Inter,27.0,1994.0,27.6,41,23,16,19,6,11,40,27.5,29,29,5,24,25,66,12,0,Matches,2021-2022,Serie-A
José Callejón,es ESP,FW,Fiorentina,34.0,1987.0,14.4,15,6,6,6,3,13,31,41.9,18,6,0,6,3,18,1,1,Matches,2021-2022,Serie-A
Andrea Cambiaso,it ITA,DF,Genoa,21.0,2000.0,19.9,46,20,28,14,4,18,32,56.3,14,33,8,25,23,69,37,1,Matches,2021-2022,Serie-A
Matteo Cancellieri,it ITA,"MF,DF",Hellas Verona,19.0,2002.0,2.5,4,4,2,2,0,0,5,0.0,5,2,0,2,1,5,0,0,Matches,2021-2022,Serie-A
Antonio Candreva,it ITA,"MF,FW",Sampdoria,34.0,1987.0,34.7,27,16,9,11,7,19,55,34.5,36,23,2,21,33,60,19,0,Matches,2021-2022,Serie-A
Leonardo Capezzi,it ITA,MF,Salernitana,26.0,1995.0,1.9,3,1,0,3,0,1,4,25.0,3,8,4,4,0,3,2,0,Matches,2021-2022,Serie-A
Gianluca Caprari,it ITA,"MF,FW",Hellas Verona,28.0,1993.0,30.4,43,25,10,22,11,17,51,33.3,34,32,0,32,4,47,7,0,Matches,2021-2022,Serie-A
Francesco Caputo,it ITA,FW,Sampdoria,33.0,1987.0,31.0,5,2,1,3,1,1,6,16.7,5,5,0,5,2,7,10,0,Matches,2021-2022,Serie-A
Francesco Caputo,it ITA,FW,Sassuolo,33.0,1987.0,1.7,0,0,0,0,0,0,0,,0,0,0,0,0,0,0,0,Matches,2021-2022,Serie-A
Andrea Carboni,it ITA,DF,Cagliari,20.0,2001.0,24.6,53,24,33,16,4,19,42,45.2,23,42,15,27,27,80,87,0,Matches,2021-2022,Serie-A
Nicolò Casale,it ITA,DF,Hellas Verona,23.0,1998.0,28.7,46,30,25,19,2,21,37,56.8,16,31,12,19,49,95,95,0,Matches,2021-2022,Serie-A
Francesco Cassata,it ITA,MF,Genoa,24.0,1997.0,0.1,0,0,0,0,0,0,0,,0,0,0,0,0,0,0,0,Matches,2021-2022,Serie-A
Samu Castillejo,es ESP,"FW,MF",Milan,26.0,1995.0,1.4,4,2,0,2,2,1,8,12.5,7,4,1,3,2,6,1,0,Matches,2021-2022,Serie-A
Gaetano Castrovilli,it ITA,MF,Fiorentina,24.0,1997.0,15.5,25,17,15,6,4,12,23,52.2,11,18,4,14,11,36,6,0,Matches,2021-2022,Serie-A
Danilo Cataldi,it ITA,MF,Lazio,26.0,1994.0,19.0,36,17,15,17,4,12,38,31.6,26,24,12,12,17,53,19,1,Matches,2021-2022,Serie-A
Pietro Ceccaroni,it ITA,DF,Venezia,25.0,1995.0,34.7,55,31,33,18,4,25,36,69.4,11,45,32,13,30,85,143,0,Matches,2021-2022,Serie-A
Federico Ceccherini,it ITA,DF,Hellas Verona,29.0,1992.0,26.2,32,16,19,10,3,19,33,57.6,14,13,8,5,50,82,76,1,Matches,2021-2022,Serie-A
Emil Ceide,no NOR,"FW,MF",Sassuolo,19.0,2001.0,0.6,1,1,0,1,0,1,2,50.0,1,1,0,1,0,1,0,0,Matches,2021-2022,Serie-A
Luca Ceppitelli,it ITA,DF,Cagliari,31.0,1989.0,16.1,23,12,13,10,0,16,27,59.3,11,21,14,7,25,48,54,0,Matches,2021-2022,Serie-A
Damir Ceter,co COL,FW,Cagliari,23.0,1997.0,0.1,0,0,0,0,0,0,0,,0,0,0,0,0,0,0,0,Matches,2021-2022,Serie-A
Julian Chabot,de GER,DF,Sampdoria,23.0,1998.0,5.4,12,10,8,4,0,8,10,80.0,2,7,4,3,9,21,28,1,Matches,2021-2022,Serie-A
Giorgio Chiellini,it ITA,DF,Juventus,36.0,1984.0,15.0,22,13,17,4,1,7,13,53.8,6,24,18,6,22,44,59,0,Matches,2021-2022,Serie-A
Federico Chiesa,it ITA,"MF,FW",Juventus,23.0,1997.0,9.6,26,19,9,9,8,12,26,46.2,14,7,0,7,4,30,3,0,Matches,2021-2022,Serie-A
Vlad Chiricheș,ro ROU,DF,Sassuolo,31.0,1989.0,25.6,28,15,19,9,0,10,21,47.6,11,34,21,13,41,69,71,4,Matches,2021-2022,Serie-A
Riccardo Ciervo,it ITA,"MF,DF",Sampdoria,19.0,2002.0,2.5,8,3,4,3,1,2,6,33.3,4,1,0,1,2,10,2,0,Matches,2021-2022,Serie-A
Moustapha Cissé,gn GUI,FW,Atalanta,17.0,2003.0,0.4,1,0,0,1,0,0,3,0.0,3,0,0,0,0,1,0,0,Matches,2021-2022,Serie-A
Giorgio Cittadini,it ITA,DF,Atalanta,19.0,2002.0,0.0,0,0,0,0,0,0,0,,0,0,0,0,1,1,0,0,Matches,2021-2022,Serie-A
Ebrima Colley,gm GAM,"FW,MF",Spezia,21.0,2000.0,4.4,6,1,3,2,1,1,7,14.3,6,8,0,8,3,9,2,0,Matches,2021-2022,Serie-A
Omar Colley,gm GAM,DF,Sampdoria,28.0,1992.0,30.5,47,36,32,14,1,22,32,68.8,10,31,19,12,80,127,135,2,Matches,2021-2022,Serie-A
Andrea Consigli,it ITA,GK,Sassuolo,34.0,1987.0,36.9,0,0,0,0,0,0,2,0.0,2,0,0,0,0,0,23,3,Matches,2021-2022,Serie-A
Andrea Conti,it ITA,"DF,MF",Sampdoria,27.0,1994.0,2.6,4,2,2,1,1,3,6,50.0,3,4,0,4,7,11,4,0,Matches,2021-2022,Serie-A
Andrea Conti,it ITA,DF,Milan,27.0,1994.0,0.1,0,0,0,0,0,0,0,,0,0,0,0,0,0,0,0,Matches,2021-2022,Serie-A
Diego Coppola,it ITA,DF,Hellas Verona,17.0,2003.0,2.8,8,4,4,4,0,3,3,100.0,0,5,1,4,4,12,5,0,Matches,2021-2022,Serie-A
Joaquín Correa,ar ARG,FW,Inter,26.0,1994.0,11.4,11,5,2,6,3,1,13,7.7,12,8,1,7,3,14,2,0,Matches,2021-2022,Serie-A
Lassana Coulibaly,ml MLI,MF,Salernitana,25.0,1996.0,25.9,58,32,29,26,3,24,62,38.7,38,40,13,27,22,80,27,0,Matches,2021-2022,Serie-A
Mamadou Coulibaly,sn SEN,MF,Salernitana,22.0,1999.0,9.0,15,12,8,5,2,7,20,35.0,13,9,0,9,11,26,9,0,Matches,2021-2022,Serie-A
Alessio Cragno,it ITA,GK,Cagliari,27.0,1994.0,35.0,3,3,2,1,0,3,3,100.0,0,0,0,0,1,4,14,1,Matches,2021-2022,Serie-A
Domenico Criscito,it ITA,DF,Genoa,34.0,1986.0,18.0,37,21,19,14,4,16,25,64.0,9,22,12,10,39,76,57,0,Matches,2021-2022,Serie-A
Bryan Cristante,it ITA,MF,Roma,26.0,1995.0,29.8,79,39,31,39,9,37,69,53.6,32,31,5,26,40,119,45,0,Matches,2021-2022,Serie-A
Domen Črnigoj,si SVN,MF,Venezia,25.0,1995.0,20.9,21,13,7,11,3,11,29,37.9,18,27,8,19,24,45,42,0,Matches,2021-2022,Serie-A
Giovanni Crociata,it ITA,FW,Empoli,23.0,1997.0,0.2,0,0,0,0,0,0,1,0.0,1,0,0,0,0,0,0,0,Matches,2021-2022,Serie-A
Juan Cuadrado,co COL,"DF,MF",Juventus,33.0,1988.0,27.6,48,23,30,13,5,30,55,54.5,25,23,5,18,29,77,34,0,Matches,2021-2022,Serie-A
Mickaël Cuisance,fr FRA,MF,Venezia,21.0,1999.0,10.2,23,9,7,12,4,10,28,35.7,18,14,0,14,12,35,5,0,Matches,2021-2022,Serie-A
Patrick Cutrone,it ITA,FW,Empoli,23.0,1998.0,15.6,5,2,0,3,2,1,9,11.1,8,11,1,10,5,10,1,0,Matches,2021-2022,Serie-A
Danilo D'Ambrosio,it ITA,DF,Inter,32.0,1988.0,11.1,30,15,21,8,1,11,22,50.0,11,21,10,11,8,38,20,0,Matches,2021-2022,Serie-A
Mikkel Damsgaard,dk DEN,"MF,FW",Sampdoria,21.0,2000.0,6.4,27,13,12,11,4,20,36,55.6,16,16,1,15,7,34,7,0,Matches,2021-2022,Serie-A
Danilo,br BRA,"DF,MF",Juventus,30.0,1991.0,21.0,37,26,20,13,4,18,28,64.3,10,21,12,9,32,69,53,1,Matches,2021-2022,Serie-A
Ebrima Darboe,gm GAM,MF,Roma,20.0,2001.0,0.7,1,1,0,1,0,0,0,,0,0,0,0,1,2,0,1,Matches,2021-2022,Serie-A
Matteo Darmian,it ITA,DF,Inter,31.0,1989.0,16.7,32,16,17,9,6,16,41,39.0,25,16,1,15,19,51,25,0,Matches,2021-2022,Serie-A
Paweł Dawidowicz,pl POL,DF,Hellas Verona,26.0,1995.0,13.3,30,18,16,10,4,16,25,64.0,9,14,11,3,21,51,53,0,Matches,2021-2022,Serie-A
Sebastien De Maio,fr FRA,DF,Udinese,34.0,1987.0,2.0,5,1,4,1,0,1,9,11.1,8,6,5,1,1,6,9,0,Matches,2021-2022,Serie-A
Tommaso De Nipoti,it ITA,FW,Atalanta,18.0,2003.0,0.1,0,0,0,0,0,0,0,,0,0,0,0,0,0,0,0,Matches,2021-2022,Serie-A
Mattia De Sciglio,it ITA,DF,Juventus,28.0,1992.0,13.0,24,12,7,9,8,11,24,45.8,13,10,0,10,10,34,30,0,Matches,2021-2022,Serie-A
Lorenzo De Silvestri,it ITA,DF,Bologna,33.0,1988.0,25.5,23,14,13,8,2,9,31,29.0,22,25,7,18,26,49,52,0,Matches,2021-2022,Serie-A
Grégoire Defrel,mq MTQ,FW,Sassuolo,30.0,1991.0,15.1,15,9,4,8,3,6,16,37.5,10,11,1,10,4,19,11,0,Matches,2021-2022,Serie-A
Alessandro Deiola,it ITA,MF,Cagliari,25.0,1995.0,23.7,47,22,15,25,7,23,58,39.7,35,28,10,18,26,73,45,0,Matches,2021-2022,Serie-A
Filippo Delli Carri,it ITA,DF,Salernitana,22.0,1999.0,3.7,6,4,4,2,0,5,14,35.7,9,6,2,4,4,10,14,0,Matches,2021-2022,Serie-A
Merih Demiral,tr TUR,DF,Atalanta,23.0,1998.0,21.3,31,17,18,12,1,15,28,53.6,13,26,14,12,58,89,68,1,Matches,2021-2022,Serie-A
Diego Demme,de GER,MF,Napoli,29.0,1991.0,7.7,21,12,4,13,4,10,21,47.6,11,11,2,9,9,30,2,0,Matches,2021-2022,Serie-A
Fabio Depaoli,it ITA,DF,Hellas Verona,24.0,1997.0,7.8,12,7,6,4,2,1,7,14.3,6,9,2,7,8,20,14,0,Matches,2021-2022,Serie-A
Fabio Depaoli,it ITA,"MF,DF",Sampdoria,24.0,1997.0,1.2,3,1,1,2,0,0,2,0.0,2,2,1,1,1,4,2,0,Matches,2021-2022,Serie-A
Mattia Destro,it ITA,FW,Genoa,30.0,1991.0,19.4,9,4,1,4,4,1,6,16.7,5,14,1,13,2,11,16,0,Matches,2021-2022,Serie-A
Gerard Deulofeu,es ESP,"FW,MF",Udinese,27.0,1994.0,29.1,11,6,2,3,6,7,29,24.1,22,14,0,14,9,20,4,0,Matches,2021-2022,Serie-A
Jacopo Dezi,it ITA,MF,Venezia,29.0,1992.0,0.2,0,0,0,0,0,0,1,0.0,1,0,0,0,1,1,0,0,Matches,2021-2022,Serie-A
Samuel Di Carmine,it ITA,FW,Hellas Verona,32.0,1988.0,0.4,0,0,0,0,0,0,0,,0,0,0,0,0,0,0,0,Matches,2021-2022,Serie-A
Federico Di Francesco,it ITA,"FW,MF",Empoli,27.0,1994.0,15.2,16,5,2,8,6,9,23,39.1,14,17,1,16,9,25,11,0,Matches,2021-2022,Serie-A
Giovanni Di Lorenzo,it ITA,DF,Napoli,27.0,1993.0,31.9,58,36,30,20,8,33,58,56.9,25,28,10,18,38,96,46,1,Matches,2021-2022,Serie-A
Francesco Di Mariano,it ITA,FW,Venezia,25.0,1996.0,0.7,1,1,0,1,0,0,0,,0,2,1,1,0,1,0,0,Matches,2021-2022,Serie-A
Francesco Di Tacchio,it ITA,MF,Salernitana,31.0,1990.0,13.9,17,7,5,10,2,9,25,36.0,16,16,8,8,22,39,25,0,Matches,2021-2022,Serie-A
Amadou Diawara,gn GUI,MF,Roma,24.0,1997.0,1.9,7,2,5,2,0,1,3,33.3,2,2,0,2,0,7,1,0,Matches,2021-2022,Serie-A
Brahim Díaz,ma MAR,MF,Milan,21.0,1999.0,20.6,23,17,3,11,9,8,22,36.4,14,11,0,11,8,31,4,0,Matches,2021-2022,Serie-A
Mitchell Dijks,nl NED,"DF,FW",Bologna,28.0,1993.0,7.7,15,6,6,6,3,5,12,41.7,7,11,2,9,3,18,10,1,Matches,2021-2022,Serie-A
Federico Dimarco,it ITA,DF,Inter,23.0,1997.0,15.9,28,15,10,15,3,13,24,54.2,11,6,1,5,19,47,19,0,Matches,2021-2022,Serie-A
Filippo Distefano,it ITA,FW,Fiorentina,17.0,2003.0,0.0,0,0,0,0,0,0,0,,0,0,0,0,0,0,0,0,Matches,2021-2022,Serie-A
Koffi Djidji,ci CIV,DF,Torino,28.0,1992.0,19.3,48,29,21,23,4,14,18,77.8,4,20,9,11,34,82,60,0,Matches,2021-2022,Serie-A
Berat Djimsiti,al ALB,DF,Atalanta,28.0,1993.0,25.1,43,24,21,20,2,29,46,63.0,17,21,11,10,31,74,56,0,Matches,2021-2022,Serie-A
Nicolás Domínguez,ar ARG,MF,Bologna,23.0,1998.0,22.4,76,45,36,32,8,32,76,42.1,44,38,9,29,32,108,34,1,Matches,2021-2022,Serie-A
Bartłomiej Drągowski,pl POL,GK,Fiorentina,23.0,1997.0,6.2,0,0,0,0,0,0,0,,0,0,0,0,1,1,5,2,Matches,2021-2022,Serie-A
Radu Drăgușin,ro ROU,DF,Sampdoria,19.0,2002.0,6.9,4,3,2,2,0,2,6,33.3,4,8,4,4,10,14,33,0,Matches,2021-2022,Serie-A
Radu Drăgușin,ro ROU,DF,Salernitana,19.0,2002.0,5.4,5,4,2,3,0,4,10,40.0,6,7,3,4,13,18,17,0,Matches,2021-2022,Serie-A
Denzel Dumfries,nl NED,DF,Inter,25.0,1996.0,22.5,32,12,9,14,9,16,32,50.0,16,15,6,9,9,41,26,0,Matches,2021-2022,Serie-A
Alfred Duncan,gh GHA,MF,Fiorentina,28.0,1993.0,21.5,34,19,13,16,5,11,32,34.4,21,32,3,29,10,44,7,0,Matches,2021-2022,Serie-A
Paulo Dybala,ar ARG,"FW,MF",Juventus,27.0,1993.0,22.9,30,13,7,14,9,8,35,22.9,27,19,0,19,9,39,4,3,Matches,2021-2022,Serie-A
Edin Džeko,ba BIH,FW,Inter,35.0,1986.0,27.4,14,8,7,4,3,8,25,32.0,17,22,5,17,4,18,35,0,Matches,2021-2022,Serie-A
Tyronne Ebuehi,ng NGA,DF,Venezia,25.0,1995.0,12.6,28,12,16,8,4,10,18,55.6,8,13,3,10,16,44,38,1,Matches,2021-2022,Serie-A
Éderson,br BRA,MF,Salernitana,22.0,1999.0,12.7,29,18,11,14,4,14,26,53.8,12,11,2,9,19,48,8,0,Matches,2021-2022,Serie-A
Albin Ekdal,se SWE,MF,Sampdoria,32.0,1989.0,18.2,43,28,17,21,5,26,56,46.4,30,27,7,20,29,72,25,0,Matches,2021-2022,Serie-A
Caleb Ekuban,gh GHA,"FW,MF",Genoa,27.0,1994.0,19.1,19,12,2,12,5,7,23,30.4,16,19,5,14,9,28,6,0,Matches,2021-2022,Serie-A
Elif Elmas,mk MKD,"FW,MF",Napoli,21.0,1999.0,18.0,25,15,10,10,5,12,28,42.9,16,13,2,11,8,33,17,0,Matches,2021-2022,Serie-A
Martin Erlic,hr CRO,DF,Spezia,23.0,1998.0,28.6,28,16,18,10,0,10,18,55.6,8,54,39,15,28,56,122,1,Matches,2021-2022,Serie-A
Gonzalo Escalante,ar ARG,MF,Lazio,28.0,1993.0,0.1,1,0,1,0,0,1,1,100.0,0,2,1,1,1,2,0,0,Matches,2021-2022,Serie-A
Diego Falcinelli,it ITA,FW,Bologna,30.0,1991.0,0.7,2,2,2,0,0,0,0,,0,0,0,0,1,3,1,0,Matches,2021-2022,Serie-A
Wladimiro Falcone,it ITA,GK,Sampdoria,26.0,1995.0,9.5,0,0,0,0,0,0,0,,0,0,0,0,1,1,5,0,Matches,2021-2022,Serie-A
Paolo Faragò,it ITA,MF,Cagliari,28.0,1993.0,0.2,1,1,1,0,0,0,0,,0,2,0,2,0,1,0,0,Matches,2021-2022,Serie-A
Davide Faraoni,it ITA,DF,Hellas Verona,29.0,1991.0,28.6,62,40,38,21,3,29,62,46.8,33,38,5,33,23,85,62,1,Matches,2021-2022,Serie-A
Mohamed Fares,dz ALG,"DF,FW",Genoa,25.0,1996.0,6.5,4,2,1,3,0,0,4,0.0,4,8,3,5,8,12,11,0,Matches,2021-2022,Serie-A
Diego Farias,br BRA,"MF,FW",Cagliari,31.0,1990.0,0.7,1,1,0,1,0,1,3,33.3,2,0,0,0,0,1,0,0,Matches,2021-2022,Serie-A
Andrea Favilli,it ITA,FW,Genoa,24.0,1997.0,0.4,1,1,0,0,1,0,0,,0,0,0,0,0,1,2,0,Matches,2021-2022,Serie-A
Federico Fazio,ar ARG,DF,Salernitana,34.0,1987.0,15.9,17,11,10,6,1,9,12,75.0,3,21,16,5,27,44,67,1,Matches,2021-2022,Serie-A
Luiz Felipe,it ITA,DF,Lazio,24.0,1997.0,27.7,41,23,21,16,4,20,34,58.8,14,40,33,7,33,74,102,1,Matches,2021-2022,Serie-A
Alex Ferrari,it ITA,DF,Sampdoria,27.0,1994.0,18.3,40,22,28,9,3,19,33,57.6,14,31,22,9,39,79,63,1,Matches,2021-2022,Serie-A
Salvador Ferrer,es ESP,"DF,MF",Spezia,23.0,1998.0,16.6,32,18,15,9,8,12,25,48.0,13,24,12,12,18,50,46,0,Matches,2021-2022,Serie-A
Riccardo Fiamozzi,it ITA,DF,Empoli,28.0,1993.0,6.9,7,5,2,2,3,2,4,50.0,2,6,5,1,7,14,12,0,Matches,2021-2022,Serie-A
Luca Fiordilino,it ITA,MF,Venezia,25.0,1996.0,7.3,21,13,11,6,4,13,27,48.1,14,14,4,10,11,32,12,0,Matches,2021-2022,Serie-A
Vincenzo Fiorillo,it ITA,GK,Salernitana,31.0,1990.0,1.0,0,0,0,0,0,0,0,,0,0,0,0,0,0,1,0,Matches,2021-2022,Serie-A
Alessandro Florenzi,it ITA,"DF,FW",Milan,30.0,1991.0,12.8,28,14,14,7,7,14,32,43.8,18,9,2,7,27,55,10,1,Matches,2021-2022,Serie-A
Fernando Forestieri,it ITA,"FW,MF",Udinese,31.0,1990.0,0.6,0,0,0,0,0,0,1,0.0,1,1,0,1,0,0,1,0,Matches,2021-2022,Serie-A
Francesco Forte,it ITA,FW,Venezia,28.0,1993.0,4.7,3,2,0,2,1,2,5,40.0,3,1,0,1,0,3,2,0,Matches,2021-2022,Serie-A
Gianluca Frabotta,it ITA,"DF,MF",Hellas Verona,22.0,1999.0,0.2,0,0,0,0,0,0,1,0.0,1,1,0,1,1,1,0,0,Matches,2021-2022,Serie-A
Davide Frattesi,it ITA,MF,Sassuolo,21.0,1999.0,31.7,46,16,26,18,2,26,52,50.0,26,44,12,32,29,75,62,1,Matches,2021-2022,Serie-A
Morten Frendrup,dk DEN,"DF,MF",Genoa,20.0,2001.0,7.7,40,24,19,13,8,13,29,44.8,16,19,2,17,17,57,7,1,Matches,2021-2022,Serie-A
Remo Freuler,ch SUI,MF,Atalanta,29.0,1992.0,26.3,69,39,22,33,14,30,70,42.9,40,48,8,40,35,104,26,1,Matches,2021-2022,Serie-A
Matteo Gabbia,it ITA,DF,Milan,21.0,1999.0,6.0,4,3,1,3,0,0,4,0.0,4,2,2,0,8,12,12,0,Matches,2021-2022,Serie-A
Manolo Gabbiadini,it ITA,"FW,MF",Sampdoria,29.0,1991.0,12.7,6,4,3,2,1,1,7,14.3,6,5,2,3,3,9,10,0,Matches,2021-2022,Serie-A
Gianluca Gaetano,it ITA,MF,Napoli,21.0,2000.0,0.2,1,1,1,0,0,1,2,50.0,1,0,0,0,2,3,0,0,Matches,2021-2022,Serie-A
Luca Gagliano,it ITA,"FW,DF",Cagliari,21.0,2000.0,0.1,0,0,0,0,0,0,0,,0,1,0,1,0,0,1,0,Matches,2021-2022,Serie-A
Roberto Gagliardini,it ITA,MF,Inter,27.0,1994.0,7.2,12,6,7,4,1,1,13,7.7,12,14,5,9,9,21,7,0,Matches,2021-2022,Serie-A
Riccardo Gagliolo,se SWE,DF,Salernitana,31.0,1990.0,12.6,23,12,16,4,3,16,27,59.3,11,15,8,7,28,51,52,0,Matches,2021-2022,Serie-A
Nicolas Galazzi,it ITA,MF,Venezia,20.0,2000.0,0.2,2,1,1,0,1,0,1,0.0,1,0,0,0,0,2,0,0,Matches,2021-2022,Serie-A
Pablo Galdames Millán,cl CHI,MF,Genoa,24.0,1996.0,11.4,28,12,6,16,6,12,35,34.3,23,16,2,14,8,36,9,1,Matches,2021-2022,Serie-A
Luca Gemello,it ITA,GK,Torino,21.0,2000.0,1.0,0,0,0,0,0,0,0,,0,0,0,0,0,0,0,0,Matches,2021-2022,Serie-A
Paolo Ghiglione,it ITA,DF,Genoa,24.0,1997.0,6.7,17,12,8,6,3,9,14,64.3,5,11,5,6,10,27,12,1,Matches,2021-2022,Serie-A
Faouzi Ghoulam,dz ALG,DF,Napoli,30.0,1991.0,3.7,3,1,1,2,0,0,3,0.0,3,2,1,1,3,6,10,0,Matches,2021-2022,Serie-A
Sebastian Giovinco,it ITA,MF,Sampdoria,34.0,1987.0,0.4,0,0,0,0,0,0,1,0.0,1,0,0,0,0,0,0,0,Matches,2021-2022,Serie-A
Olivier Giroud,fr FRA,FW,Milan,34.0,1986.0,21.0,15,11,4,6,5,3,17,17.6,14,13,4,9,3,18,19,0,Matches,2021-2022,Serie-A
Diego Godín,uy URU,DF,Cagliari,35.0,1986.0,9.1,18,7,13,3,2,10,15,66.7,5,7,5,2,13,31,46,0,Matches,2021-2022,Serie-A
Edoardo Goldaniga,it ITA,DF,Cagliari,27.0,1993.0,10.4,12,5,7,5,0,4,11,36.4,7,8,5,3,22,34,23,0,Matches,2021-2022,Serie-A
Edoardo Goldaniga,it ITA,"DF,MF",Sassuolo,27.0,1993.0,0.0,0,0,0,0,0,0,0,,0,0,0,0,0,0,0,0,Matches,2021-2022,Serie-A
Cedric Gondo,ci CIV,FW,Salernitana,24.0,1996.0,7.8,5,2,2,2,1,2,5,40.0,3,2,0,2,3,8,2,0,Matches,2021-2022,Serie-A
Nicolás González,ar ARG,FW,Fiorentina,23.0,1998.0,26.2,21,16,6,8,7,9,28,32.1,19,26,2,24,21,42,4,1,Matches,2021-2022,Serie-A
Robin Gosens,de GER,DF,Atalanta,27.0,1994.0,5.1,7,3,3,4,0,4,8,50.0,4,4,0,4,9,16,1,0,Matches,2021-2022,Serie-A
Robin Gosens,de GER,DF,Inter,27.0,1994.0,1.9,3,1,1,2,0,0,0,,0,5,2,3,3,6,3,0,Matches,2021-2022,Serie-A
Alberto Grassi,it ITA,MF,Cagliari,26.0,1995.0,24.2,47,26,13,30,4,16,38,42.1,22,27,9,18,63,110,33,1,Matches,2021-2022,Serie-A
Koray Günter,de GER,DF,Hellas Verona,26.0,1994.0,26.8,32,18,19,11,2,16,32,50.0,16,27,21,6,69,101,110,1,Matches,2021-2022,Serie-A
Albert Guðmundsson,is ISL,"FW,MF",Genoa,24.0,1997.0,6.7,5,3,2,1,2,3,8,37.5,5,2,0,2,5,10,4,0,Matches,2021-2022,Serie-A
Emmanuel Gyasi,gh GHA,"FW,MF",Spezia,27.0,1994.0,33.7,47,30,31,9,7,21,41,51.2,20,22,4,18,16,63,43,1,Matches,2021-2022,Serie-A
Norbert Gyömbér,sk SVK,DF,Salernitana,29.0,1992.0,28.5,53,32,40,11,2,33,50,66.0,17,38,24,14,44,97,126,1,Matches,2021-2022,Serie-A
Nicolas Haas,ch SUI,MF,Empoli,25.0,1996.0,11.1,35,22,15,10,10,17,39,43.6,22,24,4,20,9,44,17,1,Matches,2021-2022,Serie-A
Samir Handanović,si SVN,GK,Inter,37.0,1984.0,37.0,1,0,1,0,0,1,2,50.0,1,1,0,1,0,1,6,3,Matches,2021-2022,Serie-A
Ridgeciano Haps,sr SUR,DF,Venezia,28.0,1993.0,22.8,36,20,26,4,6,11,21,52.4,10,34,12,22,29,65,57,1,Matches,2021-2022,Serie-A
Abdou Harroui,nl NED,MF,Sassuolo,23.0,1998.0,5.0,11,4,4,7,0,8,11,72.7,3,14,0,14,4,15,5,0,Matches,2021-2022,Serie-A
Hans Hateboer,nl NED,"DF,MF",Atalanta,27.0,1994.0,15.4,22,14,10,8,4,11,26,42.3,15,11,1,10,7,29,20,0,Matches,2021-2022,Serie-A
Silvan Hefti,ch SUI,DF,Genoa,23.0,1997.0,14.3,50,30,23,22,5,32,58,55.2,26,20,4,16,20,70,34,1,Matches,2021-2022,Serie-A
Liam Henderson,sct SCO,MF,Empoli,25.0,1996.0,22.4,22,13,7,8,7,9,31,29.0,22,14,4,10,9,31,13,0,Matches,2021-2022,Serie-A
Dalbert Henrique,br BRA,"DF,MF",Cagliari,27.0,1993.0,23.1,43,23,23,16,4,11,35,31.4,24,28,5,23,24,67,34,0,Matches,2021-2022,Serie-A
Matheus Henrique,br BRA,MF,Sassuolo,23.0,1997.0,12.0,10,3,6,3,1,6,24,25.0,18,14,2,12,7,17,12,1,Matches,2021-2022,Serie-A
Thomas Henry,fr FRA,FW,Venezia,26.0,1994.0,23.5,9,4,2,3,4,5,13,38.5,8,11,5,6,2,11,25,0,Matches,2021-2022,Serie-A
Theo Hernández,fr FRA,DF,Milan,23.0,1997.0,30.1,53,35,34,14,5,29,40,72.5,11,16,3,13,23,76,29,3,Matches,2021-2022,Serie-A
Hernani,br BRA,"MF,FW",Genoa,27.0,1994.0,7.6,20,10,8,9,3,13,32,40.6,19,17,4,13,13,33,5,1,Matches,2021-2022,Serie-A
Daan Heymans,be BEL,"MF,FW",Venezia,22.0,1999.0,2.8,3,1,1,2,0,1,5,20.0,4,7,3,4,4,7,3,0,Matches,2021-2022,Serie-A
Aaron Hickey,sct SCO,DF,Bologna,19.0,2002.0,31.3,46,29,24,15,7,20,30,66.7,10,36,13,23,29,75,44,0,Matches,2021-2022,Serie-A
Martin Hongla,cm CMR,MF,Hellas Verona,23.0,1998.0,7.2,14,8,5,6,3,4,8,50.0,4,6,2,4,4,18,16,1,Matches,2021-2022,Serie-A
Sydney van Hooijdonk,nl NED,"FW,MF",Bologna,21.0,2000.0,0.4,0,0,0,0,0,0,1,0.0,1,1,0,1,0,0,0,0,Matches,2021-2022,Serie-A
Petko Hristov,bg BUL,DF,Spezia,22.0,1999.0,13.9,17,10,11,6,0,10,16,62.5,6,29,23,6,19,36,47,0,Matches,2021-2022,Serie-A
Elseid Hysaj,al ALB,DF,Lazio,27.0,1994.0,22.5,46,30,25,17,4,29,45,64.4,16,18,6,12,24,70,34,1,Matches,2021-2022,Serie-A
Roger Ibanez,br BRA,DF,Roma,22.0,1998.0,32.1,54,32,31,19,4,26,43,60.5,17,26,7,19,62,116,104,2,Matches,2021-2022,Serie-A
Zlatan Ibrahimović,se SWE,FW,Milan,39.0,1981.0,11.3,0,0,0,0,0,0,2,0.0,2,2,1,1,3,3,9,0,Matches,2021-2022,Serie-A
Igor,br BRA,DF,Fiorentina,23.0,1998.0,24.9,53,31,34,16,3,30,40,75.0,10,37,19,18,31,84,46,4,Matches,2021-2022,Serie-A
Jonathan Ikone,fr FRA,FW,Fiorentina,23.0,1998.0,7.2,7,3,2,3,2,3,10,30.0,7,10,2,8,1,8,2,0,Matches,2021-2022,Serie-A
Ivan Ilić,rs SRB,MF,Hellas Verona,20.0,2001.0,28.1,39,18,16,19,4,20,54,37.0,34,34,12,22,22,61,55,0,Matches,2021-2022,Serie-A
Josip Iličić,si SVN,"MF,FW",Atalanta,33.0,1988.0,9.3,7,7,3,2,2,4,17,23.5,13,6,1,5,3,10,1,0,Matches,2021-2022,Serie-A
Ciro Immobile,it ITA,FW,Lazio,31.0,1990.0,30.1,10,5,4,4,2,1,15,6.7,14,7,1,6,3,13,16,0,Matches,2021-2022,Serie-A
Lorenzo Insigne,it ITA,FW,Napoli,30.0,1991.0,25.4,23,14,8,12,3,8,44,18.2,36,30,1,29,20,43,3,1,Matches,2021-2022,Serie-A
Ardian Ismajli,al ALB,DF,Empoli,24.0,1996.0,14.1,13,9,8,4,1,5,14,35.7,9,21,11,10,24,37,80,0,Matches,2021-2022,Serie-A
Armando Izzo,it ITA,DF,Torino,29.0,1992.0,5.8,16,9,14,2,0,9,11,81.8,2,5,4,1,17,33,21,0,Matches,2021-2022,Serie-A
Mato Jajalo,ba BIH,MF,Udinese,33.0,1988.0,7.0,24,14,14,7,3,11,23,47.8,12,7,0,7,11,35,5,0,Matches,2021-2022,Serie-A
Paweł Jaroszyński,pl POL,DF,Salernitana,26.0,1994.0,5.7,10,5,7,3,0,5,7,71.4,2,4,0,4,10,20,19,0,Matches,2021-2022,Serie-A
Juan Jesus,br BRA,DF,Napoli,30.0,1991.0,14.2,25,17,14,11,0,12,18,66.7,6,21,16,5,9,34,34,0,Matches,2021-2022,Serie-A
Dennis Johnsen,no NOR,"FW,MF",Venezia,23.0,1998.0,16.1,14,10,8,4,2,6,18,33.3,12,14,1,13,5,19,3,0,Matches,2021-2022,Serie-A
Kaio Jorge,br BRA,"MF,FW",Juventus,19.0,2002.0,1.3,2,1,0,2,0,1,3,33.3,2,1,0,1,0,2,2,0,Matches,2021-2022,Serie-A
Flavio Junior Bianchi,it ITA,"FW,MF",Genoa,21.0,2000.0,3.5,2,2,1,0,1,0,2,0.0,2,0,0,0,0,2,0,0,Matches,2021-2022,Serie-A
Hamed Junior Traorè,ci CIV,"FW,MF",Sassuolo,21.0,2000.0,19.7,32,18,8,14,10,10,46,21.7,36,22,2,20,12,44,6,1,Matches,2021-2022,Serie-A
Nikola Kalinić,hr CRO,FW,Hellas Verona,33.0,1988.0,4.5,2,0,0,1,1,1,2,50.0,1,2,0,2,0,2,2,0,Matches,2021-2022,Serie-A
Yayah Kallon,sl SLE,"FW,MF",Genoa,20.0,2001.0,7.1,15,11,5,6,4,3,11,27.3,8,7,1,6,1,16,5,0,Matches,2021-2022,Serie-A
Pierre Kalulu,fr FRA,DF,Milan,21.0,2000.0,21.6,61,36,36,21,4,17,22,77.3,5,36,15,21,26,87,54,0,Matches,2021-2022,Serie-A
Dimitrije Kamenović,rs SRB,DF,Lazio,21.0,2000.0,0.5,1,1,1,0,0,1,1,100.0,0,0,0,0,2,3,1,0,Matches,2021-2022,Serie-A
Rick Karsdorp,nl NED,"DF,FW",Roma,26.0,1995.0,32.0,53,38,33,13,7,28,50,56.0,22,22,5,17,34,87,26,1,Matches,2021-2022,Serie-A
Denso Kasius,nl NED,"DF,FW",Bologna,18.0,2002.0,2.0,9,7,5,3,1,2,5,40.0,3,4,0,4,3,12,4,0,Matches,2021-2022,Serie-A
Grigoris Kastanos,cy CYP,"MF,FW",Salernitana,23.0,1998.0,15.0,30,19,9,19,2,7,23,30.4,16,21,5,16,22,52,8,0,Matches,2021-2022,Serie-A
Moise Kean,it ITA,FW,Juventus,21.0,2000.0,12.2,9,4,2,5,2,6,16,37.5,10,5,0,5,3,12,8,1,Matches,2021-2022,Serie-A
Wajdi Kechrida,tn TUN,"DF,MF",Salernitana,25.0,1995.0,10.6,9,6,6,3,0,8,13,61.5,5,10,2,8,8,17,15,0,Matches,2021-2022,Serie-A
Dimitrios Keramitsis,gr GRE,MF,Roma,17.0,2004.0,0.0,0,0,0,0,0,0,0,,0,0,0,0,0,0,0,0,Matches,2021-2022,Serie-A
Franck Kessié,ci CIV,MF,Milan,24.0,1996.0,25.6,41,23,12,24,5,17,26,65.4,9,39,10,29,23,64,22,0,Matches,2021-2022,Serie-A
Jakub Kiwior,pl POL,MF,Spezia,21.0,2000.0,21.8,50,27,25,19,6,26,57,45.6,31,38,15,23,40,90,53,0,Matches,2021-2022,Serie-A
Sofian Kiyine,ma MAR,"MF,FW",Venezia,23.0,1997.0,13.8,24,14,9,11,4,12,32,37.5,20,15,1,14,10,34,9,0,Matches,2021-2022,Serie-A
Simon Kjær,dk DEN,DF,Milan,32.0,1989.0,8.9,20,12,9,8,3,6,12,50.0,6,17,13,4,9,29,39,0,Matches,2021-2022,Serie-A
Aleksandr Kokorin,ru RUS,"FW,MF",Fiorentina,30.0,1991.0,0.6,1,1,1,0,0,0,0,,0,1,0,1,0,1,0,0,Matches,2021-2022,Serie-A
Aleksandar Kolarov,rs SRB,DF,Inter,35.0,1985.0,0.5,1,1,1,0,0,1,1,100.0,0,0,0,0,1,2,2,0,Matches,2021-2022,Serie-A
Teun Koopmeiners,nl NED,MF,Atalanta,23.0,1998.0,23.6,40,24,10,19,11,22,54,40.7,32,31,2,29,15,55,19,0,Matches,2021-2022,Serie-A
Kalidou Koulibaly,sn SEN,DF,Napoli,30.0,1991.0,26.7,39,23,31,6,2,25,38,65.8,13,41,25,16,29,68,90,1,Matches,2021-2022,Serie-A
Christos Kourfalidis,gr GRE,"MF,FW",Cagliari,18.0,2002.0,0.2,0,0,0,0,0,0,1,0.0,1,1,0,1,0,0,0,0,Matches,2021-2022,Serie-A
Viktor Kovalenko,ua UKR,MF,Spezia,25.0,1996.0,14.7,16,10,7,8,1,9,21,42.9,12,16,3,13,13,29,8,0,Matches,2021-2022,Serie-A
Julian Kristoffersen,no NOR,FW,Salernitana,24.0,1997.0,0.1,0,0,0,0,0,0,0,,0,0,0,0,0,0,0,0,Matches,2021-2022,Serie-A
Rade Krunić,ba BIH,"MF,FW",Milan,27.0,1993.0,15.7,33,18,16,14,3,15,31,48.4,16,19,2,17,16,49,17,0,Matches,2021-2022,Serie-A
Dejan Kulusevski,se SWE,"FW,MF",Juventus,21.0,2000.0,8.6,15,12,9,6,0,8,21,38.1,13,14,0,14,5,20,5,0,Matches,2021-2022,Serie-A
Marash Kumbulla,al ALB,DF,Roma,21.0,2000.0,11.4,21,13,13,7,1,8,15,53.3,7,17,8,9,16,37,26,0,Matches,2021-2022,Serie-A
Giorgos Kyriakopoulos,gr GRE,"DF,FW",Sassuolo,25.0,1996.0,21.9,30,14,19,7,4,19,38,50.0,19,32,9,23,11,41,52,0,Matches,2021-2022,Serie-A
Andrea La Mantia,it ITA,"FW,MF",Empoli,30.0,1991.0,5.4,2,0,0,0,2,1,2,50.0,1,3,1,2,1,3,6,0,Matches,2021-2022,Serie-A
Sam Lammers,nl NED,"FW,MF",Atalanta,24.0,1997.0,0.4,1,0,0,0,1,0,0,,0,0,0,0,0,1,0,0,Matches,2021-2022,Serie-A
Kevin Lasagna,it ITA,"MF,FW",Hellas Verona,28.0,1992.0,13.2,13,7,4,5,4,4,15,26.7,11,16,0,16,3,16,7,0,Matches,2021-2022,Serie-A
Darko Lazović,rs SRB,DF,Hellas Verona,30.0,1990.0,30.7,36,23,20,8,8,21,39,53.8,18,28,4,24,19,55,49,1,Matches,2021-2022,Serie-A
Manuel Lazzari,it ITA,DF,Lazio,27.0,1993.0,18.5,28,14,13,15,0,16,26,61.5,10,10,2,8,12,40,16,1,Matches,2021-2022,Serie-A
Patrick Leal,us USA,FW,Venezia,18.0,2003.0,0.0,0,0,0,0,0,0,1,0.0,1,0,0,0,0,0,0,0,Matches,2021-2022,Serie-A
Rafael Leão,pt POR,FW,Milan,22.0,1999.0,28.9,17,7,3,9,5,10,20,50.0,10,12,1,11,12,29,8,0,Matches,2021-2022,Serie-A
Lucas Leiva,br BRA,MF,Lazio,34.0,1987.0,18.9,55,30,26,25,4,15,53,28.3,38,27,10,17,28,83,37,0,Matches,2021-2022,Serie-A
Luca Lezzerini,it ITA,GK,Venezia,26.0,1995.0,5.5,0,0,0,0,0,0,0,,0,1,0,1,0,0,0,0,Matches,2021-2022,Serie-A
Ben Lhassine Kone,ci CIV,MF,Torino,21.0,2000.0,0.9,3,3,1,2,0,1,2,50.0,1,0,0,0,1,4,1,0,Matches,2021-2022,Serie-A
Matthijs de Ligt,nl NED,DF,Juventus,21.0,1999.0,29.7,34,19,21,13,0,15,18,83.3,3,31,21,10,26,60,103,0,Matches,2021-2022,Serie-A
Anderson Lima,br BRA,MF,Lazio,21.0,1999.0,0.7,2,0,1,1,0,0,2,0.0,2,1,0,1,2,4,1,0,Matches,2021-2022,Serie-A
Karol Linetty,pl POL,"MF,FW",Torino,26.0,1995.0,10.0,14,8,3,4,7,6,18,33.3,12,8,0,8,3,17,2,0,Matches,2021-2022,Serie-A
Stanislav Lobotka,sk SVK,MF,Napoli,26.0,1994.0,18.7,39,24,16,20,3,14,36,38.9,22,9,1,8,12,51,13,1,Matches,2021-2022,Serie-A
Manuel Locatelli,it ITA,MF,Juventus,23.0,1998.0,24.0,44,25,21,16,7,21,47,44.7,26,43,21,22,22,66,33,0,Matches,2021-2022,Serie-A
Maxime Lopez,fr FRA,MF,Sassuolo,23.0,1997.0,32.6,69,36,40,27,2,35,87,40.2,52,33,7,26,42,111,38,1,Matches,2021-2022,Serie-A
Matteo Lovato,it ITA,DF,Atalanta,21.0,2000.0,3.4,5,4,4,1,0,0,1,0.0,1,4,2,2,7,12,8,0,Matches,2021-2022,Serie-A
Matteo Lovato,it ITA,DF,Cagliari,21.0,2000.0,13.8,23,15,13,10,0,8,20,40.0,12,21,10,11,28,51,43,0,Matches,2021-2022,Serie-A
Hirving Lozano,mx MEX,FW,Napoli,26.0,1995.0,17.9,28,20,12,11,5,8,30,26.7,22,24,0,24,9,37,9,0,Matches,2021-2022,Serie-A
José Luis Palomino,ar ARG,DF,Atalanta,31.0,1990.0,29.7,78,40,42,33,3,32,50,64.0,18,43,21,22,100,178,80,2,Matches,2021-2022,Serie-A
Saša Lukić,rs SRB,MF,Torino,24.0,1996.0,33.1,51,34,17,27,7,19,43,44.2,24,34,6,28,24,75,41,0,Matches,2021-2022,Serie-A
Sebastiano Luperto,it ITA,DF,Empoli,24.0,1996.0,21.8,29,17,17,10,2,10,20,50.0,10,32,26,6,45,74,132,0,Matches,2021-2022,Serie-A
Charalambos Lykogiannis,gr GRE,"DF,FW",Cagliari,27.0,1993.0,20.2,19,12,16,1,2,11,20,55.0,9,18,8,10,31,50,73,0,Matches,2021-2022,Serie-A
Niki Mäenpää,fi FIN,GK,Venezia,36.0,1985.0,16.5,0,0,0,0,0,0,0,,0,0,0,0,0,0,8,2,Matches,2021-2022,Serie-A
Giulio Maggiore,it ITA,MF,Spezia,23.0,1998.0,31.3,58,32,20,32,6,31,77,40.3,46,30,5,25,29,87,33,0,Matches,2021-2022,Serie-A
Francesco Magnanelli,it ITA,MF,Sassuolo,36.0,1984.0,3.0,5,4,4,1,0,1,9,11.1,8,3,1,2,1,6,3,0,Matches,2021-2022,Serie-A
Giangiacomo Magnani,it ITA,DF,Hellas Verona,25.0,1995.0,5.9,10,7,5,5,0,8,16,50.0,8,5,3,2,10,20,46,0,Matches,2021-2022,Serie-A
Giangiacomo Magnani,it ITA,DF,Sampdoria,25.0,1995.0,2.7,4,2,4,0,0,1,1,100.0,0,2,2,0,7,11,12,0,Matches,2021-2022,Serie-A
Mike Maignan,fr FRA,GK,Milan,26.0,1995.0,32.0,2,1,2,0,0,2,2,100.0,0,0,0,0,1,3,4,2,Matches,2021-2022,Serie-A
Ainsley Maitland-Niles,eng ENG,DF,Roma,23.0,1997.0,5.4,8,6,5,0,3,5,14,35.7,9,7,0,7,6,14,7,0,Matches,2021-2022,Serie-A
Jean-Victor Makengo,fr FRA,MF,Udinese,23.0,1998.0,26.1,30,21,7,17,6,15,29,51.7,14,26,6,20,19,49,17,0,Matches,2021-2022,Serie-A
Nikola Maksimović,rs SRB,DF,Genoa,29.0,1991.0,12.4,14,6,10,4,0,7,9,77.8,2,17,11,6,12,26,61,1,Matches,2021-2022,Serie-A
Kévin Malcuit,ma MAR,"DF,MF",Napoli,30.0,1991.0,3.2,4,2,4,0,0,2,2,100.0,0,3,0,3,8,12,6,0,Matches,2021-2022,Serie-A
Daniel Maldini,it ITA,MF,Milan,19.0,2001.0,1.6,8,3,4,3,1,2,6,33.3,4,4,0,4,1,9,0,0,Matches,2021-2022,Serie-A
Youssef Maleh,ma MAR,MF,Fiorentina,22.0,1998.0,11.3,27,16,8,13,6,12,25,48.0,13,14,1,13,6,33,2,0,Matches,2021-2022,Serie-A
Ruslan Malinovskyi,ua UKR,"MF,FW",Atalanta,28.0,1993.0,17.7,18,10,3,10,5,5,19,26.3,14,27,3,24,5,23,1,0,Matches,2021-2022,Serie-A
Rey Manaj,al ALB,FW,Spezia,24.0,1997.0,19.6,19,12,3,11,5,6,26,23.1,20,16,0,16,4,23,13,0,Matches,2021-2022,Serie-A
Gianluca Mancini,it ITA,DF,Roma,25.0,1996.0,32.0,41,25,22,18,1,18,33,54.5,15,38,19,19,39,80,69,0,Matches,2021-2022,Serie-A
Leonardo Mancuso,it ITA,FW,Empoli,29.0,1992.0,4.7,1,1,0,1,0,0,6,0.0,6,2,0,2,1,2,2,0,Matches,2021-2022,Serie-A
Rolando Mandragora,it ITA,MF,Torino,24.0,1997.0,14.7,21,10,3,16,2,12,21,57.1,9,18,4,14,10,31,13,0,Matches,2021-2022,Serie-A
Kostas Manolas,gr GRE,DF,Napoli,30.0,1991.0,3.5,2,2,1,1,0,2,3,66.7,1,2,1,1,4,6,10,1,Matches,2021-2022,Serie-A
Riccardo Marchizza,it ITA,DF,Empoli,23.0,1998.0,15.0,21,15,11,8,2,11,16,68.8,5,15,6,9,10,31,24,0,Matches,2021-2022,Serie-A
Gian Marco Ferrari,it ITA,DF,Sassuolo,29.0,1992.0,34.7,16,11,10,6,0,10,23,43.5,13,37,27,10,43,59,114,2,Matches,2021-2022,Serie-A
Davide Marfella,it ITA,GK,Napoli,21.0,1999.0,0.1,0,0,0,0,0,0,0,,0,0,0,0,0,0,0,0,Matches,2021-2022,Serie-A
Pablo Marí,es ESP,DF,Udinese,27.0,1993.0,14.9,16,8,8,6,2,8,16,50.0,8,18,12,6,21,37,72,0,Matches,2021-2022,Serie-A
Răzvan Marin,ro ROU,MF,Cagliari,25.0,1996.0,31.3,42,21,16,22,4,24,54,44.4,30,23,5,18,10,52,17,1,Matches,2021-2022,Serie-A
Lautaro Martínez,ar ARG,FW,Inter,23.0,1997.0,25.4,20,10,3,10,7,6,11,54.5,5,21,1,20,18,38,6,0,Matches,2021-2022,Serie-A
Lucas Martínez Quarta,ar ARG,DF,Fiorentina,25.0,1996.0,15.9,36,25,23,11,2,21,34,61.8,13,22,9,13,19,55,46,0,Matches,2021-2022,Serie-A
Adam Marušić,me MNE,DF,Lazio,28.0,1992.0,30.2,30,18,16,12,2,13,32,40.6,19,19,8,11,41,71,71,0,Matches,2021-2022,Serie-A
Andrea Masiello,it ITA,DF,Genoa,35.0,1986.0,5.7,5,3,4,1,0,4,7,57.1,3,8,4,4,11,16,20,1,Matches,2021-2022,Serie-A
Aleš Matějů,cz CZE,DF,Venezia,25.0,1996.0,8.1,16,12,10,5,1,13,29,44.8,16,10,6,4,9,25,15,0,Matches,2021-2022,Serie-A
Borja Mayoral,es ESP,"FW,DF",Roma,24.0,1997.0,1.1,0,0,0,0,0,0,0,,0,0,0,0,0,0,0,0,Matches,2021-2022,Serie-A
Pasquale Mazzocchi,it ITA,DF,Venezia,26.0,1995.0,13.8,18,8,11,4,3,10,26,38.5,16,11,8,3,21,39,31,1,Matches,2021-2022,Serie-A
Pasquale Mazzocchi,it ITA,DF,Salernitana,26.0,1995.0,14.1,28,19,15,11,2,14,34,41.2,20,5,0,5,11,39,31,0,Matches,2021-2022,Serie-A
Ibrahima Mbaye,sn SEN,DF,Bologna,26.0,1994.0,1.2,1,1,1,0,0,1,2,50.0,1,1,1,0,1,2,6,0,Matches,2021-2022,Serie-A
Weston McKennie,us USA,MF,Juventus,22.0,1998.0,15.2,20,11,11,7,2,8,26,30.8,18,17,8,9,23,43,20,0,Matches,2021-2022,Serie-A
Gary Medel,cl CHI,DF,Bologna,33.0,1987.0,31.4,39,23,27,11,1,16,36,44.4,20,30,21,9,44,83,112,0,Matches,2021-2022,Serie-A
Filippo Melegoni,it ITA,"MF,FW",Genoa,22.0,1999.0,10.9,20,12,5,8,7,8,16,50.0,8,10,1,9,11,31,8,1,Matches,2021-2022,Serie-A
Arthur Melo,br BRA,MF,Juventus,24.0,1996.0,10.7,25,12,10,14,1,13,24,54.2,11,11,2,9,7,32,8,1,Matches,2021-2022,Serie-A
Alex Meret,it ITA,GK,Napoli,24.0,1997.0,6.9,0,0,0,0,0,0,0,,0,0,0,0,0,0,3,1,Matches,2021-2022,Serie-A
Yıldırım Mert Çetin,tr TUR,MF,Hellas Verona,24.0,1997.0,0.5,1,0,1,0,0,1,1,100.0,0,0,0,0,0,1,2,0,Matches,2021-2022,Serie-A
Dries Mertens,be BEL,"FW,MF",Napoli,34.0,1987.0,15.4,16,7,1,11,4,3,16,18.8,13,8,2,6,9,25,2,0,Matches,2021-2022,Serie-A
Junior Messias,br BRA,"FW,MF",Milan,30.0,1991.0,15.9,34,18,11,14,9,15,34,44.1,19,11,1,10,17,51,17,0,Matches,2021-2022,Serie-A
Kingsley Michael,ng NGA,MF,Bologna,21.0,1999.0,0.8,4,1,2,2,0,1,2,50.0,1,2,1,1,1,5,1,1,Matches,2021-2022,Serie-A
Valentin Mihaila,ro ROU,"MF,FW",Atalanta,21.0,2000.0,0.8,1,1,0,1,0,0,1,0.0,1,2,0,2,0,1,0,0,Matches,2021-2022,Serie-A
Mikael,br BRA,"FW,MF",Salernitana,22.0,1999.0,1.0,1,1,0,1,0,0,0,,0,0,0,0,0,1,1,0,Matches,2021-2022,Serie-A
Hilmir Mikaelsson,is ISL,FW,Venezia,17.0,2004.0,0.2,2,0,0,1,1,0,0,,0,0,0,0,0,2,0,0,Matches,2021-2022,Serie-A
Nikola Milenković,rs SRB,DF,Fiorentina,23.0,1997.0,32.5,54,32,31,20,3,29,34,85.3,5,30,15,15,39,93,94,0,Matches,2021-2022,Serie-A
Sergej Milinković-Savić,rs SRB,MF,Lazio,26.0,1995.0,34.4,67,44,20,32,15,29,67,43.3,38,50,9,41,34,101,43,1,Matches,2021-2022,Serie-A
Vanja Milinković-Savić,rs SRB,GK,Torino,24.0,1997.0,27.0,0,0,0,0,0,0,1,0.0,1,0,0,0,0,0,7,2,Matches,2021-2022,Serie-A
Aleksei Miranchuk,ru RUS,"MF,FW",Atalanta,25.0,1995.0,8.6,11,7,3,7,1,4,12,33.3,8,3,0,3,1,12,7,0,Matches,2021-2022,Serie-A
Fabio Miretti,it ITA,MF,Juventus,17.0,2003.0,3.6,4,2,2,2,0,2,9,22.2,7,3,1,2,2,6,3,0,Matches,2021-2022,Serie-A
Henrikh Mkhitaryan,am ARM,"MF,FW",Roma,32.0,1989.0,27.7,45,29,11,27,7,17,52,32.7,35,33,2,31,22,67,33,0,Matches,2021-2022,Serie-A
Marco Modolo,it ITA,DF,Venezia,32.0,1989.0,4.4,6,3,4,2,0,2,5,40.0,3,6,6,0,4,10,26,0,Matches,2021-2022,Serie-A
Nahuel Molina,ar ARG,DF,Udinese,23.0,1998.0,29.3,41,24,17,21,3,16,48,33.3,32,24,3,21,22,63,44,2,Matches,2021-2022,Serie-A
Cristian Molinaro,it ITA,DF,Venezia,38.0,1983.0,6.1,12,9,10,2,0,5,7,71.4,2,7,2,5,6,18,20,0,Matches,2021-2022,Serie-A
Lorenzo Montipò,it ITA,GK,Hellas Verona,25.0,1996.0,34.0,0,0,0,0,0,0,0,,0,0,0,0,1,1,16,3,Matches,2021-2022,Serie-A
Álvaro Morata,es ESP,FW,Juventus,28.0,1992.0,25.6,18,9,4,9,5,8,31,25.8,23,26,1,25,5,23,24,0,Matches,2021-2022,Serie-A
Raúl Moro,es ESP,FW,Lazio,18.0,2002.0,2.2,3,3,0,2,1,1,5,20.0,4,2,0,2,0,3,0,0,Matches,2021-2022,Serie-A
Andrei Motoc,md MDA,DF,Salernitana,19.0,2002.0,1.0,1,1,0,1,0,0,0,,0,2,2,0,2,3,1,0,Matches,2021-2022,Serie-A
Lys Mousset,fr FRA,"MF,FW",Salernitana,25.0,1996.0,1.8,1,0,0,1,0,0,0,,0,2,0,2,0,1,0,0,Matches,2021-2022,Serie-A
Samuel Mráz,sk SVK,FW,Spezia,24.0,1997.0,0.6,0,0,0,0,0,0,0,,0,1,0,1,0,0,0,0,Matches,2021-2022,Serie-A
Mert Müldür,tr TUR,DF,Sassuolo,22.0,1999.0,22.7,52,35,43,7,2,27,49,55.1,22,25,6,19,24,76,44,1,Matches,2021-2022,Serie-A
Luis Muriel,co COL,"FW,MF",Atalanta,30.0,1991.0,17.1,15,4,2,7,6,3,19,15.8,16,12,0,12,4,19,5,0,Matches,2021-2022,Serie-A
Vedat Muriqi,xk KVX,FW,Lazio,27.0,1994.0,2.4,1,0,1,0,0,0,5,0.0,5,0,0,0,0,1,2,0,Matches,2021-2022,Serie-A
Nicola Murru,it ITA,DF,Sampdoria,26.0,1994.0,10.9,22,17,10,11,1,8,13,61.5,5,17,3,14,7,29,20,1,Matches,2021-2022,Serie-A
Juan Musso,ar ARG,GK,Atalanta,27.0,1994.0,32.6,1,1,1,0,0,0,0,,0,0,0,0,0,1,17,1,Matches,2021-2022,Serie-A
Joakim Mæhle,dk DEN,"DF,MF",Atalanta,24.0,1997.0,16.3,21,11,6,9,6,12,27,44.4,15,18,2,16,14,35,13,0,Matches,2021-2022,Serie-A
Nahitan Nández,uy URU,"MF,DF",Cagliari,25.0,1995.0,16.9,39,21,16,15,8,18,33,54.5,15,16,1,15,9,48,15,1,Matches,2021-2022,Serie-A
Nani,pt POR,"MF,FW",Venezia,34.0,1986.0,3.2,2,1,1,1,0,0,1,0.0,1,1,0,1,2,4,0,1,Matches,2021-2022,Serie-A
Matija Nastasić,rs SRB,DF,Fiorentina,28.0,1993.0,2.4,1,1,1,0,0,1,1,100.0,0,1,1,0,5,6,11,0,Matches,2021-2022,Serie-A
Ilija Nestorovski,mk MKD,FW,Udinese,31.0,1990.0,2.1,0,0,0,0,0,0,3,0.0,3,0,0,0,0,0,4,0,Matches,2021-2022,Serie-A
Aurélien Nguiamba,fr FRA,MF,Spezia,22.0,1999.0,0.6,3,2,1,2,0,2,3,66.7,1,2,1,1,0,3,1,0,Matches,2021-2022,Serie-A
Dimitris Nikolaou,gr GRE,DF,Spezia,22.0,1998.0,36.0,39,26,29,7,3,22,34,64.7,12,48,24,24,49,88,132,1,Matches,2021-2022,Serie-A
Jean-Pierre Nsame,cm CMR,FW,Venezia,28.0,1993.0,2.7,1,1,0,0,1,0,0,,0,0,0,0,0,1,1,0,Matches,2021-2022,Serie-A
Bram Nuytinck,nl NED,DF,Udinese,31.0,1990.0,22.6,38,24,24,13,1,15,34,44.1,19,42,31,11,22,60,101,0,Matches,2021-2022,Serie-A
Simeon Nwankwo,ng NGA,FW,Salernitana,29.0,1992.0,9.4,5,5,0,4,1,4,10,40.0,6,8,3,5,3,8,10,0,Matches,2021-2022,Serie-A
M'Bala Nzola,ao ANG,FW,Spezia,24.0,1996.0,11.9,2,2,0,0,2,1,6,16.7,5,8,0,8,0,2,13,0,Matches,2021-2022,Serie-A
Adam Obert,sk SVK,"DF,MF",Cagliari,18.0,2002.0,3.0,8,5,6,2,0,5,6,83.3,1,6,4,2,4,12,11,0,Matches,2021-2022,Serie-A
Joel Obi,ng NGA,"MF,DF",Salernitana,30.0,1991.0,12.7,23,14,5,14,4,5,12,41.7,7,17,6,11,10,33,7,0,Matches,2021-2022,Serie-A
Brian Oddei,it ITA,FW,Sassuolo,18.0,2002.0,0.1,0,0,0,0,0,0,0,,0,0,0,0,0,0,0,0,Matches,2021-2022,Serie-A
Álvaro Odriozola,es ESP,DF,Fiorentina,25.0,1995.0,19.3,25,15,12,6,7,15,32,46.9,17,17,6,11,8,33,25,2,Matches,2021-2022,Serie-A
Stefano Okaka,it ITA,FW,Udinese,31.0,1989.0,0.2,0,0,0,0,0,0,0,,0,2,0,2,0,0,1,0,Matches,2021-2022,Serie-A
David Okereke,ng NGA,"FW,MF",Venezia,23.0,1997.0,22.8,16,10,4,9,3,3,20,15.0,17,19,3,16,10,26,20,0,Matches,2021-2022,Serie-A
Christian Oliva,uy URU,MF,Cagliari,25.0,1996.0,0.5,2,2,2,0,0,1,4,25.0,3,0,0,0,0,2,0,0,Matches,2021-2022,Serie-A
Sérgio Oliveira,pt POR,MF,Roma,29.0,1992.0,9.9,27,14,11,14,2,15,30,50.0,15,13,0,13,10,37,7,0,Matches,2021-2022,Serie-A
Riccardo Orsolini,it ITA,"FW,MF",Bologna,24.0,1997.0,19.8,21,13,9,11,1,13,29,44.8,16,9,4,5,5,26,14,0,Matches,2021-2022,Serie-A
Victor Osimhen,ng NGA,FW,Napoli,22.0,1998.0,22.0,10,5,1,2,7,2,6,33.3,4,16,3,13,3,13,17,0,Matches,2021-2022,Serie-A
David Ospina,co COL,GK,Napoli,32.0,1988.0,31.0,0,0,0,0,0,0,0,,0,0,0,0,1,1,11,1,Matches,2021-2022,Serie-A
Adam Ounas,dz ALG,"MF,FW",Napoli,24.0,1996.0,3.6,6,1,0,3,3,3,7,42.9,4,3,0,3,2,8,3,0,Matches,2021-2022,Serie-A
Daniele Padelli,it ITA,GK,Udinese,35.0,1985.0,3.0,0,0,0,0,0,0,0,,0,0,0,0,0,0,2,1,Matches,2021-2022,Serie-A
Simone Pafundi,it ITA,FW,Udinese,15.0,2006.0,0.3,0,0,0,0,0,0,1,0.0,1,0,0,0,0,0,0,0,Matches,2021-2022,Serie-A
Martin Palumbo,no NOR,FW,Juventus,19.0,2002.0,0.1,0,0,0,0,0,0,1,0.0,1,0,0,0,0,0,0,0,Matches,2021-2022,Serie-A
Goran Pandev,mk MKD,"FW,MF",Genoa,38.0,1983.0,9.4,2,0,1,0,1,0,9,0.0,9,3,1,2,2,4,0,0,Matches,2021-2022,Serie-A
Ivor Pandur,hr CRO,GK,Hellas Verona,21.0,2000.0,3.0,0,0,0,0,0,0,0,,0,0,0,0,0,0,2,0,Matches,2021-2022,Serie-A
Fabiano Parisi,it ITA,DF,Empoli,20.0,2000.0,16.4,35,19,25,5,5,13,31,41.9,18,30,10,20,22,57,42,0,Matches,2021-2022,Serie-A
Mario Pašalić,hr CRO,"MF,FW",Atalanta,26.0,1995.0,22.2,27,12,8,13,6,12,30,40.0,18,27,6,21,20,47,14,0,Matches,2021-2022,Serie-A
Patric,es ESP,DF,Lazio,28.0,1993.0,18.3,21,15,17,4,0,9,20,45.0,11,22,11,11,12,33,44,2,Matches,2021-2022,Serie-A
Rui Patrício,pt POR,GK,Roma,33.0,1988.0,38.0,0,0,0,0,0,0,0,,0,1,0,1,0,0,10,3,Matches,2021-2022,Serie-A
Leonardo Pavoletti,it ITA,FW,Cagliari,32.0,1988.0,16.9,10,6,2,5,3,3,9,33.3,6,9,5,4,2,12,12,0,Matches,2021-2022,Serie-A
Pedro,es ESP,FW,Lazio,34.0,1987.0,22.6,36,23,8,19,9,16,47,34.0,31,18,2,16,6,42,8,0,Matches,2021-2022,Serie-A
João Pedro,it ITA,FW,Cagliari,29.0,1992.0,36.9,15,12,2,8,5,4,18,22.2,14,23,5,18,8,23,18,1,Matches,2021-2022,Serie-A
Gianluca Pegolo,it ITA,GK,Sassuolo,40.0,1981.0,1.0,0,0,0,0,0,0,0,,0,0,0,0,0,0,0,1,Matches,2021-2022,Serie-A
Pietro Pellegri,it ITA,FW,Torino,20.0,2001.0,2.4,1,1,0,1,0,0,4,0.0,4,0,0,0,0,1,5,0,Matches,2021-2022,Serie-A
Pietro Pellegri,it ITA,FW,Milan,20.0,2001.0,1.5,2,2,0,1,1,0,1,0.0,1,0,0,0,0,2,1,0,Matches,2021-2022,Serie-A
Lorenzo Pellegrini,it ITA,MF,Roma,25.0,1996.0,25.4,35,14,10,17,8,16,60,26.7,44,29,1,28,27,62,20,0,Matches,2021-2022,Serie-A
Luca Pellegrini,it ITA,DF,Juventus,22.0,1999.0,12.3,23,10,13,5,5,12,19,63.2,7,9,1,8,5,28,23,0,Matches,2021-2022,Serie-A
Federico Peluso,it ITA,DF,Sassuolo,37.0,1984.0,0.1,1,1,0,1,0,1,1,100.0,0,0,0,0,0,1,0,0,Matches,2021-2022,Serie-A
Gastón Pereiro,uy URU,"FW,MF",Cagliari,26.0,1995.0,10.8,13,5,7,4,2,5,18,27.8,13,12,1,11,1,14,8,0,Matches,2021-2022,Serie-A
Dor Peretz,il ISR,MF,Venezia,26.0,1995.0,6.5,27,18,8,16,3,13,25,52.0,12,8,4,4,8,35,11,0,Matches,2021-2022,Serie-A
Roberto Pereyra,ar ARG,"MF,FW",Udinese,30.0,1991.0,19.9,18,12,7,6,5,7,23,30.4,16,26,5,21,12,30,11,0,Matches,2021-2022,Serie-A
Carles Pérez,es ESP,"MF,FW",Roma,23.0,1998.0,6.2,8,3,3,1,4,3,12,25.0,9,10,0,10,2,10,2,0,Matches,2021-2022,Serie-A
Nehuén Pérez,ar ARG,DF,Udinese,21.0,2000.0,18.8,44,21,21,21,2,16,25,64.0,9,27,9,18,21,65,47,0,Matches,2021-2022,Serie-A
Mattia Perin,it ITA,GK,Juventus,28.0,1992.0,4.5,0,0,0,0,0,0,0,,0,0,0,0,0,0,3,0,Matches,2021-2022,Serie-A
Ivan Perišić,hr CRO,DF,Inter,32.0,1989.0,31.3,38,22,18,11,9,28,50,56.0,22,39,7,32,47,85,42,0,Matches,2021-2022,Serie-A
Diego Perotti,ar ARG,"MF,FW",Salernitana,33.0,1988.0,3.2,11,5,7,1,3,4,13,30.8,9,1,0,1,2,13,6,0,Matches,2021-2022,Serie-A
Mario Perrone,it ITA,DF,Salernitana,18.0,2003.0,0.2,0,0,0,0,0,0,0,,0,0,0,0,0,0,0,0,Matches,2021-2022,Serie-A
Matteo Pessina,it ITA,"MF,FW",Atalanta,24.0,1997.0,16.0,27,14,10,11,6,14,33,42.4,19,22,3,19,13,40,7,0,Matches,2021-2022,Serie-A
Andrea Petagna,it ITA,FW,Napoli,26.0,1995.0,6.5,3,3,0,3,0,1,4,25.0,3,1,0,1,0,3,5,0,Matches,2021-2022,Serie-A
Giuseppe Pezzella,it ITA,"DF,MF",Atalanta,23.0,1997.0,11.9,28,13,15,7,6,8,18,44.4,10,13,5,8,9,37,16,0,Matches,2021-2022,Serie-A
Krzysztof Piątek,pl POL,FW,Fiorentina,26.0,1995.0,8.1,5,4,1,1,3,2,3,66.7,1,6,0,6,2,7,8,0,Matches,2021-2022,Serie-A
Roberto Piccoli,it ITA,FW,Genoa,20.0,2001.0,2.4,1,1,0,1,0,0,0,,0,0,0,0,1,2,1,1,Matches,2021-2022,Serie-A
Roberto Piccoli,it ITA,FW,Atalanta,20.0,2001.0,2.2,2,0,0,0,2,0,2,0.0,2,1,0,1,0,2,0,0,Matches,2021-2022,Serie-A
Andrea Pinamonti,it ITA,FW,Empoli,22.0,1999.0,31.9,11,6,0,7,4,2,18,11.1,16,24,3,21,7,18,23,0,Matches,2021-2022,Serie-A
Carlo Pinsoglio,it ITA,GK,Juventus,31.0,1990.0,0.5,0,0,0,0,0,0,0,,0,0,0,0,0,0,0,0,Matches,2021-2022,Serie-A
Riccardo Pinzi,it ITA,FW,Udinese,17.0,2003.0,0.0,0,0,0,0,0,0,0,,0,0,0,0,0,0,0,0,Matches,2021-2022,Serie-A
Marko Pjaca,hr CRO,MF,Torino,26.0,1995.0,12.8,7,4,1,4,2,3,8,37.5,5,10,2,8,4,11,2,0,Matches,2021-2022,Serie-A
Tommaso Pobega,it ITA,MF,Torino,22.0,1999.0,24.9,48,30,17,20,11,21,40,52.5,19,32,3,29,25,73,38,0,Matches,2021-2022,Serie-A
Suf Podgoreanu,il ISR,FW,Spezia,19.0,2002.0,1.3,2,0,1,1,0,1,4,25.0,3,2,0,2,1,3,3,0,Matches,2021-2022,Serie-A
Matteo Politano,it ITA,FW,Napoli,27.0,1993.0,18.3,24,12,8,11,5,15,54,27.8,39,11,2,9,13,37,5,0,Matches,2021-2022,Serie-A
Manolo Portanova,it ITA,"FW,MF",Genoa,21.0,2000.0,14.7,46,28,9,26,11,14,34,41.2,20,26,2,24,17,63,22,0,Matches,2021-2022,Serie-A
Dennis Praet,be BEL,MF,Torino,27.0,1994.0,17.1,19,10,6,8,5,8,22,36.4,14,12,1,11,3,22,4,0,Matches,2021-2022,Serie-A
Mateusz Praszelik,pl POL,MF,Hellas Verona,20.0,2000.0,0.3,0,0,0,0,0,0,0,,0,0,0,0,0,0,0,0,Matches,2021-2022,Serie-A
Ivan Provedel,it ITA,GK,Spezia,27.0,1994.0,30.7,0,0,0,0,0,0,1,0.0,1,0,0,0,2,2,10,2,Matches,2021-2022,Serie-A
Erick Pulgar,cl CHI,MF,Fiorentina,27.0,1994.0,3.8,6,6,4,2,0,4,9,44.4,5,5,1,4,5,11,2,1,Matches,2021-2022,Serie-A
Ignacio Pussetto,ar ARG,"FW,MF",Udinese,25.0,1995.0,13.4,17,9,2,9,6,2,10,20.0,8,18,2,16,4,21,13,0,Matches,2021-2022,Serie-A
Niklas Pyyhtiä,fi FIN,MF,Bologna,17.0,2003.0,0.2,0,0,0,0,0,0,1,0.0,1,0,0,0,0,0,0,0,Matches,2021-2022,Serie-A
Fabio Quagliarella,it ITA,FW,Sampdoria,38.0,1983.0,18.5,6,2,2,2,2,2,15,13.3,13,14,1,13,3,9,12,0,Matches,2021-2022,Serie-A
Adrien Rabiot,fr FRA,MF,Juventus,26.0,1995.0,25.4,64,43,32,24,8,15,34,44.1,19,34,8,26,20,84,41,1,Matches,2021-2022,Serie-A
Ivan Radovanović,rs SRB,"DF,MF",Salernitana,32.0,1988.0,11.7,11,7,8,3,0,7,19,36.8,12,14,7,7,7,18,29,0,Matches,2021-2022,Serie-A
Ionuț Radu,ro ROU,GK,Inter,24.0,1997.0,1.0,0,0,0,0,0,0,0,,0,0,0,0,0,0,0,1,Matches,2021-2022,Serie-A
Ștefan Radu,ro ROU,DF,Lazio,34.0,1986.0,6.2,9,6,3,6,0,5,9,55.6,4,7,2,5,5,14,15,0,Matches,2021-2022,Serie-A
Boris Radunović,rs SRB,GK,Cagliari,25.0,1996.0,3.0,0,0,0,0,0,0,0,,0,0,0,0,0,0,0,0,Matches,2021-2022,Serie-A
Antonio Raimondo,it ITA,FW,Bologna,17.0,2004.0,0.8,0,0,0,0,0,0,1,0.0,1,1,0,1,0,0,1,0,Matches,2021-2022,Serie-A
Aaron Ramsey,wls WAL,MF,Juventus,30.0,1990.0,1.1,0,0,0,0,0,0,0,,0,0,0,0,1,1,0,0,Matches,2021-2022,Serie-A
Luca Ranieri,it ITA,DF,Salernitana,22.0,1999.0,23.4,38,21,23,11,4,19,33,57.6,14,18,8,10,22,60,67,0,Matches,2021-2022,Serie-A
Andrea Ranocchia,it ITA,DF,Inter,33.0,1988.0,3.8,8,4,5,1,2,1,3,33.3,2,4,3,1,4,12,16,0,Matches,2021-2022,Serie-A
Giacomo Raspadori,it ITA,"MF,FW",Sassuolo,21.0,2000.0,30.4,29,18,5,15,9,11,38,28.9,27,29,3,26,9,38,11,0,Matches,2021-2022,Serie-A
Nicola Ravaglia,it ITA,GK,Sampdoria,32.0,1988.0,0.1,0,0,0,0,0,0,0,,0,0,0,0,0,0,0,0,Matches,2021-2022,Serie-A
Ante Rebić,hr CRO,FW,Milan,27.0,1993.0,9.9,14,8,3,6,5,7,20,35.0,13,14,0,14,3,17,3,1,Matches,2021-2022,Serie-A
Arkadiusz Reca,pl POL,DF,Spezia,26.0,1995.0,19.7,31,19,21,3,7,20,30,66.7,10,20,7,13,32,63,47,2,Matches,2021-2022,Serie-A
Pepe Reina,es ESP,GK,Lazio,38.0,1982.0,15.0,0,0,0,0,0,0,1,0.0,1,0,0,0,0,0,1,1,Matches,2021-2022,Serie-A
Panagiotis Retsos,gr GRE,DF,Hellas Verona,22.0,1998.0,0.6,0,0,0,0,0,0,2,0.0,2,0,0,0,2,2,3,0,Matches,2021-2022,Serie-A
Bryan Reynolds,us USA,DF,Roma,20.0,2001.0,0.0,0,0,0,0,0,0,1,0.0,1,0,0,0,0,0,1,0,Matches,2021-2022,Serie-A
Franck Ribéry,fr FRA,"MF,FW",Salernitana,38.0,1983.0,15.8,17,10,6,6,5,8,13,61.5,5,12,0,12,3,20,1,0,Matches,2021-2022,Serie-A
Samuele Ricci,it ITA,MF,Torino,19.0,2001.0,8.0,8,4,4,2,2,2,5,40.0,3,7,1,6,14,22,9,0,Matches,2021-2022,Serie-A
Samuele Ricci,it ITA,MF,Empoli,19.0,2001.0,17.0,33,19,17,13,3,20,34,58.8,14,24,5,19,31,64,18,0,Matches,2021-2022,Serie-A
Tomás Rincón,ve VEN,MF,Torino,33.0,1988.0,1.8,2,2,2,0,0,0,3,0.0,3,3,1,2,2,4,4,0,Matches,2021-2022,Serie-A
Tomás Rincón,ve VEN,MF,Sampdoria,33.0,1988.0,13.0,22,13,9,10,3,13,34,38.2,21,15,2,13,18,40,11,0,Matches,2021-2022,Serie-A
Ricardo Rodríguez,ch SUI,DF,Torino,28.0,1992.0,27.5,36,21,11,23,2,18,33,54.5,15,22,8,14,41,77,48,1,Matches,2021-2022,Serie-A
Marko Rog,hr CRO,MF,Cagliari,26.0,1995.0,3.5,5,3,1,2,2,1,8,12.5,7,6,1,5,1,6,3,0,Matches,2021-2022,Serie-A
Rogério,br BRA,DF,Sassuolo,23.0,1998.0,19.2,21,13,12,5,4,15,22,68.2,7,20,8,12,18,39,42,1,Matches,2021-2022,Serie-A
Alessio Romagnoli,it ITA,DF,Milan,26.0,1995.0,15.7,24,14,14,10,0,14,18,77.8,4,21,12,9,19,43,45,0,Matches,2021-2022,Serie-A
Simone Romagnoli,it ITA,DF,Empoli,31.0,1990.0,16.6,28,12,14,12,2,15,20,75.0,5,34,28,6,9,37,86,0,Matches,2021-2022,Serie-A
Luka Romero,ar ARG,FW,Lazio,16.0,2004.0,0.9,2,1,0,1,1,0,2,0.0,2,0,0,0,1,3,0,0,Matches,2021-2022,Serie-A
Sergio Romero,ar ARG,GK,Venezia,34.0,1987.0,16.0,2,2,2,0,0,2,2,100.0,0,0,0,0,1,3,10,0,Matches,2021-2022,Serie-A
Cristiano Ronaldo,pt POR,FW,Juventus,36.0,1985.0,0.3,1,0,0,1,0,1,1,100.0,0,0,0,0,0,1,0,0,Matches,2021-2022,Serie-A
Marten de Roon,nl NED,"MF,DF",Atalanta,30.0,1991.0,28.3,69,42,33,29,7,34,62,54.8,28,36,2,34,45,114,41,0,Matches,2021-2022,Serie-A
Francesco Rossi,it ITA,GK,Atalanta,30.0,1991.0,0.4,0,0,0,0,0,0,0,,0,0,0,0,0,0,0,0,Matches,2021-2022,Serie-A
Nicolò Rovella,it ITA,MF,Genoa,19.0,2001.0,16.3,37,26,16,14,7,15,40,37.5,25,21,1,20,20,57,20,0,Matches,2021-2022,Serie-A
Amir Rrahmani,xk KVX,DF,Napoli,27.0,1994.0,32.5,21,11,15,5,1,15,19,78.9,4,36,25,11,19,40,89,0,Matches,2021-2022,Serie-A
Ruan,br BRA,DF,Sassuolo,22.0,1999.0,2.4,7,4,7,0,0,3,4,75.0,1,6,5,1,2,9,24,1,Matches,2021-2022,Serie-A
Daniele Rugani,it ITA,DF,Juventus,27.0,1994.0,9.8,8,5,4,4,0,4,7,57.1,3,9,4,5,11,19,47,0,Matches,2021-2022,Serie-A
Matteo Ruggeri,it ITA,DF,Salernitana,19.0,2002.0,7.5,8,4,5,2,1,7,10,70.0,3,6,1,5,2,10,25,0,Matches,2021-2022,Serie-A
Mário Rui,pt POR,DF,Napoli,30.0,1991.0,33.2,68,43,32,28,8,39,84,46.4,45,31,7,24,40,108,50,0,Matches,2021-2022,Serie-A
Fabián Ruiz Peña,es ESP,MF,Napoli,25.0,1996.0,26.5,55,33,22,29,4,29,67,43.3,38,34,1,33,22,77,32,0,Matches,2021-2022,Serie-A
Alessandro Russo,it ITA,MF,Salernitana,17.0,2003.0,0.3,1,0,1,0,0,0,1,0.0,1,0,0,0,0,1,1,0,Matches,2021-2022,Serie-A
Stefano Sabelli,it ITA,DF,Genoa,28.0,1993.0,3.9,6,3,3,2,1,3,9,33.3,6,5,1,4,3,9,12,0,Matches,2021-2022,Serie-A
Abdelhamid Sabiri,ma MAR,"MF,FW",Sampdoria,24.0,1996.0,9.9,34,18,10,15,9,7,25,28.0,18,10,2,8,7,41,3,0,Matches,2021-2022,Serie-A
Alexis Saelemaekers,be BEL,FW,Milan,22.0,1999.0,20.7,43,22,12,17,14,15,51,29.4,36,19,0,19,15,58,8,0,Matches,2021-2022,Serie-A
Jacopo Sala,it ITA,MF,Spezia,29.0,1991.0,9.8,22,11,10,10,2,13,30,43.3,17,6,0,6,14,36,11,0,Matches,2021-2022,Serie-A
Eddie Salcedo,it ITA,"MF,FW",Spezia,19.0,2001.0,4.8,1,1,0,0,1,0,1,0.0,1,2,1,1,0,1,7,1,Matches,2021-2022,Serie-A
Lazar Samardzic,rs SRB,"MF,FW",Udinese,19.0,2002.0,5.4,13,9,4,7,2,7,26,26.9,19,6,0,6,2,15,2,0,Matches,2021-2022,Serie-A
Luigi Samele,it ITA,FW,Sassuolo,19.0,2002.0,0.1,0,0,0,0,0,0,0,,0,0,0,0,0,0,1,0,Matches,2021-2022,Serie-A
Antonio Sanabria,py PAR,FW,Torino,25.0,1996.0,20.0,3,2,0,1,2,1,4,25.0,3,11,4,7,2,5,10,0,Matches,2021-2022,Serie-A
Alexis Sánchez,cl CHI,FW,Inter,32.0,1988.0,9.8,9,8,0,6,3,2,11,18.2,9,4,0,4,2,11,3,0,Matches,2021-2022,Serie-A
Alex Sandro,br BRA,DF,Juventus,30.0,1991.0,19.8,27,16,15,9,3,11,25,44.0,14,17,6,11,27,54,40,0,Matches,2021-2022,Serie-A
Nicola Sansone,it ITA,"FW,MF",Bologna,29.0,1991.0,10.0,13,7,5,6,2,3,15,20.0,12,1,0,1,4,17,2,0,Matches,2021-2022,Serie-A
Federico Santander,py PAR,"FW,DF",Bologna,30.0,1991.0,0.7,2,1,1,1,0,1,1,100.0,0,0,0,0,0,2,0,0,Matches,2021-2022,Serie-A
Samir Santos,br BRA,DF,Udinese,26.0,1994.0,15.8,36,16,22,13,1,15,25,60.0,10,21,7,14,42,78,62,0,Matches,2021-2022,Serie-A
Riccardo Saponara,it ITA,FW,Fiorentina,29.0,1991.0,14.3,10,2,1,6,3,6,16,37.5,10,5,0,5,1,11,3,0,Matches,2021-2022,Serie-A
Giacomo Satalino,it ITA,GK,Sassuolo,22.0,1999.0,0.1,0,0,0,0,0,0,0,,0,0,0,0,0,0,0,0,Matches,2021-2022,Serie-A
Martin Satriano,uy URU,"FW,MF",Inter,20.0,2001.0,0.4,1,0,0,0,1,1,1,100.0,0,0,0,0,0,1,0,0,Matches,2021-2022,Serie-A
Giorgio Scalvini,it ITA,"DF,MF",Atalanta,17.0,2003.0,8.5,22,11,13,8,1,9,19,47.4,10,12,1,11,22,44,16,0,Matches,2021-2022,Serie-A
Gianluca Scamacca,it ITA,FW,Sassuolo,22.0,1999.0,23.8,19,14,2,5,12,5,21,23.8,16,16,1,15,5,24,22,1,Matches,2021-2022,Serie-A
Andrea Schiavone,it ITA,MF,Salernitana,28.0,1993.0,6.3,14,8,5,9,0,10,23,43.5,13,13,3,10,8,22,12,0,Matches,2021-2022,Serie-A
David Schnegg,at AUT,DF,Venezia,22.0,1998.0,1.6,2,0,1,1,0,1,3,33.3,2,4,0,4,3,5,6,0,Matches,2021-2022,Serie-A
Jerdy Schouten,nl NED,MF,Bologna,24.0,1997.0,15.5,25,17,10,12,3,9,22,40.9,13,22,5,17,33,58,29,1,Matches,2021-2022,Serie-A
Demba Seck,sn SEN,"MF,FW",Torino,20.0,2001.0,1.6,2,1,0,2,0,0,0,,0,0,0,0,0,2,0,0,Matches,2021-2022,Serie-A
Adrian Šemper,hr CRO,GK,Genoa,23.0,1998.0,1.0,0,0,0,0,0,0,0,,0,0,0,0,0,0,0,0,Matches,2021-2022,Serie-A
Stefano Sensi,it ITA,"MF,FW",Sampdoria,25.0,1995.0,8.4,18,9,10,6,2,10,23,43.5,13,2,0,2,6,24,4,0,Matches,2021-2022,Serie-A
Stefano Sensi,it ITA,"MF,FW",Inter,25.0,1995.0,1.9,4,3,1,3,0,2,4,50.0,2,2,0,2,0,4,2,0,Matches,2021-2022,Serie-A
Luigi Sepe,it ITA,GK,Salernitana,30.0,1991.0,15.5,0,0,0,0,0,0,0,,0,0,0,0,1,1,3,0,Matches,2021-2022,Serie-A
Laurens Serpe,it ITA,DF,Genoa,20.0,2001.0,0.5,1,0,1,0,0,1,2,50.0,1,0,0,0,0,1,1,0,Matches,2021-2022,Serie-A
Stephan El Shaarawy,it ITA,"FW,DF",Roma,28.0,1992.0,11.7,13,8,4,9,0,4,6,66.7,2,10,2,8,11,24,8,0,Matches,2021-2022,Serie-A
Aimar Sher,se SWE,MF,Spezia,18.0,2002.0,0.5,2,1,1,1,0,0,1,0.0,1,1,0,1,3,5,1,0,Matches,2021-2022,Serie-A
Eldor Shomurodov,uz UZB,"FW,MF",Roma,26.0,1995.0,8.7,5,4,0,4,1,1,10,10.0,9,8,0,8,2,7,5,0,Matches,2021-2022,Serie-A
Alassane Sidibe,ci CIV,MF,Atalanta,19.0,2002.0,0.1,1,1,1,0,0,0,0,,0,0,0,0,0,1,0,0,Matches,2021-2022,Serie-A
Arnór Sigurðsson,is ISL,"FW,MF",Venezia,22.0,1999.0,2.0,1,1,0,1,0,1,2,50.0,1,2,0,2,1,2,0,0,Matches,2021-2022,Serie-A
Adrien Silva,pt POR,MF,Sampdoria,32.0,1989.0,12.0,24,12,14,5,5,9,33,27.3,24,15,5,10,23,47,23,0,Matches,2021-2022,Serie-A
Marco Silvestri,it ITA,GK,Udinese,30.0,1991.0,35.0,0,0,0,0,0,0,1,0.0,1,0,0,0,1,1,11,1,Matches,2021-2022,Serie-A
Giovanni Simeone,ar ARG,FW,Hellas Verona,26.0,1995.0,29.5,27,15,6,12,9,9,39,23.1,30,37,3,34,6,33,23,0,Matches,2021-2022,Serie-A
Giovanni Simeone,ar ARG,FW,Cagliari,26.0,1995.0,0.1,0,0,0,0,0,0,0,,0,0,0,0,0,0,0,0,Matches,2021-2022,Serie-A
Wilfried Singo,ci CIV,DF,Torino,20.0,2000.0,29.0,55,35,24,24,7,24,34,70.6,10,26,6,20,23,78,47,0,Matches,2021-2022,Serie-A
Salvatore Sirigu,it ITA,GK,Genoa,34.0,1987.0,37.0,1,1,1,0,0,1,2,50.0,1,0,0,0,0,1,19,2,Matches,2021-2022,Serie-A
Leo Skiri Østigård,no NOR,DF,Genoa,21.0,1999.0,13.0,16,9,8,7,1,9,11,81.8,2,17,10,7,8,24,55,1,Matches,2021-2022,Serie-A
Łukasz Skorupski,pl POL,GK,Bologna,30.0,1991.0,36.0,0,0,0,0,0,0,1,0.0,1,0,0,0,0,0,17,0,Matches,2021-2022,Serie-A
Andreas Skov Olsen,dk DEN,"FW,DF",Bologna,21.0,1999.0,8.3,12,10,4,4,4,5,11,45.5,6,9,1,8,3,15,11,0,Matches,2021-2022,Serie-A
Milan Škriniar,sk SVK,DF,Inter,26.0,1995.0,35.0,47,27,26,17,4,24,42,57.1,18,36,25,11,25,72,90,1,Matches,2021-2022,Serie-A
Chris Smalling,eng ENG,DF,Roma,31.0,1989.0,23.2,36,23,28,8,0,18,25,72.0,7,32,24,8,26,62,92,1,Matches,2021-2022,Serie-A
Brandon Soppy,fr FRA,"DF,MF",Udinese,19.0,2002.0,8.6,20,9,8,10,2,11,16,68.8,5,10,2,8,5,25,9,1,Matches,2021-2022,Serie-A
Roberto Soriano,it ITA,MF,Bologna,30.0,1991.0,29.1,57,30,27,22,8,17,56,30.4,39,37,3,34,22,79,32,0,Matches,2021-2022,Serie-A
Riccardo Sottil,it ITA,FW,Fiorentina,22.0,1999.0,13.8,9,4,4,4,1,3,9,33.3,6,3,0,3,1,10,2,0,Matches,2021-2022,Serie-A
Matìas Soulé,ar ARG,FW,Juventus,18.0,2003.0,0.1,0,0,0,0,0,0,1,0.0,1,0,0,0,0,0,0,0,Matches,2021-2022,Serie-A
Adama Soumaoro,fr FRA,DF,Bologna,29.0,1992.0,25.2,15,5,5,8,2,4,9,44.4,5,22,16,6,34,49,95,0,Matches,2021-2022,Serie-A
Leonardo Spinazzola,it ITA,DF,Roma,28.0,1993.0,1.4,0,0,0,0,0,0,1,0.0,1,4,1,3,0,0,3,0,Matches,2021-2022,Serie-A
Marco Sportiello,it ITA,GK,Atalanta,29.0,1992.0,5.0,0,0,0,0,0,0,0,,0,0,0,0,0,0,2,0,Matches,2021-2022,Serie-A
Luca Stanga,it ITA,DF,Milan,19.0,2002.0,0.0,1,0,0,1,0,0,0,,0,0,0,0,0,1,0,0,Matches,2021-2022,Serie-A
Riccardo Stivanello,it ITA,DF,Bologna,17.0,2004.0,0.5,1,1,1,0,0,1,1,100.0,0,2,2,0,0,1,6,0,Matches,2021-2022,Serie-A
Petar Stojanović,si SVN,DF,Empoli,25.0,1995.0,30.4,96,63,55,32,9,59,114,51.8,55,39,13,26,27,123,65,1,Matches,2021-2022,Serie-A
Thomas Strakosha,al ALB,GK,Lazio,26.0,1995.0,23.0,0,0,0,0,0,0,0,,0,0,0,0,0,0,7,2,Matches,2021-2022,Serie-A
Stefan Strandberg,no NOR,DF,Salernitana,31.0,1990.0,10.4,13,8,10,3,0,8,11,72.7,3,15,13,2,9,22,49,0,Matches,2021-2022,Serie-A
Dávid Strelec,sk SVK,"FW,MF",Spezia,20.0,2001.0,5.6,4,4,1,2,1,2,9,22.2,7,8,1,7,2,6,1,0,Matches,2021-2022,Serie-A
Kevin Strootman,nl NED,MF,Cagliari,31.0,1990.0,7.1,8,4,2,4,2,5,12,41.7,7,11,2,9,10,18,15,0,Matches,2021-2022,Serie-A
Jens Stryger Larsen,dk DEN,DF,Udinese,30.0,1991.0,7.6,5,2,3,1,1,2,3,66.7,1,2,0,2,4,9,17,0,Matches,2021-2022,Serie-A
Leo Štulac,si SVN,MF,Empoli,26.0,1994.0,9.3,13,6,5,6,2,7,19,36.8,12,6,2,4,8,21,15,0,Matches,2021-2022,Serie-A
Stefano Sturaro,it ITA,MF,Genoa,28.0,1993.0,19.6,43,26,16,16,11,22,48,45.8,26,25,1,24,15,58,29,2,Matches,2021-2022,Serie-A
Isaac Success,ng NGA,"FW,MF",Udinese,25.0,1996.0,10.1,5,2,0,3,2,1,5,20.0,4,2,0,2,2,7,6,0,Matches,2021-2022,Serie-A
Vladyslav Supriaha,ua UKR,FW,Sampdoria,21.0,2000.0,0.2,0,0,0,0,0,0,1,0.0,1,0,0,0,0,0,0,0,Matches,2021-2022,Serie-A
Bosko Sutalo,hr CRO,DF,Hellas Verona,21.0,2000.0,10.2,20,13,11,6,3,8,16,50.0,8,10,5,5,17,37,39,0,Matches,2021-2022,Serie-A
Mattias Svanberg,se SWE,MF,Bologna,22.0,1999.0,28.5,39,15,15,16,8,16,54,29.6,38,31,9,22,28,67,34,0,Matches,2021-2022,Serie-A
Michael Svoboda,at AUT,DF,Venezia,22.0,1998.0,13.7,33,17,26,6,1,18,32,56.3,14,27,15,12,10,43,61,5,Matches,2021-2022,Serie-A
Wojciech Szczęsny,pl POL,GK,Juventus,31.0,1990.0,33.0,1,1,1,0,0,1,2,50.0,1,0,0,0,0,1,8,1,Matches,2021-2022,Serie-A
Adrien Tameze,cm CMR,"MF,DF",Hellas Verona,27.0,1994.0,28.6,52,29,24,21,7,20,59,33.9,39,40,5,35,52,104,41,0,Matches,2021-2022,Serie-A
Ciprian Tătărușanu,ro ROU,GK,Milan,35.0,1986.0,6.0,0,0,0,0,0,0,1,0.0,1,0,0,0,0,0,2,1,Matches,2021-2022,Serie-A
Filippo Terracciano,it ITA,DF,Hellas Verona,18.0,2003.0,0.1,0,0,0,0,0,0,0,,0,0,0,0,0,0,1,0,Matches,2021-2022,Serie-A
Pietro Terracciano,it ITA,GK,Fiorentina,31.0,1990.0,31.8,0,0,0,0,0,0,4,0.0,4,0,0,0,2,2,20,1,Matches,2021-2022,Serie-A
Aleksa Terzić,rs SRB,DF,Fiorentina,21.0,1999.0,3.0,8,5,3,3,2,4,7,57.1,3,7,0,7,4,12,5,0,Matches,2021-2022,Serie-A
Tanner Tessmann,us USA,MF,Venezia,19.0,2001.0,7.6,11,5,4,6,1,5,14,35.7,9,19,9,10,5,16,22,0,Matches,2021-2022,Serie-A
Arthur Theate,be BEL,DF,Bologna,21.0,2000.0,26.9,33,19,26,3,4,14,31,45.2,17,29,16,13,42,75,69,0,Matches,2021-2022,Serie-A
Morten Thorsby,no NOR,MF,Sampdoria,25.0,1996.0,32.7,46,26,15,23,8,28,56,50.0,28,37,12,25,25,71,39,0,Matches,2021-2022,Serie-A
Jeremy Toljan,de GER,DF,Sassuolo,26.0,1994.0,15.5,18,10,12,4,2,13,20,65.0,7,12,5,7,12,30,41,0,Matches,2021-2022,Serie-A
Rafael Tolói,it ITA,DF,Atalanta,30.0,1990.0,16.0,38,15,12,15,11,24,39,61.5,15,23,11,12,26,64,35,0,Matches,2021-2022,Serie-A
Takehiro Tomiyasu,jp JPN,DF,Bologna,22.0,1998.0,0.1,0,0,0,0,0,0,0,,0,1,0,1,1,1,0,0,Matches,2021-2022,Serie-A
Fikayo Tomori,eng ENG,DF,Milan,23.0,1997.0,30.2,73,44,36,34,3,18,26,69.2,8,37,23,14,45,118,84,1,Matches,2021-2022,Serie-A
Sandro Tonali,it ITA,MF,Milan,21.0,2000.0,28.9,54,37,23,25,6,21,41,51.2,20,26,8,18,34,88,19,0,Matches,2021-2022,Serie-A
Lorenzo Tonelli,it ITA,DF,Empoli,31.0,1990.0,9.7,17,9,11,4,2,6,13,46.2,7,14,8,6,19,36,28,2,Matches,2021-2022,Serie-A
Ernesto Torregrossa,ve VEN,FW,Sampdoria,29.0,1992.0,1.3,2,1,1,0,1,1,2,50.0,1,0,0,0,0,2,1,0,Matches,2021-2022,Serie-A
Lucas Torreira,uy URU,MF,Fiorentina,25.0,1996.0,24.4,37,29,13,21,3,18,40,45.0,22,18,1,17,26,63,18,0,Matches,2021-2022,Serie-A
Abdoulaye Touré,gn GUI,MF,Genoa,27.0,1994.0,4.8,12,4,3,8,1,5,11,45.5,6,6,1,5,4,16,6,0,Matches,2021-2022,Serie-A
Simone Trimboli,it ITA,MF,Sampdoria,19.0,2002.0,0.7,2,1,2,0,0,2,2,100.0,0,0,0,0,2,4,0,0,Matches,2021-2022,Serie-A
Axel Tuanzebe,cd COD,DF,Napoli,23.0,1997.0,0.1,0,0,0,0,0,0,0,,0,1,1,0,0,0,0,0,Matches,2021-2022,Serie-A
Destiny Udogie,it ITA,DF,Udinese,18.0,2002.0,27.5,64,40,30,27,7,33,60,55.0,27,39,6,33,27,91,42,0,Matches,2021-2022,Serie-A
Maximilian Ullmann,at AUT,DF,Venezia,25.0,1996.0,2.7,0,0,0,0,0,0,1,0.0,1,4,0,4,2,2,7,0,Matches,2021-2022,Serie-A
Kacper Urbanski,pl POL,MF,Bologna,16.0,2004.0,0.5,3,2,1,2,0,2,2,100.0,0,2,0,2,0,3,0,0,Matches,2021-2022,Serie-A
Antonio Vacca,it ITA,MF,Venezia,31.0,1990.0,11.8,36,20,24,10,2,14,36,38.9,22,16,8,8,20,56,16,0,Matches,2021-2022,Serie-A
Zinho Vanheusden,be BEL,DF,Genoa,22.0,1999.0,11.0,18,6,12,5,1,8,14,57.1,6,19,14,5,23,41,42,0,Matches,2021-2022,Serie-A
Johan Vásquez,mx MEX,DF,Genoa,22.0,1998.0,25.3,79,46,44,32,3,48,75,64.0,27,32,10,22,42,121,85,0,Matches,2021-2022,Serie-A
Denis Vavro,sk SVK,DF,Lazio,25.0,1996.0,0.1,0,0,0,0,0,0,0,,0,0,0,0,0,0,0,0,Matches,2021-2022,Serie-A
Matías Vecino,uy URU,MF,Inter,29.0,1991.0,4.2,7,5,2,3,2,3,9,33.3,6,10,1,9,4,11,7,0,Matches,2021-2022,Serie-A
Miguel Veloso,pt POR,MF,Hellas Verona,35.0,1986.0,14.9,23,15,4,17,2,10,16,62.5,6,18,5,13,11,34,18,1,Matches,2021-2022,Serie-A
Lorenzo Venuti,it ITA,DF,Fiorentina,26.0,1995.0,17.5,25,10,13,10,2,14,24,58.3,10,13,4,9,5,30,27,0,Matches,2021-2022,Serie-A
Daniele Verde,it ITA,"FW,MF",Spezia,25.0,1996.0,21.7,11,4,8,2,1,9,20,45.0,11,17,2,15,18,29,8,0,Matches,2021-2022,Serie-A
Simone Verdi,it ITA,"MF,FW",Torino,29.0,1992.0,0.5,1,1,0,1,0,0,0,,0,0,0,0,0,1,0,0,Matches,2021-2022,Serie-A
Simone Verdi,it ITA,"FW,MF",Salernitana,29.0,1992.0,9.2,12,8,5,2,5,9,20,45.0,11,4,0,4,3,15,1,0,Matches,2021-2022,Serie-A
Jordan Veretout,fr FRA,MF,Roma,28.0,1993.0,25.8,34,25,20,12,2,15,39,38.5,24,12,1,11,27,61,22,1,Matches,2021-2022,Serie-A
Edoardo Vergani,it ITA,"FW,MF",Salernitana,20.0,2001.0,1.1,2,2,2,0,0,0,0,,0,2,2,0,0,2,2,0,Matches,2021-2022,Serie-A
Valerio Verre,it ITA,"MF,FW",Sampdoria,27.0,1994.0,4.7,7,5,1,4,2,4,9,44.4,5,7,0,7,0,7,5,0,Matches,2021-2022,Serie-A
Valerio Verre,it ITA,MF,Empoli,27.0,1994.0,3.4,4,2,3,1,0,2,7,28.6,5,2,0,2,1,5,0,0,Matches,2021-2022,Serie-A
Freddie Veseli,al ALB,DF,Salernitana,28.0,1992.0,6.6,7,2,4,3,0,5,6,83.3,1,10,5,5,4,11,19,0,Matches,2021-2022,Serie-A
Guglielmo Vicario,it ITA,GK,Empoli,24.0,1996.0,38.0,1,1,1,0,0,1,1,100.0,0,1,0,1,1,2,21,1,Matches,2021-2022,Serie-A
Arturo Vidal,cl CHI,MF,Inter,34.0,1987.0,8.2,26,10,16,9,1,9,26,34.6,17,13,5,8,7,33,7,1,Matches,2021-2022,Serie-A
Ronaldo Vieira,eng ENG,MF,Sampdoria,23.0,1998.0,5.5,10,6,6,4,0,5,10,50.0,5,5,2,3,6,16,5,1,Matches,2021-2022,Serie-A
Luca Vignali,it ITA,"DF,MF",Spezia,25.0,1996.0,0.9,1,1,0,1,0,0,3,0.0,3,0,0,0,1,2,1,0,Matches,2021-2022,Serie-A
Emanuel Vignato,it ITA,"MF,DF",Bologna,20.0,2000.0,6.6,12,7,5,7,0,6,13,46.2,7,2,0,2,2,14,5,0,Matches,2021-2022,Serie-A
Matías Viña,uy URU,"DF,FW",Roma,23.0,1997.0,17.4,46,30,27,14,5,29,59,49.2,30,26,3,23,25,71,33,0,Matches,2021-2022,Serie-A
Nicolas Viola,it ITA,MF,Bologna,31.0,1989.0,1.1,2,2,1,1,0,1,2,50.0,1,1,1,0,0,2,1,0,Matches,2021-2022,Serie-A
Mattia Viti,it ITA,DF,Empoli,19.0,2002.0,16.6,28,16,16,9,3,15,24,62.5,9,28,25,3,29,57,69,1,Matches,2021-2022,Serie-A
Dušan Vlahović,rs SRB,FW,Fiorentina,21.0,2000.0,20.6,5,0,0,2,3,2,11,18.2,9,6,2,4,1,6,16,0,Matches,2021-2022,Serie-A
Dušan Vlahović,rs SRB,FW,Juventus,21.0,2000.0,12.0,0,0,0,0,0,0,4,0.0,4,3,0,3,0,0,7,0,Matches,2021-2022,Serie-A
Mërgim Vojvoda,xk KVX,DF,Torino,26.0,1995.0,22.0,38,23,23,11,4,20,36,55.6,16,27,8,19,20,58,51,0,Matches,2021-2022,Serie-A
Cristian Volpato,it ITA,"FW,MF",Roma,17.0,2003.0,0.4,1,1,0,0,1,1,1,100.0,0,0,0,0,0,1,0,0,Matches,2021-2022,Serie-A
Stefan de Vrij,nl NED,DF,Inter,29.0,1992.0,26.8,38,29,22,16,0,12,17,70.6,5,17,8,9,32,70,52,0,Matches,2021-2022,Serie-A
Walace,br BRA,MF,Udinese,26.0,1995.0,33.0,83,49,37,38,8,50,113,44.2,63,51,5,46,54,137,32,1,Matches,2021-2022,Serie-A
Sebastian Walukiewicz,pl POL,DF,Cagliari,21.0,2000.0,3.4,9,5,7,2,0,3,5,60.0,2,5,2,3,7,16,14,0,Matches,2021-2022,Serie-A
Magnus Warming,dk DEN,"MF,FW",Torino,21.0,2000.0,0.6,1,1,0,1,0,0,0,,0,2,0,2,0,1,0,0,Matches,2021-2022,Serie-A
Kelvin Yeboah,it ITA,"FW,MF",Genoa,21.0,2000.0,9.4,14,7,5,7,2,9,19,47.4,10,22,1,21,1,15,7,0,Matches,2021-2022,Serie-A
Gerard Yepes,es ESP,"MF,DF",Sampdoria,18.0,2002.0,0.2,1,0,0,1,0,1,1,100.0,0,1,0,1,0,1,0,0,Matches,2021-2022,Serie-A
Maya Yoshida,jp JPN,DF,Sampdoria,32.0,1988.0,20.3,17,10,8,9,0,8,15,53.3,7,27,20,7,28,45,72,1,Matches,2021-2022,Serie-A
Mattia Zaccagni,it ITA,MF,Hellas Verona,26.0,1995.0,2.0,3,1,1,0,2,1,2,50.0,1,1,0,1,4,7,0,0,Matches,2021-2022,Serie-A
Mattia Zaccagni,it ITA,FW,Lazio,26.0,1995.0,20.8,33,16,10,13,10,11,19,57.9,8,17,2,15,20,53,5,0,Matches,2021-2022,Serie-A
Denis Zakaria,ch SUI,MF,Juventus,24.0,1996.0,6.6,11,7,3,6,2,3,11,27.3,8,16,3,13,11,22,7,0,Matches,2021-2022,Serie-A
Nicola Zalewski,pl POL,DF,Roma,19.0,2002.0,8.8,32,19,17,11,4,21,35,60.0,14,18,1,17,16,48,4,0,Matches,2021-2022,Serie-A
Andre-Frank Zambo Anguissa,cm CMR,MF,Napoli,25.0,1995.0,21.4,50,26,24,17,9,25,51,49.0,26,31,5,26,24,74,33,1,Matches,2021-2022,Serie-A
Nicolò Zaniolo,it ITA,"FW,MF",Roma,22.0,1999.0,21.9,24,15,0,15,9,6,28,21.4,22,19,0,19,7,31,6,0,Matches,2021-2022,Serie-A
Alessandro Zanoli,it ITA,DF,Napoli,20.0,2000.0,5.1,10,7,6,3,1,3,5,60.0,2,2,1,1,4,14,16,0,Matches,2021-2022,Serie-A
Mattia Zanotti,it ITA,DF,Inter,18.0,2003.0,0.1,1,0,1,0,0,0,1,0.0,1,0,0,0,0,1,0,0,Matches,2021-2022,Serie-A
Duván Zapata,co COL,FW,Atalanta,30.0,1991.0,19.1,6,2,0,4,2,4,8,50.0,4,8,1,7,3,9,5,0,Matches,2021-2022,Serie-A
Gabriele Zappa,it ITA,DF,Cagliari,21.0,1999.0,12.7,21,9,12,6,3,6,24,25.0,18,15,5,10,14,35,28,0,Matches,2021-2022,Serie-A
Davide Zappacosta,it ITA,DF,Atalanta,29.0,1992.0,26.1,32,22,12,13,7,19,37,51.4,18,32,2,30,12,44,22,0,Matches,2021-2022,Serie-A
Simone Zaza,it ITA,"FW,DF",Torino,30.0,1991.0,1.4,2,2,1,1,0,1,1,100.0,0,3,0,3,0,2,3,0,Matches,2021-2022,Serie-A
Marvin Zeegelaar,nl NED,DF,Udinese,30.0,1990.0,7.1,15,11,6,8,1,5,14,35.7,9,12,4,8,12,27,22,1,Matches,2021-2022,Serie-A
Piotr Zieliński,pl POL,MF,Napoli,27.0,1994.0,23.2,19,12,5,9,5,6,21,28.6,15,13,2,11,8,27,4,0,Matches,2021-2022,Serie-A
David Zima,cz CZE,DF,Torino,20.0,2000.0,14.6,20,12,8,11,1,9,20,45.0,11,15,13,2,23,43,42,0,Matches,2021-2022,Serie-A
Jeroen Zoet,nl NED,GK,Spezia,30.0,1991.0,7.0,1,0,1,0,0,1,1,100.0,0,0,0,0,0,1,4,0,Matches,2021-2022,Serie-A
Nadir Zortea,it ITA,"DF,MF",Salernitana,22.0,1999.0,15.7,21,15,9,7,5,11,19,57.9,8,14,2,12,7,28,33,0,Matches,2021-2022,Serie-A
Petar Zovko,ba BIH,GK,Spezia,19.0,2002.0,0.3,0,0,0,0,0,0,0,,0,0,0,0,0,0,1,0,Matches,2021-2022,Serie-A
Szymon Żurkowski,pl POL,MF,Empoli,23.0,1997.0,25.6,58,33,24,21,13,29,68,42.6,39,43,10,33,35,93,32,1,Matches,2021-2022,Serie-A
Milan Đurić,ba BIH,FW,Salernitana,31.0,1990.0,24.1,1,1,0,1,0,1,3,33.3,2,6,1,5,2,3,32,0,Matches,2021-2022,Serie-A
Filip Đuričić,rs SRB,"MF,FW",Sassuolo,29.0,1992.0,7.5,13,10,7,1,5,5,13,38.5,8,7,1,6,4,17,1,0,Matches,2021-2022,Serie-A
James Abankwah,ie IRL,DF,Udinese,18.0,2004.0,0.7,1,1,0,1,0,0,0,,0,4,2,2,0,1,5,0,Matches,2022-2023,Serie-A
Oliver Abildgaard,dk DEN,MF,Hellas Verona,26.0,1996.0,6.6,10,6,6,3,1,7,16,43.8,9,7,1,6,5,15,17,0,Matches,2022-2023,Serie-A
Tammy Abraham,eng ENG,FW,Roma,24.0,1997.0,24.3,17,10,4,8,5,3,16,18.8,13,10,4,6,3,20,14,0,Matches,2022-2023,Serie-A
Christian Acella,it ITA,MF,Cremonese,20.0,2002.0,0.2,1,0,1,0,0,0,2,0.0,2,0,0,0,0,1,0,0,Matches,2022-2023,Serie-A
Francesco Acerbi,it ITA,DF,Inter,34.0,1988.0,26.9,33,19,22,7,4,20,27,74.1,7,25,18,7,41,74,85,2,Matches,2022-2023,Serie-A
Yacine Adli,fr FRA,"MF,FW",Milan,22.0,2000.0,1.6,6,3,2,4,0,2,2,100.0,0,2,0,2,1,7,1,0,Matches,2022-2023,Serie-A
Michel Aebischer,ch SUI,"FW,MF",Bologna,25.0,1997.0,17.1,12,6,3,6,3,2,18,11.1,16,14,2,12,7,19,9,0,Matches,2022-2023,Serie-A
Felix Afena-Gyan,gh GHA,"FW,MF",Cremonese,19.0,2003.0,9.1,7,3,4,1,2,2,10,20.0,8,5,1,4,1,8,6,0,Matches,2022-2023,Serie-A
Kevin Agudelo,co COL,"MF,FW",Spezia,23.0,1998.0,23.7,71,38,22,30,19,25,59,42.4,34,39,5,34,10,81,6,0,Matches,2022-2023,Serie-A
Ola Aina,ng NGA,DF,Torino,25.0,1996.0,9.7,17,13,5,8,4,9,15,60.0,6,12,2,10,11,28,26,0,Matches,2022-2023,Serie-A
Emanuel Aiwum,at AUT,DF,Cremonese,21.0,2000.0,18.4,55,34,36,17,2,33,47,70.2,14,28,16,12,25,80,52,3,Matches,2022-2023,Serie-A
Jean-Daniel Akpa-Akpro,ci CIV,"MF,FW",Empoli,29.0,1992.0,15.1,53,37,25,19,9,23,42,54.8,19,35,4,31,13,66,27,0,Matches,2022-2023,Serie-A
Luis Alberto,es ESP,MF,Lazio,29.0,1992.0,27.1,49,29,18,20,11,23,72,31.9,49,35,6,29,9,58,4,0,Matches,2022-2023,Serie-A
Agustín Álvarez Martínez,uy URU,"FW,MF",Sassuolo,21.0,2001.0,4.1,6,3,0,5,1,1,4,25.0,3,5,1,4,3,9,3,0,Matches,2022-2023,Serie-A
Kelvin Amian,fr FRA,DF,Spezia,24.0,1998.0,26.4,54,32,33,12,9,24,31,77.4,7,34,12,22,22,76,87,1,Matches,2022-2023,Serie-A
Bruno Amione,ar ARG,DF,Hellas Verona,20.0,2002.0,0.6,1,1,1,0,0,1,2,50.0,1,1,0,1,0,1,4,0,Matches,2022-2023,Serie-A
Bruno Amione,ar ARG,DF,Sampdoria,20.0,2002.0,23.2,50,33,36,14,0,19,43,44.2,24,26,11,15,25,75,62,1,Matches,2022-2023,Serie-A
Ethan Ampadu,wls WAL,"DF,MF",Spezia,21.0,2000.0,29.3,66,37,33,28,5,17,41,41.5,24,48,23,25,36,102,98,0,Matches,2022-2023,Serie-A
Sofyan Amrabat,ma MAR,MF,Fiorentina,25.0,1996.0,22.2,39,24,15,17,7,16,29,55.2,13,23,5,18,21,60,18,2,Matches,2022-2023,Serie-A
Felipe Anderson,br BRA,FW,Lazio,29.0,1993.0,32.9,80,50,31,41,8,31,88,35.2,57,58,6,52,31,111,27,0,Matches,2022-2023,Serie-A
Janis Antiste,fr FRA,FW,Sassuolo,19.0,2002.0,0.6,1,0,1,0,0,1,1,100.0,0,0,0,0,0,1,0,0,Matches,2022-2023,Serie-A
Marcos Antônio,br BRA,MF,Lazio,22.0,2000.0,6.6,9,6,4,5,0,9,20,45.0,11,7,2,5,11,20,18,0,Matches,2022-2023,Serie-A
Valentin Antov,bg BUL,DF,Monza,21.0,2000.0,3.4,6,5,3,3,0,1,5,20.0,4,5,4,1,4,10,14,1,Matches,2022-2023,Serie-A
Marko Arnautović,at AUT,FW,Bologna,33.0,1989.0,17.0,9,6,2,5,2,1,6,16.7,5,11,1,10,2,11,10,0,Matches,2022-2023,Serie-A
Tolgay Arslan,de GER,MF,Udinese,31.0,1990.0,13.5,29,18,13,15,1,14,39,35.9,25,19,0,19,12,41,9,1,Matches,2022-2023,Serie-A
Santiago Ascacíbar,ar ARG,MF,Cremonese,25.0,1997.0,8.1,29,14,17,10,2,14,35,40.0,21,14,2,12,13,42,11,0,Matches,2022-2023,Serie-A
Kristoffer Askildsen,no NOR,MF,Lecce,21.0,2001.0,8.1,7,3,2,3,2,4,10,40.0,6,15,4,11,11,18,6,0,Matches,2022-2023,Serie-A
Kristjan Asllani,al ALB,MF,Inter,20.0,2002.0,6.6,11,5,1,8,2,7,10,70.0,3,3,1,2,6,17,4,0,Matches,2022-2023,Serie-A
Emil Audero,id IDN,GK,Sampdoria,25.0,1997.0,25.0,0,0,0,0,0,0,2,0.0,2,0,0,0,0,0,7,1,Matches,2022-2023,Serie-A
Tommaso Augello,it ITA,DF,Sampdoria,27.0,1994.0,34.0,17,14,13,2,2,9,20,45.0,11,23,7,16,17,34,61,1,Matches,2022-2023,Serie-A
Carlos Augusto,br BRA,DF,Monza,23.0,1999.0,34.3,73,38,42,23,8,33,54,61.1,21,24,6,18,24,97,85,1,Matches,2022-2023,Serie-A
Kaan Ayhan,tr TUR,DF,Sassuolo,27.0,1994.0,6.1,10,4,6,4,0,7,7,100.0,0,5,4,1,5,15,26,1,Matches,2022-2023,Serie-A
Jaime Báez,uy URU,DF,Cremonese,27.0,1995.0,1.1,4,2,3,0,1,3,6,50.0,3,0,0,0,0,4,2,1,Matches,2022-2023,Serie-A
Nedim Bajrami,al ALB,"MF,FW",Empoli,23.0,1999.0,10.4,8,4,3,3,2,4,6,66.7,2,5,0,5,7,15,4,0,Matches,2022-2023,Serie-A
Nedim Bajrami,al ALB,"FW,MF",Sassuolo,23.0,1999.0,9.1,12,7,6,2,4,5,11,45.5,6,9,1,8,7,19,6,0,Matches,2022-2023,Serie-A
Tiemoué Bakayoko,fr FRA,MF,Milan,27.0,1994.0,0.5,5,5,4,1,0,3,3,100.0,0,0,0,0,0,5,0,1,Matches,2022-2023,Serie-A
Tommaso Baldanzi,it ITA,MF,Empoli,19.0,2003.0,19.7,25,12,9,13,3,7,32,21.9,25,21,1,20,2,27,5,0,Matches,2022-2023,Serie-A
Fodé Ballo-Touré,sn SEN,DF,Milan,25.0,1997.0,5.8,14,9,7,6,1,7,10,70.0,3,11,3,8,2,16,3,0,Matches,2022-2023,Serie-A
Lameck Banda,zm ZAM,"FW,MF",Lecce,21.0,2001.0,18.2,30,20,13,14,3,15,41,36.6,26,24,2,22,8,38,5,0,Matches,2022-2023,Serie-A
Filippo Bandinelli,it ITA,MF,Empoli,27.0,1995.0,25.1,55,34,19,26,10,17,45,37.8,28,20,7,13,18,73,40,0,Matches,2022-2023,Serie-A
Antonín Barák,cz CZE,MF,Hellas Verona,27.0,1994.0,0.3,0,0,0,0,0,0,0,,0,0,0,0,0,0,0,0,Matches,2022-2023,Serie-A
Antonín Barák,cz CZE,MF,Fiorentina,27.0,1994.0,20.0,21,9,5,7,9,6,16,37.5,10,16,2,14,3,24,13,0,Matches,2022-2023,Serie-A
Andrea Barberis,it ITA,MF,Monza,28.0,1993.0,3.8,7,2,4,3,0,5,11,45.5,6,0,0,0,8,15,1,0,Matches,2022-2023,Serie-A
Tommaso Barbieri,it ITA,DF,Juventus,19.0,2002.0,1.2,3,3,3,0,0,3,8,37.5,5,3,0,3,0,3,2,0,Matches,2022-2023,Serie-A
Francesco Bardi,it ITA,GK,Bologna,30.0,1992.0,1.0,0,0,0,0,0,0,0,,0,0,0,0,0,0,0,0,Matches,2022-2023,Serie-A
Nicolò Barella,it ITA,MF,Inter,25.0,1997.0,29.0,49,25,17,26,6,28,53,52.8,25,29,5,24,12,61,12,0,Matches,2022-2023,Serie-A
Enzo Barrenechea,ar ARG,MF,Juventus,21.0,2001.0,1.8,8,3,3,4,1,3,5,60.0,2,3,0,3,2,10,3,0,Matches,2022-2023,Serie-A
Musa Barrow,gm GAM,"FW,MF",Bologna,23.0,1998.0,21.8,21,4,10,6,5,8,14,57.1,6,25,1,24,1,22,7,0,Matches,2022-2023,Serie-A
Federico Baschirotto,it ITA,DF,Lecce,25.0,1996.0,37.0,40,30,35,5,0,22,36,61.1,14,45,29,16,36,76,192,0,Matches,2022-2023,Serie-A
Toma Bašić,hr CRO,MF,Lazio,25.0,1996.0,5.7,6,4,4,1,1,3,8,37.5,5,9,0,9,7,13,8,0,Matches,2022-2023,Serie-A
Alberto Basso,it ITA,MF,Cremonese,18.0,2004.0,0.2,0,0,0,0,0,0,0,,0,0,0,0,0,0,0,0,Matches,2022-2023,Serie-A
Alessandro Bastoni,it ITA,DF,Inter,23.0,1999.0,24.0,41,20,20,14,7,11,27,40.7,16,27,13,14,24,65,45,0,Matches,2022-2023,Serie-A
Simone Bastoni,it ITA,"MF,DF",Spezia,25.0,1996.0,13.2,47,24,23,19,5,15,33,45.5,18,20,5,15,8,55,14,0,Matches,2022-2023,Serie-A
Brian Bayeye,cd COD,DF,Torino,22.0,2000.0,0.7,3,0,3,0,0,1,1,100.0,0,1,1,0,1,4,2,0,Matches,2022-2023,Serie-A
Rodrigo Becão,br BRA,DF,Udinese,26.0,1996.0,27.6,70,36,50,17,3,40,53,75.5,13,44,24,20,26,96,68,2,Matches,2022-2023,Serie-A
Julius Beck,dk DEN,MF,Spezia,17.0,2005.0,0.1,2,1,1,1,0,0,0,,0,0,0,0,0,2,0,0,Matches,2022-2023,Serie-A
Raoul Bellanova,it ITA,DF,Inter,22.0,2000.0,5.5,14,6,11,2,1,9,14,64.3,5,6,1,5,4,18,14,0,Matches,2022-2023,Serie-A
Andrea Belotti,it ITA,FW,Roma,28.0,1993.0,12.7,12,5,3,5,4,5,11,45.5,6,11,1,10,3,15,5,0,Matches,2022-2023,Serie-A
Marco Benassi,it ITA,DF,Fiorentina,27.0,1994.0,1.0,3,3,2,0,1,3,4,75.0,1,0,0,0,1,4,1,0,Matches,2022-2023,Serie-A
Marco Benassi,it ITA,MF,Cremonese,27.0,1994.0,11.1,26,15,9,11,6,15,24,62.5,9,13,1,12,12,38,19,0,Matches,2022-2023,Serie-A
Ismaël Bennacer,dz ALG,MF,Milan,24.0,1997.0,22.3,59,33,26,31,2,30,51,58.8,21,25,7,18,26,85,16,1,Matches,2022-2023,Serie-A
Domenico Berardi,it ITA,FW,Sassuolo,27.0,1994.0,20.7,23,14,8,10,5,9,40,22.5,31,13,0,13,19,42,18,0,Matches,2022-2023,Serie-A
Bartosz Bereszyński,pl POL,DF,Sampdoria,30.0,1992.0,13.3,28,18,15,11,2,17,26,65.4,9,18,4,14,21,49,25,0,Matches,2022-2023,Serie-A
Bartosz Bereszyński,pl POL,DF,Napoli,30.0,1992.0,1.8,3,2,1,1,1,2,2,100.0,0,4,0,4,3,6,3,0,Matches,2022-2023,Serie-A
Marco Bertini,it ITA,MF,Lazio,19.0,2002.0,0.0,0,0,0,0,0,0,0,,0,0,0,0,0,0,0,0,Matches,2022-2023,Serie-A
Beto,gw GNB,FW,Udinese,24.0,1998.0,23.7,16,9,0,9,7,4,17,23.5,13,18,3,15,6,22,30,0,Matches,2022-2023,Serie-A
Matteo Bianchetti,it ITA,DF,Cremonese,29.0,1993.0,23.7,32,19,21,9,2,20,32,62.5,12,31,17,14,20,52,111,0,Matches,2022-2023,Serie-A
Alessandro Bianco,it ITA,MF,Fiorentina,19.0,2002.0,1.7,5,2,2,3,0,2,3,66.7,1,1,0,1,0,5,0,0,Matches,2022-2023,Serie-A
Jaka Bijol,si SVN,DF,Udinese,23.0,1999.0,30.3,39,23,32,7,0,16,27,59.3,11,41,25,16,29,68,165,0,Matches,2022-2023,Serie-A
Cristiano Biraghi,it ITA,DF,Fiorentina,29.0,1992.0,28.3,65,38,29,29,7,32,65,49.2,33,32,7,25,14,79,42,1,Matches,2022-2023,Serie-A
Samuele Birindelli,it ITA,DF,Monza,23.0,1999.0,15.6,35,19,21,10,4,18,29,62.1,11,28,8,20,16,51,30,0,Matches,2022-2023,Serie-A
Kristijan Bistrović,hr CRO,MF,Lecce,24.0,1998.0,5.1,3,1,3,0,0,0,5,0.0,5,3,0,3,0,3,4,0,Matches,2022-2023,Serie-A
Alexis Blin,fr FRA,MF,Lecce,25.0,1996.0,26.4,69,39,27,33,9,38,73,52.1,35,55,15,40,34,103,74,0,Matches,2022-2023,Serie-A
Jeremie Boga,ci CIV,"MF,FW",Atalanta,25.0,1997.0,8.7,9,5,3,2,4,2,5,40.0,3,6,0,6,1,10,1,0,Matches,2022-2023,Serie-A
Emil Bohinen,no NOR,MF,Salernitana,23.0,1999.0,9.2,25,13,15,8,2,12,23,52.2,11,25,7,18,17,42,21,0,Matches,2022-2023,Serie-A
Giacomo Bonaventura,it ITA,MF,Fiorentina,32.0,1989.0,21.2,35,23,14,15,6,24,37,64.9,13,14,0,14,16,51,5,1,Matches,2022-2023,Serie-A
Federico Bonazzoli,it ITA,"FW,MF",Salernitana,25.0,1997.0,12.4,5,3,0,3,2,0,9,0.0,9,9,1,8,3,8,0,0,Matches,2022-2023,Serie-A
Warren Bondo,fr FRA,MF,Monza,18.0,2003.0,0.7,1,0,1,0,0,0,0,,0,1,0,1,0,1,0,0,Matches,2022-2023,Serie-A
Kevin Bonifazi,it ITA,DF,Bologna,26.0,1996.0,10.0,13,8,7,6,0,6,12,50.0,6,11,8,3,12,25,39,0,Matches,2022-2023,Serie-A
Leonardo Bonucci,it ITA,DF,Juventus,35.0,1987.0,9.8,5,4,1,4,0,2,4,50.0,2,12,8,4,13,18,29,0,Matches,2022-2023,Serie-A
Erik Botheim,no NOR,"MF,FW",Salernitana,22.0,2000.0,9.6,11,7,3,4,4,6,13,46.2,7,3,0,3,0,11,4,0,Matches,2022-2023,Serie-A
Mehdi Bourabia,ma MAR,MF,Spezia,30.0,1991.0,30.8,41,20,13,22,6,19,41,46.3,22,39,12,27,32,73,57,0,Matches,2022-2023,Serie-A
Edoardo Bove,it ITA,MF,Roma,20.0,2002.0,11.0,35,18,12,15,8,16,39,41.0,23,15,1,14,10,45,11,0,Matches,2022-2023,Serie-A
Jayden Braaf,nl NED,"MF,FW",Hellas Verona,19.0,2002.0,3.2,5,3,2,3,0,0,0,,0,1,0,1,2,7,1,0,Matches,2022-2023,Serie-A
Domagoj Bradarić,hr CRO,DF,Salernitana,22.0,1999.0,25.0,26,19,14,8,4,7,16,43.8,9,20,5,15,21,47,44,0,Matches,2022-2023,Serie-A
Josip Brekalo,hr CRO,"FW,MF",Fiorentina,24.0,1998.0,2.5,2,1,0,1,1,1,4,25.0,3,1,0,1,1,3,1,0,Matches,2022-2023,Serie-A
Gleison Bremer,br BRA,DF,Juventus,25.0,1997.0,29.3,29,20,23,5,1,19,26,73.1,7,44,22,22,42,71,120,2,Matches,2022-2023,Serie-A
Dylan Bronn,tn TUN,DF,Salernitana,27.0,1995.0,18.7,34,18,17,16,1,20,30,66.7,10,32,20,12,20,54,58,1,Matches,2022-2023,Serie-A
Marcelo Brozović,hr CRO,MF,Inter,29.0,1992.0,19.7,37,22,13,22,2,11,37,29.7,26,23,7,16,22,59,28,0,Matches,2022-2023,Serie-A
Cristian Buonaiuto,it ITA,"MF,FW",Cremonese,29.0,1992.0,10.9,25,16,8,11,6,12,26,46.2,14,11,0,11,14,39,7,0,Matches,2022-2023,Serie-A
Alessandro Buongiorno,it ITA,DF,Torino,23.0,1999.0,30.2,38,25,22,16,0,16,31,51.6,15,38,19,19,60,98,105,2,Matches,2022-2023,Serie-A
Leonardo Buta,pt POR,DF,Udinese,20.0,2002.0,0.2,1,1,0,1,0,0,0,,0,0,0,0,0,1,0,0,Matches,2022-2023,Serie-A
Arthur Cabral,br BRA,FW,Fiorentina,24.0,1998.0,15.9,9,2,1,4,4,4,8,50.0,4,10,1,9,1,10,12,0,Matches,2022-2023,Serie-A
Liberato Cacace,nz NZL,DF,Empoli,21.0,2000.0,6.5,25,10,12,8,5,9,15,60.0,6,15,7,8,4,29,16,0,Matches,2022-2023,Serie-A
Davide Calabria,it ITA,DF,Milan,25.0,1996.0,18.8,71,44,31,32,8,38,61,62.3,23,22,7,15,25,96,34,0,Matches,2022-2023,Serie-A
Mattia Caldara,it ITA,DF,Spezia,28.0,1994.0,13.9,23,14,10,11,2,9,20,45.0,11,23,16,7,17,40,88,2,Matches,2022-2023,Serie-A
Luca Caldirola,it ITA,DF,Monza,31.0,1991.0,26.1,26,14,19,4,3,13,26,50.0,13,32,18,14,25,51,66,1,Matches,2022-2023,Serie-A
Hakan Çalhanoğlu,tr TUR,MF,Inter,28.0,1994.0,26.3,48,27,17,26,5,16,43,37.2,27,30,5,25,25,73,13,1,Matches,2022-2023,Serie-A
Mohamed Camara,gn GUI,MF,Roma,25.0,1997.0,7.7,13,10,3,7,3,5,15,33.3,10,5,1,4,10,23,8,0,Matches,2022-2023,Serie-A
Nicolò Cambiaghi,it ITA,"FW,MF",Empoli,21.0,2000.0,14.3,30,22,11,12,7,8,27,29.6,19,19,1,18,9,39,8,0,Matches,2022-2023,Serie-A
Andrea Cambiaso,it ITA,DF,Bologna,22.0,2000.0,24.1,57,34,34,20,3,28,65,43.1,37,26,2,24,26,83,33,1,Matches,2022-2023,Serie-A
Matteo Cancellieri,it ITA,FW,Lazio,20.0,2002.0,2.8,10,4,5,3,2,5,9,55.6,4,4,0,4,1,11,2,0,Matches,2022-2023,Serie-A
Antonio Candreva,it ITA,"MF,DF",Salernitana,35.0,1987.0,30.3,17,7,13,2,2,11,38,28.9,27,7,3,4,17,34,32,0,Matches,2022-2023,Serie-A
Gianluca Caprari,it ITA,"MF,FW",Monza,29.0,1993.0,27.1,16,6,3,11,2,8,26,30.8,18,22,1,21,8,24,3,0,Matches,2022-2023,Serie-A
Francesco Caputo,it ITA,FW,Sampdoria,34.0,1987.0,12.2,3,1,0,0,3,0,3,0.0,3,0,0,0,1,4,3,0,Matches,2022-2023,Serie-A
Francesco Caputo,it ITA,FW,Empoli,34.0,1987.0,19.0,2,2,0,1,1,0,1,0.0,1,7,2,5,2,4,8,0,Matches,2022-2023,Serie-A
Andrea Carboni,it ITA,DF,Monza,21.0,2001.0,1.9,3,2,2,0,1,2,5,40.0,3,3,2,1,3,6,2,1,Matches,2022-2023,Serie-A
Franco Carboni,it ITA,"DF,FW",Monza,19.0,2003.0,0.7,1,1,1,0,0,0,2,0.0,2,3,0,3,1,2,0,0,Matches,2022-2023,Serie-A
Valentin Carboni,ar ARG,"MF,DF",Inter,17.0,2005.0,0.3,1,1,0,1,0,1,3,33.3,2,1,0,1,0,1,0,0,Matches,2022-2023,Serie-A
Marco Carnesecchi,it ITA,GK,Cremonese,22.0,2000.0,27.0,1,1,1,0,0,1,2,50.0,1,0,0,0,0,1,11,2,Matches,2022-2023,Serie-A
Nicolò Casale,it ITA,DF,Lazio,24.0,1998.0,27.1,42,20,28,14,0,22,34,64.7,12,25,17,8,17,59,73,1,Matches,2022-2023,Serie-A
Tommaso Cassandro,it ITA,DF,Lecce,22.0,2000.0,0.1,1,1,0,1,0,0,0,,0,1,1,0,0,1,0,0,Matches,2022-2023,Serie-A
Michele Castagnetti,it ITA,MF,Cremonese,32.0,1989.0,15.7,46,21,20,24,2,18,54,33.3,36,14,4,10,15,61,22,0,Matches,2022-2023,Serie-A
Gaetano Castrovilli,it ITA,MF,Fiorentina,25.0,1997.0,8.0,10,8,1,7,2,2,9,22.2,7,5,1,4,8,18,5,0,Matches,2022-2023,Serie-A
Danilo Cataldi,it ITA,MF,Lazio,27.0,1994.0,21.3,25,16,7,15,3,14,40,35.0,26,23,9,14,24,49,33,0,Matches,2022-2023,Serie-A
Pietro Ceccaroni,it ITA,DF,Lecce,26.0,1995.0,0.5,0,0,0,0,0,0,0,,0,1,1,0,3,3,2,0,Matches,2022-2023,Serie-A
Federico Ceccherini,it ITA,DF,Hellas Verona,30.0,1992.0,15.7,25,19,15,9,1,13,23,56.5,10,17,10,7,19,44,55,0,Matches,2022-2023,Serie-A
Assan Ceesay,gm GAM,FW,Lecce,28.0,1994.0,20.1,23,18,7,8,8,9,17,52.9,8,15,2,13,3,26,24,0,Matches,2022-2023,Serie-A
Emil Ceide,no NOR,FW,Sassuolo,20.0,2001.0,5.7,5,2,5,0,0,3,5,60.0,2,3,1,2,1,6,0,0,Matches,2022-2023,Serie-A
Zeki Çelik,tr TUR,DF,Roma,25.0,1997.0,16.7,42,21,19,21,2,24,41,58.5,17,33,6,27,14,56,36,2,Matches,2022-2023,Serie-A
Michele Cerofolini,it ITA,GK,Fiorentina,23.0,1999.0,5.0,0,0,0,0,0,0,0,,0,0,0,0,1,1,2,0,Matches,2022-2023,Serie-A
Federico Chiesa,it ITA,"DF,MF",Juventus,24.0,1997.0,9.5,22,11,6,6,10,5,14,35.7,9,13,1,12,0,22,1,0,Matches,2022-2023,Serie-A
Vlad Chiricheș,ro ROU,DF,Cremonese,32.0,1989.0,10.9,35,20,27,7,1,16,24,66.7,8,36,23,13,22,57,44,0,Matches,2022-2023,Serie-A
Daniel Ciofani,it ITA,FW,Cremonese,37.0,1985.0,11.8,6,3,1,2,3,4,7,57.1,3,7,1,6,2,8,10,0,Matches,2022-2023,Serie-A
Tio Cipot,si SVN,"FW,MF",Spezia,19.0,2003.0,1.5,12,7,6,3,3,6,8,75.0,2,0,0,0,0,12,2,0,Matches,2022-2023,Serie-A
Patrick Ciurria,it ITA,"DF,MF",Monza,27.0,1995.0,30.6,31,18,20,10,1,17,33,51.5,16,24,2,22,7,38,32,0,Matches,2022-2023,Serie-A
Nicolò Cocetta,it ITA,DF,Udinese,18.0,2003.0,0.4,0,0,0,0,0,0,1,0.0,1,1,1,0,1,1,1,0,Matches,2022-2023,Serie-A
Omar Colley,gm GAM,DF,Sampdoria,29.0,1992.0,15.4,17,10,10,7,0,9,12,75.0,3,9,5,4,22,39,69,1,Matches,2022-2023,Serie-A
Lorenzo Colombo,it ITA,FW,Lecce,20.0,2002.0,16.8,17,9,1,9,7,6,14,42.9,8,22,0,22,2,19,7,0,Matches,2022-2023,Serie-A
Andrea Colpani,it ITA,MF,Monza,23.0,1999.0,10.5,14,9,6,5,3,8,12,66.7,4,14,2,12,3,17,6,0,Matches,2022-2023,Serie-A
Andrea Consigli,it ITA,GK,Sassuolo,35.0,1987.0,35.0,1,0,1,0,0,0,1,0.0,1,0,0,0,0,1,13,3,Matches,2022-2023,Serie-A
Andrea Conti,it ITA,DF,Sampdoria,28.0,1994.0,0.3,0,0,0,0,0,0,0,,0,0,0,0,0,0,0,0,Matches,2022-2023,Serie-A
Diego Coppola,it ITA,DF,Hellas Verona,18.0,2003.0,13.1,25,17,15,10,0,11,24,45.8,13,20,6,14,14,39,38,0,Matches,2022-2023,Serie-A
Alex Cordaz,it ITA,GK,Inter,39.0,1983.0,0.3,0,0,0,0,0,0,0,,0,0,0,0,0,0,0,0,Matches,2022-2023,Serie-A
Joaquín Correa,ar ARG,FW,Inter,27.0,1994.0,10.6,12,7,3,6,3,4,15,26.7,11,4,1,3,3,15,0,0,Matches,2022-2023,Serie-A
Alessandro Cortinovis,it ITA,MF,Hellas Verona,21.0,2001.0,0.1,1,0,1,0,0,0,0,,0,1,0,1,0,1,0,0,Matches,2022-2023,Serie-A
Lassana Coulibaly,ml MLI,MF,Salernitana,26.0,1996.0,32.1,84,50,42,35,7,30,73,41.1,43,35,7,28,25,109,33,2,Matches,2022-2023,Serie-A
Alessio Cragno,it ITA,GK,Monza,28.0,1994.0,1.0,0,0,0,0,0,0,1,0.0,1,0,0,0,0,0,0,0,Matches,2022-2023,Serie-A
Bryan Cristante,it ITA,"MF,DF",Roma,27.0,1995.0,32.6,113,62,55,49,9,55,90,61.1,35,39,10,29,18,131,53,0,Matches,2022-2023,Serie-A
Domen Črnigoj,si SVN,MF,Salernitana,26.0,1995.0,3.3,8,3,0,7,1,1,2,50.0,1,9,1,8,9,17,6,0,Matches,2022-2023,Serie-A
Juan Cuadrado,co COL,"DF,FW",Juventus,34.0,1988.0,23.1,50,34,34,13,3,27,65,41.5,38,15,2,13,24,74,32,0,Matches,2022-2023,Serie-A
Mickaël Cuisance,fr FRA,MF,Sampdoria,22.0,1999.0,6.9,13,10,7,5,1,5,23,21.7,18,10,0,10,5,18,4,0,Matches,2022-2023,Serie-A
Marco D'Alessandro,it ITA,"DF,FW",Monza,31.0,1991.0,3.2,4,4,3,1,0,2,5,40.0,3,2,0,2,1,5,3,0,Matches,2022-2023,Serie-A
Danilo D'Ambrosio,it ITA,DF,Inter,33.0,1988.0,8.1,25,17,17,7,1,15,27,55.6,12,12,4,8,10,35,17,0,Matches,2022-2023,Serie-A
Luca D'Andrea,it ITA,FW,Sassuolo,17.0,2004.0,3.5,4,0,2,1,1,1,4,25.0,3,2,0,2,1,5,1,0,Matches,2022-2023,Serie-A
Flavius Daniliuc,at AUT,DF,Salernitana,21.0,2001.0,24.4,57,29,37,17,3,26,47,55.3,21,30,13,17,29,86,76,0,Matches,2022-2023,Serie-A
Danilo,br BRA,DF,Juventus,31.0,1991.0,35.4,92,62,61,23,8,52,73,71.2,21,39,20,19,47,139,114,1,Matches,2022-2023,Serie-A
Matteo Darmian,it ITA,DF,Inter,32.0,1989.0,22.5,56,30,29,15,12,31,47,66.0,16,33,5,28,21,77,36,0,Matches,2022-2023,Serie-A
Juan David Cabal,co COL,DF,Hellas Verona,21.0,2001.0,4.9,10,6,7,3,0,7,12,58.3,5,8,5,3,13,23,12,0,Matches,2022-2023,Serie-A
Paweł Dawidowicz,pl POL,DF,Hellas Verona,27.0,1995.0,18.1,48,31,28,17,3,22,31,71.0,9,14,9,5,23,71,71,0,Matches,2022-2023,Serie-A
Charles De Ketelaere,be BEL,"MF,FW",Milan,21.0,2001.0,12.4,26,12,7,14,5,13,30,43.3,17,14,2,12,4,30,9,0,Matches,2022-2023,Serie-A
Manuel De Luca,it ITA,"FW,MF",Sampdoria,24.0,1998.0,0.5,0,0,0,0,0,0,0,,0,0,0,0,0,0,0,0,Matches,2022-2023,Serie-A
Tommaso De Nipoti,it ITA,MF,Atalanta,19.0,2003.0,0.0,1,0,0,1,0,0,0,,0,0,0,0,0,1,0,0,Matches,2022-2023,Serie-A
Mattia De Sciglio,it ITA,DF,Juventus,29.0,1992.0,11.6,14,7,8,3,3,9,14,64.3,5,9,3,6,4,18,20,0,Matches,2022-2023,Serie-A
Lorenzo De Silvestri,it ITA,DF,Bologna,34.0,1988.0,7.5,3,2,2,0,1,3,7,42.9,4,6,5,1,3,6,20,0,Matches,2022-2023,Serie-A
Koni De Winter,be BEL,DF,Empoli,20.0,2002.0,11.4,14,9,11,3,0,5,13,38.5,8,14,12,2,6,20,65,0,Matches,2022-2023,Serie-A
Grégoire Defrel,mq MTQ,FW,Sassuolo,31.0,1991.0,13.0,9,7,5,2,2,4,13,30.8,9,11,0,11,2,11,5,0,Matches,2022-2023,Serie-A
Duccio Degl'Innocenti,it ITA,MF,Empoli,19.0,2003.0,0.0,0,0,0,0,0,0,0,,0,0,0,0,1,1,0,0,Matches,2022-2023,Serie-A
Merih Demiral,tr TUR,DF,Atalanta,24.0,1998.0,17.1,41,29,30,11,0,26,36,72.2,10,24,7,17,24,65,57,1,Matches,2022-2023,Serie-A
Diego Demme,de GER,MF,Napoli,30.0,1991.0,1.6,1,0,1,0,0,0,4,0.0,4,2,0,2,0,1,1,0,Matches,2022-2023,Serie-A
Fabio Depaoli,it ITA,DF,Hellas Verona,25.0,1997.0,24.1,48,28,25,16,7,25,44,56.8,19,32,6,26,18,66,33,3,Matches,2022-2023,Serie-A
Fabio Depaoli,it ITA,"DF,MF",Sampdoria,25.0,1997.0,1.5,5,3,2,3,0,3,4,75.0,1,1,0,1,1,6,4,0,Matches,2022-2023,Serie-A
Kastriot Dermaku,al ALB,DF,Lecce,30.0,1992.0,0.4,0,0,0,0,0,0,0,,0,0,0,0,0,0,0,0,Matches,2022-2023,Serie-A
Cyriel Dessers,ng NGA,FW,Cremonese,27.0,1994.0,17.6,11,4,4,4,3,2,6,33.3,4,14,2,12,3,14,5,0,Matches,2022-2023,Serie-A
Sergiño Dest,us USA,DF,Milan,21.0,2000.0,3.7,12,6,3,5,4,3,4,75.0,1,1,0,1,4,16,2,0,Matches,2022-2023,Serie-A
Mattia Destro,it ITA,"FW,MF",Empoli,31.0,1991.0,6.4,1,1,0,1,0,0,0,,0,2,0,2,1,2,5,0,Matches,2022-2023,Serie-A
Gerard Deulofeu,es ESP,FW,Udinese,28.0,1994.0,13.5,8,5,5,1,2,5,15,33.3,10,8,1,7,2,10,1,0,Matches,2022-2023,Serie-A
Samuel Di Carmine,it ITA,"FW,MF",Cremonese,33.0,1988.0,0.3,0,0,0,0,0,0,0,,0,0,0,0,0,0,0,0,Matches,2022-2023,Serie-A
Federico Di Francesco,it ITA,"FW,MF",Lecce,28.0,1994.0,22.6,28,16,7,11,10,9,19,47.4,10,16,0,16,8,36,14,0,Matches,2022-2023,Serie-A
Michele Di Gregorio,it ITA,GK,Monza,25.0,1997.0,37.0,0,0,0,0,0,0,3,0.0,3,1,0,1,4,4,18,3,Matches,2022-2023,Serie-A
Giovanni Di Lorenzo,it ITA,DF,Napoli,28.0,1993.0,36.2,60,29,33,19,8,25,49,51.0,24,30,9,21,30,90,60,0,Matches,2022-2023,Serie-A
Ángel Di María,ar ARG,"FW,MF",Juventus,34.0,1988.0,15.1,10,5,3,5,2,3,19,15.8,16,15,0,15,7,17,0,0,Matches,2022-2023,Serie-A
Boulaye Dia,sn SEN,"FW,MF",Salernitana,25.0,1996.0,28.0,12,5,3,6,3,2,7,28.6,5,10,0,10,7,19,27,1,Matches,2022-2023,Serie-A
Brahim Díaz,ma MAR,"MF,FW",Milan,22.0,1999.0,21.4,32,15,5,22,5,5,15,33.3,10,11,0,11,7,39,6,0,Matches,2022-2023,Serie-A
Federico Dimarco,it ITA,DF,Inter,24.0,1997.0,23.0,31,25,6,18,7,9,19,47.4,10,15,4,11,18,49,20,0,Matches,2022-2023,Serie-A
Koffi Djidji,ci CIV,DF,Torino,29.0,1992.0,26.9,50,25,32,17,1,18,32,56.3,14,29,14,15,34,84,72,0,Matches,2022-2023,Serie-A
Berat Djimsiti,al ALB,DF,Atalanta,29.0,1993.0,20.0,34,19,21,13,0,17,25,68.0,8,17,7,10,36,70,74,1,Matches,2022-2023,Serie-A
Dodô,br BRA,DF,Fiorentina,23.0,1998.0,25.9,40,22,20,14,6,22,46,47.8,24,26,2,24,25,65,37,0,Matches,2022-2023,Serie-A
Josh Doig,sct SCO,DF,Hellas Verona,20.0,2002.0,15.0,19,8,6,7,6,6,16,37.5,10,25,6,19,11,30,13,1,Matches,2022-2023,Serie-A
Nicolás Domínguez,ar ARG,MF,Bologna,24.0,1998.0,25.6,79,49,34,33,12,39,76,51.3,37,29,3,26,21,100,29,1,Matches,2022-2023,Serie-A
Giulio Donati,it ITA,DF,Monza,32.0,1990.0,4.7,4,1,1,1,2,3,6,50.0,3,3,1,2,4,8,11,0,Matches,2022-2023,Serie-A
Bartłomiej Drągowski,pl POL,GK,Spezia,24.0,1997.0,32.7,1,0,1,0,0,1,5,20.0,4,0,0,0,1,2,15,3,Matches,2022-2023,Serie-A
Ondrej Duda,sk SVK,MF,Hellas Verona,27.0,1994.0,11.8,22,14,7,12,3,9,16,56.3,7,11,0,11,13,35,8,0,Matches,2022-2023,Serie-A
Denzel Dumfries,nl NED,DF,Inter,26.0,1996.0,24.6,35,18,17,13,5,22,34,64.7,12,33,9,24,12,47,26,0,Matches,2022-2023,Serie-A
Alfred Duncan,gh GHA,MF,Fiorentina,29.0,1993.0,12.3,18,10,0,17,1,10,21,47.6,11,9,0,9,8,26,6,0,Matches,2022-2023,Serie-A
Paulo Dybala,ar ARG,"MF,FW",Roma,28.0,1993.0,19.3,14,4,1,8,5,8,26,30.8,18,12,1,11,8,22,4,0,Matches,2022-2023,Serie-A
Edin Džeko,ba BIH,FW,Inter,36.0,1986.0,19.2,3,2,0,3,0,0,4,0.0,4,15,1,14,3,6,25,0,Matches,2022-2023,Serie-A
Festy Ebosele,ie IRL,DF,Udinese,19.0,2002.0,4.6,15,10,8,7,0,4,10,40.0,6,5,0,5,2,17,5,0,Matches,2022-2023,Serie-A
Enzo Ebosse,cm CMR,DF,Udinese,23.0,1999.0,10.3,15,9,11,4,0,9,13,69.2,4,27,6,21,11,26,29,0,Matches,2022-2023,Serie-A
Tyronne Ebuehi,ng NGA,DF,Empoli,26.0,1995.0,21.4,22,14,11,7,4,9,13,69.2,4,23,12,11,12,34,79,1,Matches,2022-2023,Serie-A
Éderson,br BRA,MF,Atalanta,23.0,1999.0,24.6,67,34,18,42,7,29,66,43.9,37,56,7,49,36,103,31,0,Matches,2022-2023,Serie-A
Kingsley Ehizibue,nl NED,DF,Udinese,27.0,1995.0,17.1,47,31,28,13,6,29,45,64.4,16,21,3,18,10,57,42,1,Matches,2022-2023,Serie-A
Albin Ekdal,se SWE,MF,Spezia,33.0,1989.0,19.3,37,20,14,20,3,19,45,42.2,26,24,2,22,26,63,36,0,Matches,2022-2023,Serie-A
Emmanuel Ekong,se SWE,"FW,MF",Empoli,20.0,2002.0,0.2,0,0,0,0,0,0,0,,0,0,0,0,0,0,0,0,Matches,2022-2023,Serie-A
Mikael Ellertsson,is ISL,"MF,DF",Spezia,20.0,2002.0,1.9,4,2,1,3,0,0,3,0.0,3,2,1,1,2,6,0,0,Matches,2022-2023,Serie-A
Elif Elmas,mk MKD,"FW,MF",Napoli,22.0,1999.0,18.1,24,13,8,12,4,11,23,47.8,12,18,2,16,11,35,5,0,Matches,2022-2023,Serie-A
Martin Erlic,hr CRO,DF,Sassuolo,24.0,1998.0,25.9,27,16,18,8,1,10,23,43.5,13,36,23,13,31,58,120,1,Matches,2022-2023,Serie-A
Gonzalo Escalante,ar ARG,MF,Cremonese,29.0,1993.0,6.2,16,8,8,8,0,10,13,76.9,3,7,1,6,10,26,4,0,Matches,2022-2023,Serie-A
Salvatore Esposito,it ITA,MF,Spezia,21.0,2000.0,10.8,15,12,8,5,2,5,21,23.8,16,9,1,8,11,26,18,0,Matches,2022-2023,Serie-A
Nicolò Fagioli,it ITA,MF,Juventus,21.0,2001.0,16.9,29,19,12,15,2,8,27,29.6,19,16,2,14,8,37,7,1,Matches,2022-2023,Serie-A
Wladimiro Falcone,it ITA,GK,Lecce,27.0,1995.0,38.0,2,0,2,0,0,2,2,100.0,0,0,0,0,2,4,21,3,Matches,2022-2023,Serie-A
Davide Faraoni,it ITA,DF,Hellas Verona,30.0,1991.0,16.5,34,24,19,13,2,16,41,39.0,25,30,11,19,15,49,37,0,Matches,2022-2023,Serie-A
Federico Fazio,ar ARG,DF,Salernitana,35.0,1987.0,11.9,15,12,8,7,0,4,11,36.4,7,9,4,5,28,43,61,0,Matches,2022-2023,Serie-A
Jacopo Fazzini,it ITA,MF,Empoli,19.0,2003.0,9.2,31,17,20,8,3,18,34,52.9,16,15,3,12,7,38,19,0,Matches,2022-2023,Serie-A
Lewis Ferguson,sct SCO,"MF,FW",Bologna,22.0,1999.0,25.7,44,25,16,20,8,20,40,50.0,20,22,7,15,19,63,25,0,Matches,2022-2023,Serie-A
Alex Ferrari,it ITA,DF,Sampdoria,28.0,1994.0,9.6,9,5,7,2,0,4,8,50.0,4,21,10,11,19,28,25,0,Matches,2022-2023,Serie-A
Alex Ferrari,it ITA,DF,Cremonese,28.0,1994.0,11.2,40,23,32,7,1,28,42,66.7,14,19,4,15,25,65,45,1,Matches,2022-2023,Serie-A
Salvador Ferrer,es ESP,DF,Spezia,24.0,1998.0,1.5,4,2,2,2,0,1,3,33.3,2,3,1,2,1,5,4,0,Matches,2022-2023,Serie-A
Vincenzo Fiorillo,it ITA,GK,Salernitana,32.0,1990.0,1.0,0,0,0,0,0,0,0,,0,0,0,0,0,0,0,0,Matches,2022-2023,Serie-A
Alessandro Florenzi,it ITA,DF,Milan,31.0,1991.0,2.3,6,4,3,2,1,4,7,57.1,3,1,0,1,4,10,2,0,Matches,2022-2023,Serie-A
Davide Frattesi,it ITA,MF,Sassuolo,22.0,1999.0,31.9,63,36,24,29,10,25,44,56.8,19,27,6,21,16,79,42,0,Matches,2022-2023,Serie-A
Matteo Gabbia,it ITA,DF,Milan,22.0,1999.0,6.8,17,10,12,5,0,6,8,75.0,2,8,3,5,5,22,29,0,Matches,2022-2023,Serie-A
Manolo Gabbiadini,it ITA,"FW,MF",Sampdoria,30.0,1991.0,26.2,23,15,8,9,6,9,23,39.1,14,16,2,14,6,29,25,0,Matches,2022-2023,Serie-A
Gianluca Gaetano,it ITA,MF,Napoli,22.0,2000.0,0.8,5,3,1,3,1,0,0,,0,1,0,1,1,6,0,0,Matches,2022-2023,Serie-A
Roberto Gagliardini,it ITA,MF,Inter,28.0,1994.0,8.7,16,6,9,6,1,10,21,47.6,11,14,5,9,4,20,15,0,Matches,2022-2023,Serie-A
Adolfo Gaich,ar ARG,FW,Hellas Verona,23.0,1999.0,8.1,5,3,0,3,2,1,6,16.7,5,7,2,5,3,8,7,1,Matches,2022-2023,Serie-A
Pablo Galdames Millán,cl CHI,MF,Cremonese,25.0,1996.0,8.2,14,10,8,3,3,5,33,15.2,28,13,2,11,10,24,13,0,Matches,2022-2023,Serie-A
Antonino Gallo,it ITA,DF,Lecce,22.0,2000.0,27.6,56,36,35,12,9,38,57,66.7,19,37,6,31,13,69,71,0,Matches,2022-2023,Serie-A
Federico Gatti,it ITA,DF,Juventus,24.0,1998.0,16.1,15,11,9,4,2,9,15,60.0,6,20,14,6,21,36,54,2,Matches,2022-2023,Serie-A
Valentin Gendrey,fr FRA,DF,Lecce,22.0,2000.0,34.5,88,57,54,25,9,40,71,56.3,31,45,4,41,37,125,89,0,Matches,2022-2023,Serie-A
Paolo Ghiglione,it ITA,DF,Cremonese,25.0,1997.0,7.9,16,11,10,3,3,10,23,43.5,13,9,4,5,4,20,12,0,Matches,2022-2023,Serie-A
Mario Gila,es ESP,DF,Lazio,21.0,2000.0,1.0,3,1,3,0,0,0,1,0.0,1,0,0,0,3,6,3,0,Matches,2022-2023,Serie-A
Gvidas Gineitis,lt LTU,MF,Torino,18.0,2004.0,1.5,3,1,0,2,1,1,2,50.0,1,0,0,0,0,3,1,0,Matches,2022-2023,Serie-A
Olivier Giroud,fr FRA,FW,Milan,35.0,1986.0,23.8,8,5,2,4,2,2,10,20.0,8,11,3,8,3,11,23,0,Matches,2022-2023,Serie-A
Pierluigi Gollini,it ITA,GK,Fiorentina,27.0,1995.0,3.0,1,0,1,0,0,1,1,100.0,0,0,0,0,0,1,2,0,Matches,2022-2023,Serie-A
Pierluigi Gollini,it ITA,GK,Napoli,27.0,1995.0,4.0,0,0,0,0,0,0,0,,0,0,0,0,0,0,1,0,Matches,2022-2023,Serie-A
Joan Gonzàlez,es ESP,MF,Lecce,20.0,2002.0,24.4,48,28,20,18,10,17,51,33.3,34,37,8,29,16,64,28,0,Matches,2022-2023,Serie-A
Nicolás González,ar ARG,"FW,MF",Fiorentina,24.0,1998.0,15.0,17,10,3,10,4,5,16,31.3,11,14,0,14,4,21,6,0,Matches,2022-2023,Serie-A
Robin Gosens,de GER,DF,Inter,28.0,1994.0,13.2,34,18,15,10,9,15,25,60.0,10,16,2,14,23,57,15,0,Matches,2022-2023,Serie-A
Alberto Grassi,it ITA,MF,Empoli,27.0,1995.0,13.3,26,21,13,13,0,15,24,62.5,9,23,12,11,27,53,45,0,Matches,2022-2023,Serie-A
Andrew Gravillon,gp GLP,DF,Torino,24.0,1998.0,3.5,3,3,0,3,0,0,0,,0,4,2,2,9,12,16,0,Matches,2022-2023,Serie-A
Axel Guessand,fr FRA,DF,Udinese,17.0,2004.0,0.9,2,1,2,0,0,1,2,50.0,1,1,0,1,2,4,3,0,Matches,2022-2023,Serie-A
Koray Günter,de GER,DF,Hellas Verona,27.0,1994.0,11.1,10,6,1,8,1,4,7,57.1,3,24,15,9,30,40,46,0,Matches,2022-2023,Serie-A
Koray Günter,de GER,DF,Sampdoria,27.0,1994.0,8.6,10,8,6,4,0,6,9,66.7,3,10,5,5,11,21,46,0,Matches,2022-2023,Serie-A
Emmanuel Gyasi,gh GHA,"FW,DF",Spezia,28.0,1994.0,31.2,24,15,11,10,3,9,36,25.0,27,24,6,18,8,32,26,0,Matches,2022-2023,Serie-A
Norbert Gyömbér,sk SVK,DF,Salernitana,30.0,1992.0,19.3,32,23,25,6,1,16,24,66.7,8,33,22,11,35,67,92,0,Matches,2022-2023,Serie-A
Christian Gytkjær,dk DEN,"FW,MF",Monza,32.0,1990.0,6.2,6,2,1,4,1,2,5,40.0,3,6,1,5,0,6,2,0,Matches,2022-2023,Serie-A
Nicolas Haas,ch SUI,MF,Empoli,26.0,1996.0,12.8,27,13,16,6,5,12,24,50.0,12,16,4,12,8,35,27,0,Matches,2022-2023,Serie-A
Samir Handanović,si SVN,GK,Inter,38.0,1984.0,13.7,0,0,0,0,0,0,0,,0,0,0,0,0,0,5,0,Matches,2022-2023,Serie-A
Abdou Harroui,nl NED,MF,Sassuolo,24.0,1998.0,7.2,17,6,6,7,4,2,7,28.6,5,6,1,5,2,19,10,0,Matches,2022-2023,Serie-A
Hans Hateboer,nl NED,DF,Atalanta,28.0,1994.0,15.5,21,13,11,8,2,11,27,40.7,16,23,4,19,12,33,25,0,Matches,2022-2023,Serie-A
Liam Henderson,sct SCO,MF,Empoli,26.0,1996.0,11.2,13,10,6,5,2,4,21,19.0,17,10,2,8,10,23,10,0,Matches,2022-2023,Serie-A
Jack Hendry,sct SCO,DF,Cremonese,27.0,1995.0,2.4,0,0,0,0,0,0,1,0.0,1,2,1,1,1,1,7,0,Matches,2022-2023,Serie-A
Matheus Henrique,br BRA,MF,Sassuolo,24.0,1997.0,21.6,26,12,9,11,6,12,24,50.0,12,15,4,11,12,38,10,0,Matches,2022-2023,Serie-A
Thomas Henry,fr FRA,FW,Hellas Verona,27.0,1994.0,11.4,5,3,1,1,3,1,5,20.0,4,6,2,4,0,5,14,0,Matches,2022-2023,Serie-A
Theo Hernández,fr FRA,DF,Milan,24.0,1997.0,30.8,43,24,27,15,1,22,38,57.9,16,34,7,27,21,64,35,1,Matches,2022-2023,Serie-A
Isak Hien,se SWE,DF,Hellas Verona,23.0,1999.0,29.0,73,36,54,19,0,38,61,62.3,23,40,17,23,31,104,92,1,Matches,2022-2023,Serie-A
Morten Hjulmand,dk DEN,MF,Lecce,23.0,1999.0,32.9,90,52,49,40,1,37,67,55.2,30,43,11,32,72,162,54,0,Matches,2022-2023,Serie-A
Emil Holm,se SWE,DF,Spezia,22.0,2000.0,15.5,26,15,13,8,5,16,31,51.6,15,21,6,15,9,35,41,0,Matches,2022-2023,Serie-A
Martin Hongla,cm CMR,MF,Hellas Verona,24.0,1998.0,5.8,8,5,4,4,0,5,5,100.0,0,7,1,6,6,14,9,0,Matches,2022-2023,Serie-A
Petko Hristov,bg BUL,DF,Spezia,23.0,1999.0,4.1,6,4,2,4,0,5,8,62.5,3,4,2,2,4,10,12,0,Matches,2022-2023,Serie-A
Ajdin Hrustic,au AUS,MF,Hellas Verona,26.0,1996.0,2.5,2,1,1,1,0,1,2,50.0,1,2,0,2,0,2,2,1,Matches,2022-2023,Serie-A
Elseid Hysaj,al ALB,DF,Lazio,28.0,1994.0,22.2,39,23,24,11,4,23,41,56.1,18,31,7,24,20,59,42,0,Matches,2022-2023,Serie-A
Rasmus Højlund,dk DEN,FW,Atalanta,19.0,2003.0,20.4,4,3,0,2,2,1,6,16.7,5,9,1,8,1,5,5,0,Matches,2022-2023,Serie-A
Roger Ibanez,br BRA,DF,Roma,23.0,1998.0,31.1,67,33,38,26,3,32,48,66.7,16,30,11,19,66,133,95,2,Matches,2022-2023,Serie-A
Zlatan Ibrahimović,se SWE,FW,Milan,40.0,1981.0,1.6,0,0,0,0,0,0,0,,0,1,1,0,0,0,2,0,Matches,2022-2023,Serie-A
Antonio Iervolino,it ITA,MF,Salernitana,19.0,2003.0,0.1,0,0,0,0,0,0,1,0.0,1,0,0,0,0,0,0,0,Matches,2022-2023,Serie-A
Igor,br BRA,DF,Fiorentina,24.0,1998.0,22.9,43,29,21,18,4,20,27,74.1,7,33,14,19,25,68,56,2,Matches,2022-2023,Serie-A
Jonathan Ikone,fr FRA,FW,Fiorentina,24.0,1998.0,22.3,16,8,5,6,5,5,14,35.7,9,18,1,17,4,20,3,0,Matches,2022-2023,Serie-A
Ivan Ilić,rs SRB,MF,Hellas Verona,21.0,2001.0,9.5,16,10,9,7,0,6,11,54.5,5,10,1,9,8,24,14,0,Matches,2022-2023,Serie-A
Ivan Ilić,rs SRB,MF,Torino,21.0,2001.0,13.1,18,7,6,11,1,10,20,50.0,10,12,3,9,5,23,10,0,Matches,2022-2023,Serie-A
Samuel Iling-Junior,eng ENG,"DF,FW",Juventus,18.0,2003.0,3.5,7,2,3,1,3,4,9,44.4,5,5,1,4,2,9,6,0,Matches,2022-2023,Serie-A
Emirhan İlkhan,tr TUR,MF,Torino,18.0,2004.0,1.0,1,1,0,1,0,1,1,100.0,0,3,1,2,2,3,2,0,Matches,2022-2023,Serie-A
Emirhan İlkhan,tr TUR,MF,Sampdoria,18.0,2004.0,1.3,6,3,2,2,2,2,3,66.7,1,5,1,4,0,6,3,0,Matches,2022-2023,Serie-A
Ciro Immobile,it ITA,FW,Lazio,32.0,1990.0,24.7,11,5,4,4,3,6,9,66.7,3,10,2,8,1,12,14,0,Matches,2022-2023,Serie-A
Ardian Ismajli,al ALB,DF,Empoli,25.0,1996.0,23.3,40,32,25,15,0,18,24,75.0,6,47,31,16,27,67,120,0,Matches,2022-2023,Serie-A
Mihailo Ivanović,rs SRB,FW,Sampdoria,17.0,2004.0,0.0,0,0,0,0,0,0,0,,0,0,0,0,0,0,0,0,Matches,2022-2023,Serie-A
Armando Izzo,it ITA,DF,Monza,30.0,1992.0,27.4,73,50,44,27,2,29,45,64.4,16,29,17,12,50,123,87,1,Matches,2022-2023,Serie-A
Mato Jajalo,ba BIH,MF,Udinese,34.0,1988.0,0.7,0,0,0,0,0,0,1,0.0,1,0,0,0,0,0,2,0,Matches,2022-2023,Serie-A
Jesé,es ESP,FW,Sampdoria,29.0,1993.0,2.3,2,0,0,2,0,0,1,0.0,1,3,1,2,1,3,2,0,Matches,2022-2023,Serie-A
Juan Jesus,br BRA,DF,Napoli,31.0,1991.0,10.4,16,11,9,6,1,9,12,75.0,3,18,11,7,10,26,29,0,Matches,2022-2023,Serie-A
Þórir Jóhann Helgason,is ISL,MF,Lecce,21.0,2000.0,2.5,2,2,1,0,1,2,3,66.7,1,3,1,2,3,5,3,0,Matches,2022-2023,Serie-A
Luka Jović,rs SRB,"FW,MF",Fiorentina,24.0,1997.0,17.0,6,3,1,4,1,2,8,25.0,6,7,2,5,2,8,10,0,Matches,2022-2023,Serie-A
Hamed Junior Traorè,ci CIV,"MF,FW",Sassuolo,22.0,2000.0,6.6,11,6,4,6,1,4,11,36.4,7,4,0,4,2,13,0,1,Matches,2022-2023,Serie-A
Yayah Kallon,sl SLE,"MF,FW",Hellas Verona,21.0,2001.0,9.6,14,10,5,4,5,7,12,58.3,5,10,0,10,8,22,5,0,Matches,2022-2023,Serie-A
Pierre Kalulu,fr FRA,DF,Milan,22.0,2000.0,28.3,57,39,33,21,3,28,42,66.7,14,41,17,24,41,98,56,1,Matches,2022-2023,Serie-A
Yann Karamoh,fr FRA,"MF,FW",Torino,24.0,1998.0,8.0,5,2,3,2,0,1,5,20.0,4,5,0,5,0,5,2,1,Matches,2022-2023,Serie-A
Rick Karsdorp,nl NED,DF,Roma,27.0,1995.0,7.9,21,13,11,7,3,13,22,59.1,9,0,0,0,7,28,15,1,Matches,2022-2023,Serie-A
Denso Kasius,nl NED,DF,Bologna,19.0,2002.0,3.8,12,6,7,4,1,8,10,80.0,2,6,3,3,3,15,6,0,Matches,2022-2023,Serie-A
Grigoris Kastanos,cy CYP,"MF,DF",Salernitana,24.0,1998.0,14.3,39,23,18,19,2,16,40,40.0,24,20,6,14,8,47,8,0,Matches,2022-2023,Serie-A
Moise Kean,it ITA,FW,Juventus,22.0,2000.0,11.1,8,6,2,5,1,3,7,42.9,4,4,0,4,5,13,2,0,Matches,2022-2023,Serie-A
Jakub Kiwior,pl POL,DF,Spezia,22.0,2000.0,16.0,22,17,15,7,0,6,24,25.0,18,26,18,8,24,46,71,1,Matches,2022-2023,Serie-A
Simon Kjær,dk DEN,DF,Milan,33.0,1989.0,11.2,15,8,9,6,0,7,11,63.6,4,14,11,3,9,24,35,1,Matches,2022-2023,Serie-A
Teun Koopmeiners,nl NED,MF,Atalanta,24.0,1998.0,31.8,46,26,15,24,7,28,55,50.9,27,41,5,36,19,65,36,2,Matches,2022-2023,Serie-A
Filip Kostić,rs SRB,"DF,FW",Juventus,29.0,1992.0,28.5,41,26,17,20,4,21,47,44.7,26,30,4,26,16,57,32,0,Matches,2022-2023,Serie-A
Christian Kouamé,ci CIV,FW,Fiorentina,24.0,1997.0,20.7,27,18,8,10,9,7,14,50.0,7,15,3,12,12,39,8,0,Matches,2022-2023,Serie-A
Viktor Kovalenko,ua UKR,MF,Spezia,26.0,1996.0,6.1,9,5,1,6,2,5,8,62.5,3,11,2,9,4,13,7,0,Matches,2022-2023,Serie-A
Julian Kristoffersen,no NOR,FW,Salernitana,25.0,1997.0,0.2,0,0,0,0,0,0,0,,0,1,0,1,0,0,0,0,Matches,2022-2023,Serie-A
Raimonds Krollis,lv LVA,"FW,DF",Spezia,20.0,2001.0,0.4,1,1,0,0,1,0,1,0.0,1,0,0,0,0,1,0,0,Matches,2022-2023,Serie-A
Rade Krunić,ba BIH,MF,Milan,28.0,1993.0,18.4,40,28,18,18,4,16,50,32.0,34,31,11,20,16,56,21,0,Matches,2022-2023,Serie-A
Marash Kumbulla,al ALB,DF,Roma,22.0,2000.0,2.9,4,4,2,2,0,2,3,66.7,1,2,1,1,4,8,6,0,Matches,2022-2023,Serie-A
Khvicha Kvaratskhelia,ge GEO,FW,Napoli,21.0,2001.0,28.0,43,23,12,8,23,17,43,39.5,26,20,0,20,5,48,6,1,Matches,2022-2023,Serie-A
Giorgos Kyriakopoulos,gr GRE,"DF,FW",Bologna,26.0,1996.0,7.8,13,6,4,5,4,10,23,43.5,13,14,2,12,4,17,10,0,Matches,2022-2023,Serie-A
Giorgos Kyriakopoulos,gr GRE,"FW,DF",Sassuolo,26.0,1996.0,8.5,21,8,7,9,5,10,14,71.4,4,7,1,6,11,32,12,1,Matches,2022-2023,Serie-A
Sam Lammers,nl NED,FW,Sampdoria,25.0,1997.0,12.2,12,5,2,7,3,6,15,40.0,9,10,3,7,6,18,11,0,Matches,2022-2023,Serie-A
Sam Lammers,nl NED,FW,Empoli,25.0,1997.0,9.8,20,10,5,9,6,7,11,63.6,4,4,1,3,3,23,8,0,Matches,2022-2023,Serie-A
Kevin Lasagna,it ITA,"FW,MF",Hellas Verona,29.0,1992.0,17.5,12,6,7,3,2,6,14,42.9,8,17,1,16,5,17,13,0,Matches,2022-2023,Serie-A
Armand Lauriente,fr FRA,FW,Sassuolo,23.0,1998.0,24.2,21,15,5,7,9,8,21,38.1,13,20,0,20,12,33,8,0,Matches,2022-2023,Serie-A
Valentino Lazaro,at AUT,DF,Torino,26.0,1996.0,15.3,10,5,6,0,4,6,14,42.9,8,16,3,13,3,13,29,0,Matches,2022-2023,Serie-A
Marko Lazetić,rs SRB,FW,Milan,18.0,2004.0,0.1,0,0,0,0,0,0,0,,0,0,0,0,0,0,0,0,Matches,2022-2023,Serie-A
Darko Lazović,rs SRB,"MF,DF",Hellas Verona,31.0,1990.0,24.9,24,13,9,12,3,13,29,44.8,16,14,3,11,16,40,19,0,Matches,2022-2023,Serie-A
Manuel Lazzari,it ITA,DF,Lazio,28.0,1993.0,20.9,33,21,13,14,6,21,36,58.3,15,20,6,14,18,51,36,1,Matches,2022-2023,Serie-A
Rafael Leão,pt POR,"FW,MF",Milan,23.0,1999.0,26.9,8,7,2,3,3,6,14,42.9,8,9,2,7,15,23,8,0,Matches,2022-2023,Serie-A
Mehdi Léris,dz ALG,"MF,DF",Sampdoria,24.0,1998.0,27.3,63,46,30,24,9,23,55,41.8,32,38,6,32,27,90,34,0,Matches,2022-2023,Serie-A
Karol Linetty,pl POL,MF,Torino,27.0,1995.0,21.0,32,17,7,22,3,13,25,52.0,12,28,8,20,19,51,25,0,Matches,2022-2023,Serie-A
Marcin Listkowski,pl POL,"MF,FW",Lecce,24.0,1998.0,0.9,0,0,0,0,0,0,0,,0,0,0,0,3,3,2,0,Matches,2022-2023,Serie-A
Diego Llorente,es ESP,DF,Roma,28.0,1993.0,6.4,10,5,6,4,0,5,12,41.7,7,4,2,2,11,21,20,0,Matches,2022-2023,Serie-A
Stanislav Lobotka,sk SVK,MF,Napoli,27.0,1994.0,34.5,83,44,35,35,13,43,73,58.9,30,29,7,22,23,106,16,0,Matches,2022-2023,Serie-A
Manuel Locatelli,it ITA,MF,Juventus,24.0,1998.0,27.2,59,33,26,23,10,30,53,56.6,23,50,22,28,27,86,59,0,Matches,2022-2023,Serie-A
Luka Lochoshvili,ge GEO,DF,Cremonese,24.0,1998.0,20.4,45,19,30,11,4,22,31,71.0,9,31,10,21,22,67,89,0,Matches,2022-2023,Serie-A
Ademola Lookman,ng NGA,"FW,MF",Atalanta,24.0,1997.0,19.2,13,5,2,6,5,3,15,20.0,12,18,0,18,4,17,1,0,Matches,2022-2023,Serie-A
Maxime Lopez,fr FRA,MF,Sassuolo,24.0,1997.0,25.5,42,18,26,12,4,16,56,28.6,40,24,6,18,22,64,21,0,Matches,2022-2023,Serie-A
Matteo Lovato,it ITA,DF,Salernitana,22.0,2000.0,9.0,17,14,14,3,0,10,25,40.0,15,8,5,3,13,30,33,2,Matches,2022-2023,Serie-A
Sandi Lovrić,si SVN,MF,Udinese,24.0,1998.0,25.9,40,18,16,16,8,25,43,58.1,18,25,2,23,26,66,21,0,Matches,2022-2023,Serie-A
Hirving Lozano,mx MEX,FW,Napoli,27.0,1995.0,17.8,24,13,10,6,8,9,21,42.9,12,31,0,31,15,39,6,0,Matches,2022-2023,Serie-A
Jhon Lucumí,co COL,DF,Bologna,24.0,1998.0,32.2,53,37,39,13,1,24,43,55.8,19,43,26,17,35,88,100,1,Matches,2022-2023,Serie-A
José Luis Palomino,ar ARG,DF,Atalanta,32.0,1990.0,8.4,23,14,16,7,0,11,19,57.9,8,11,4,7,28,51,20,0,Matches,2022-2023,Serie-A
Romelu Lukaku,be BEL,FW,Inter,29.0,1993.0,18.4,3,1,1,0,2,2,5,40.0,3,3,1,2,0,3,16,0,Matches,2022-2023,Serie-A
Saša Lukić,rs SRB,MF,Torino,25.0,1996.0,13.3,21,14,10,10,1,9,15,60.0,6,17,7,10,13,34,10,0,Matches,2022-2023,Serie-A
Sebastiano Luperto,it ITA,DF,Empoli,25.0,1996.0,34.8,33,18,24,8,1,9,20,45.0,11,54,42,12,43,76,163,1,Matches,2022-2023,Serie-A
Charalambos Lykogiannis,gr GRE,DF,Bologna,28.0,1993.0,12.3,16,8,5,6,5,5,13,38.5,8,9,4,5,15,31,30,0,Matches,2022-2023,Serie-A
Giulio Maggiore,it ITA,MF,Salernitana,24.0,1998.0,9.9,20,8,11,6,3,10,21,47.6,11,19,4,15,8,28,10,0,Matches,2022-2023,Serie-A
Giangiacomo Magnani,it ITA,DF,Hellas Verona,26.0,1995.0,17.0,33,22,20,11,2,19,25,76.0,6,20,15,5,21,54,76,0,Matches,2022-2023,Serie-A
Mike Maignan,fr FRA,GK,Milan,27.0,1995.0,22.0,1,0,1,0,0,1,1,100.0,0,0,0,0,1,2,10,1,Matches,2022-2023,Serie-A
Jordan Majchrzak,pl POL,FW,Roma,17.0,2004.0,0.2,0,0,0,0,0,0,0,,0,0,0,0,0,0,0,0,Matches,2022-2023,Serie-A
Jean-Victor Makengo,fr FRA,MF,Udinese,24.0,1998.0,8.9,16,13,7,7,2,5,9,55.6,4,8,2,6,9,25,3,0,Matches,2022-2023,Serie-A
Lorenzo Malagrida,it ITA,"MF,DF",Sampdoria,18.0,2003.0,1.2,1,0,0,0,1,1,3,33.3,2,1,0,1,0,1,1,0,Matches,2022-2023,Serie-A
Daniel Maldini,it ITA,"FW,MF",Spezia,20.0,2001.0,7.0,12,5,3,4,5,4,11,36.4,7,9,0,9,1,13,8,0,Matches,2022-2023,Serie-A
Youssef Maleh,ma MAR,MF,Fiorentina,23.0,1998.0,3.3,3,1,0,3,0,0,4,0.0,4,5,0,5,1,4,3,0,Matches,2022-2023,Serie-A
Youssef Maleh,ma MAR,MF,Lecce,23.0,1998.0,7.5,17,8,3,7,7,6,14,42.9,8,20,1,19,5,22,10,0,Matches,2022-2023,Serie-A
Ruslan Malinovskyi,ua UKR,"MF,FW",Atalanta,29.0,1993.0,6.1,14,8,5,6,3,6,17,35.3,11,8,1,7,5,19,2,0,Matches,2022-2023,Serie-A
Gianluca Mancini,it ITA,DF,Roma,26.0,1996.0,31.8,37,19,27,9,1,18,34,52.9,16,38,17,21,46,83,67,0,Matches,2022-2023,Serie-A
Rolando Mandragora,it ITA,MF,Fiorentina,25.0,1997.0,21.7,42,24,12,22,8,23,52,44.2,29,25,3,22,16,58,21,0,Matches,2022-2023,Serie-A
Federico Marchetti,it ITA,GK,Spezia,39.0,1983.0,0.7,0,0,0,0,0,0,0,,0,0,0,0,0,0,0,0,Matches,2022-2023,Serie-A
Riccardo Marchizza,it ITA,DF,Sassuolo,24.0,1998.0,3.1,2,2,1,1,0,2,4,50.0,2,2,0,2,2,4,8,0,Matches,2022-2023,Serie-A
Gian Marco Ferrari,it ITA,DF,Sassuolo,30.0,1992.0,24.7,23,16,11,10,2,10,17,58.8,7,29,20,9,23,46,81,4,Matches,2022-2023,Serie-A
Pablo Marí,es ESP,DF,Monza,28.0,1993.0,27.6,37,19,29,7,1,17,26,65.4,9,22,14,8,31,68,111,3,Matches,2022-2023,Serie-A
Răzvan Marin,ro ROU,MF,Empoli,26.0,1996.0,28.2,44,22,22,21,1,19,40,47.5,21,29,11,18,14,58,33,0,Matches,2022-2023,Serie-A
Marlon,br BRA,DF,Monza,26.0,1995.0,17.7,35,21,20,14,1,15,29,51.7,14,13,4,9,18,53,50,0,Matches,2022-2023,Serie-A
Luca Marrone,it ITA,DF,Monza,32.0,1990.0,1.5,0,0,0,0,0,0,2,0.0,2,2,2,0,0,0,4,1,Matches,2022-2023,Serie-A
Lautaro Martínez,ar ARG,FW,Inter,24.0,1997.0,28.6,25,14,3,15,7,7,23,30.4,16,31,1,30,13,38,16,1,Matches,2022-2023,Serie-A
Lucas Martínez Quarta,ar ARG,DF,Fiorentina,26.0,1996.0,24.1,80,48,44,32,4,42,61,68.9,19,41,19,22,48,128,78,1,Matches,2022-2023,Serie-A
Adam Marušić,me MNE,DF,Lazio,29.0,1992.0,30.7,41,30,23,14,4,25,39,64.1,14,20,6,14,38,79,63,1,Matches,2022-2023,Serie-A
Adam Masina,ma MAR,DF,Udinese,28.0,1994.0,8.8,10,7,7,3,0,6,15,40.0,9,11,4,7,10,20,28,1,Matches,2022-2023,Serie-A
Nemanja Matić,rs SRB,MF,Roma,33.0,1988.0,20.6,47,27,24,19,4,19,33,57.6,14,27,7,20,25,72,21,1,Matches,2022-2023,Serie-A
Luís Maximiano,pt POR,GK,Lazio,23.0,1999.0,0.1,0,0,0,0,0,0,0,,0,0,0,0,0,0,0,0,Matches,2022-2023,Serie-A
Pasquale Mazzocchi,it ITA,DF,Salernitana,27.0,1995.0,21.8,32,18,21,5,6,17,37,45.9,20,10,2,8,10,42,37,2,Matches,2022-2023,Serie-A
Weston McKennie,us USA,"MF,DF",Juventus,23.0,1998.0,11.7,14,5,3,9,2,5,8,62.5,3,15,4,11,11,25,15,1,Matches,2022-2023,Serie-A
Gary Medel,cl CHI,"MF,DF",Bologna,34.0,1987.0,16.4,25,15,16,7,2,9,16,56.3,7,17,10,7,28,53,34,0,Matches,2022-2023,Serie-A
Soualiho Meïté,fr FRA,MF,Cremonese,28.0,1994.0,26.3,47,31,25,15,7,22,46,47.8,24,27,6,21,27,74,36,0,Matches,2022-2023,Serie-A
Alex Meret,it ITA,GK,Napoli,25.0,1997.0,34.0,0,0,0,0,0,0,0,,0,0,0,0,0,0,6,1,Matches,2022-2023,Serie-A
Yıldırım Mert Çetin,tr TUR,DF,Lecce,25.0,1997.0,0.2,1,0,1,0,0,0,0,,0,0,0,0,1,2,1,0,Matches,2022-2023,Serie-A
Junior Messias,br BRA,"FW,DF",Milan,31.0,1991.0,16.6,24,18,9,9,6,5,19,26.3,14,20,4,16,7,31,28,0,Matches,2022-2023,Serie-A
Tommaso Milanese,it ITA,MF,Cremonese,20.0,2002.0,0.3,0,0,0,0,0,0,0,,0,1,1,0,0,0,0,0,Matches,2022-2023,Serie-A
Nikola Milenković,rs SRB,DF,Fiorentina,24.0,1997.0,23.7,40,25,20,17,3,18,27,66.7,9,27,14,13,22,62,72,0,Matches,2022-2023,Serie-A
Arkadiusz Milik,pl POL,FW,Juventus,28.0,1994.0,17.6,12,8,2,8,2,2,8,25.0,6,10,1,9,1,13,14,0,Matches,2022-2023,Serie-A
Sergej Milinković-Savić,rs SRB,MF,Lazio,27.0,1995.0,33.6,58,35,22,23,13,24,67,35.8,43,50,12,38,28,86,49,0,Matches,2022-2023,Serie-A
Vanja Milinković-Savić,rs SRB,GK,Torino,25.0,1997.0,38.0,2,1,2,0,0,2,2,100.0,0,0,0,0,1,3,19,1,Matches,2022-2023,Serie-A
Kim Min-jae,kr KOR,DF,Napoli,25.0,1996.0,33.9,55,30,32,22,1,25,29,86.2,4,36,26,10,41,96,123,1,Matches,2022-2023,Serie-A
Aleksei Miranchuk,ru RUS,MF,Torino,26.0,1995.0,23.2,11,5,3,4,4,3,11,27.3,8,11,0,11,2,13,5,0,Matches,2022-2023,Serie-A
Antonio Mirante,it ITA,GK,Milan,39.0,1983.0,0.0,0,0,0,0,0,0,0,,0,0,0,0,0,0,0,0,Matches,2022-2023,Serie-A
Fabio Miretti,it ITA,"MF,FW",Juventus,18.0,2003.0,13.7,24,11,15,6,3,12,29,41.4,17,20,1,19,4,28,11,0,Matches,2022-2023,Serie-A
Filippo Missori,it ITA,DF,Roma,18.0,2004.0,2.0,4,3,3,0,1,3,6,50.0,3,0,0,0,3,7,5,0,Matches,2022-2023,Serie-A
Henrikh Mkhitaryan,am ARM,MF,Inter,33.0,1989.0,22.1,41,26,13,22,6,14,41,34.1,27,27,4,23,21,62,18,0,Matches,2022-2023,Serie-A
Salvatore Molina,it ITA,DF,Monza,30.0,1992.0,2.5,6,5,2,4,0,4,5,80.0,1,4,2,2,1,7,2,0,Matches,2022-2023,Serie-A
Daniele Montevago,it ITA,FW,Sampdoria,19.0,2003.0,2.6,1,0,0,0,1,0,1,0.0,1,2,1,1,0,1,1,0,Matches,2022-2023,Serie-A
Lorenzo Montipò,it ITA,GK,Hellas Verona,26.0,1996.0,37.0,1,0,1,0,0,0,3,0.0,3,1,0,1,0,1,26,3,Matches,2022-2023,Serie-A
Nikola Moro,hr CRO,MF,Bologna,24.0,1998.0,13.6,32,21,11,15,6,14,36,38.9,22,15,2,13,8,40,18,0,Matches,2022-2023,Serie-A
Dany Mota,pt POR,"FW,MF",Monza,24.0,1998.0,21.2,8,7,1,3,4,2,10,20.0,8,5,1,4,6,14,25,0,Matches,2022-2023,Serie-A
João Moutinho,pt POR,"DF,FW",Spezia,24.0,1998.0,0.6,7,1,5,1,1,3,4,75.0,1,1,1,0,0,7,0,0,Matches,2022-2023,Serie-A
Mert Müldür,tr TUR,"FW,DF",Sassuolo,23.0,1999.0,0.1,0,0,0,0,0,0,0,,0,0,0,0,0,0,0,0,Matches,2022-2023,Serie-A
Luis Muriel,co COL,"FW,MF",Atalanta,31.0,1991.0,11.9,9,6,2,3,4,5,16,31.3,11,9,0,9,2,11,2,0,Matches,2022-2023,Serie-A
Jeison Murillo,co COL,DF,Sampdoria,30.0,1992.0,11.7,22,11,16,6,0,17,26,65.4,9,22,14,8,8,30,39,0,Matches,2022-2023,Serie-A
Nicola Murru,it ITA,DF,Sampdoria,27.0,1994.0,8.7,24,14,15,8,1,7,13,53.8,6,17,7,10,10,34,21,0,Matches,2022-2023,Serie-A
Juan Musso,ar ARG,GK,Atalanta,28.0,1994.0,23.1,1,1,1,0,0,1,1,100.0,0,0,0,0,0,1,11,1,Matches,2022-2023,Serie-A
Joakim Mæhle,dk DEN,"DF,MF",Atalanta,25.0,1997.0,24.5,32,18,12,7,13,22,39,56.4,17,29,6,23,24,56,26,0,Matches,2022-2023,Serie-A
Herculano Nabian,pt POR,MF,Empoli,18.0,2004.0,0.0,0,0,0,0,0,0,0,,0,0,0,0,0,0,0,0,Matches,2022-2023,Serie-A
Michel Ndary Adopo,fr FRA,"MF,DF",Torino,22.0,2000.0,2.9,7,2,4,2,1,1,3,33.3,2,2,2,0,1,8,4,0,Matches,2022-2023,Serie-A
Tanguy Ndombele,fr FRA,MF,Napoli,25.0,1996.0,9.0,14,8,4,8,2,4,7,57.1,3,10,1,9,7,21,7,1,Matches,2022-2023,Serie-A
Ilija Nestorovski,mk MKD,"FW,MF",Udinese,32.0,1990.0,7.1,7,3,2,1,4,5,11,45.5,6,6,1,5,2,9,10,0,Matches,2022-2023,Serie-A
Cyril Ngonge,be BEL,"MF,FW",Hellas Verona,22.0,2000.0,8.3,7,3,2,2,3,3,11,27.3,8,7,0,7,6,13,4,0,Matches,2022-2023,Serie-A
Hans Nicolussi Caviglia,it ITA,MF,Salernitana,22.0,2000.0,6.5,15,6,5,8,2,9,15,60.0,6,9,0,9,7,22,7,1,Matches,2022-2023,Serie-A
Dimitris Nikolaou,gr GRE,DF,Spezia,23.0,1998.0,32.9,45,32,31,10,4,25,37,67.6,12,41,26,15,27,72,82,0,Matches,2022-2023,Serie-A
Samuel Ntanda,cd COD,MF,Sampdoria,17.0,2005.0,0.0,0,0,0,0,0,0,0,,0,0,0,0,0,0,0,0,Matches,2022-2023,Serie-A
Bram Nuytinck,nl NED,DF,Udinese,32.0,1990.0,4.3,7,4,3,4,0,4,8,50.0,4,6,6,0,5,12,22,0,Matches,2022-2023,Serie-A
Bram Nuytinck,nl NED,DF,Sampdoria,32.0,1990.0,16.6,54,38,33,21,0,23,34,67.6,11,36,21,15,23,77,84,0,Matches,2022-2023,Serie-A
M'Bala Nzola,ao ANG,FW,Spezia,25.0,1996.0,29.5,12,5,0,6,6,3,9,33.3,6,20,6,14,7,19,21,0,Matches,2022-2023,Serie-A
Pedro Obiang,gq EQG,MF,Sassuolo,30.0,1992.0,9.7,26,17,12,12,2,10,18,55.6,8,12,2,10,8,34,15,0,Matches,2022-2023,Serie-A
Guillermo Ochoa,mx MEX,GK,Salernitana,37.0,1985.0,20.0,0,0,0,0,0,0,2,0.0,2,0,0,0,0,0,9,1,Matches,2022-2023,Serie-A
Marios Oikonomou,gr GRE,DF,Sampdoria,29.0,1992.0,2.4,3,2,3,0,0,1,3,33.3,2,5,4,1,4,7,13,0,Matches,2022-2023,Serie-A
David Okereke,ng NGA,"FW,MF",Cremonese,24.0,1997.0,25.2,12,8,4,5,3,3,16,18.8,13,23,3,20,10,22,12,0,Matches,2022-2023,Serie-A
Caleb Okoli,it ITA,DF,Atalanta,21.0,2001.0,10.7,21,17,14,6,1,10,25,40.0,15,10,5,5,30,51,44,3,Matches,2022-2023,Serie-A
Mathías Olivera,uy URU,DF,Napoli,24.0,1997.0,18.3,39,23,16,16,7,22,43,51.2,21,28,2,26,22,61,26,0,Matches,2022-2023,Serie-A
André Onana,cm CMR,GK,Inter,26.0,1996.0,24.0,0,0,0,0,0,0,1,0.0,1,0,0,0,0,0,5,0,Matches,2022-2023,Serie-A
Divock Origi,be BEL,FW,Milan,27.0,1995.0,11.4,10,5,4,3,3,5,10,50.0,5,6,2,4,0,10,13,0,Matches,2022-2023,Serie-A
Riccardo Orsolini,it ITA,FW,Bologna,25.0,1997.0,23.6,30,19,15,10,5,17,41,41.5,24,29,3,26,8,38,18,0,Matches,2022-2023,Serie-A
Victor Osimhen,ng NGA,FW,Napoli,23.0,1998.0,28.5,10,6,1,2,7,0,7,0.0,7,6,1,5,6,16,29,0,Matches,2022-2023,Serie-A
Remi Oudin,fr FRA,"FW,MF",Lecce,25.0,1996.0,14.7,25,13,9,12,4,10,23,43.5,13,16,2,14,29,54,23,0,Matches,2022-2023,Serie-A
Adam Ounas,dz ALG,FW,Napoli,25.0,1996.0,0.2,0,0,0,0,0,0,0,,0,0,0,0,1,1,0,0,Matches,2022-2023,Serie-A
Simone Pafundi,it ITA,"MF,FW",Udinese,16.0,2006.0,0.9,8,5,1,5,2,2,4,50.0,2,0,0,0,1,9,0,0,Matches,2022-2023,Serie-A
Flavio Paoletti,it ITA,MF,Sampdoria,19.0,2003.0,3.2,2,2,0,2,0,1,5,20.0,4,1,0,1,5,7,9,0,Matches,2022-2023,Serie-A
Leandro Paredes,ar ARG,MF,Juventus,28.0,1994.0,10.9,19,13,7,11,1,10,22,45.5,12,8,0,8,17,36,22,0,Matches,2022-2023,Serie-A
Fabiano Parisi,it ITA,DF,Empoli,21.0,2000.0,31.4,65,35,37,21,7,30,72,41.7,42,51,16,35,41,106,91,0,Matches,2022-2023,Serie-A
Mario Pašalić,hr CRO,"MF,FW",Atalanta,27.0,1995.0,19.7,22,10,6,14,2,6,23,26.1,17,22,4,18,21,43,13,0,Matches,2022-2023,Serie-A
Patric,es ESP,DF,Lazio,29.0,1993.0,15.7,17,11,12,3,2,11,16,68.8,5,17,12,5,11,28,53,1,Matches,2022-2023,Serie-A
Rui Patrício,pt POR,GK,Roma,34.0,1988.0,35.0,1,1,1,0,0,1,1,100.0,0,0,0,0,2,3,6,3,Matches,2022-2023,Serie-A
Pedro,es ESP,FW,Lazio,35.0,1987.0,21.1,35,24,14,10,11,11,30,36.7,19,18,2,16,6,41,4,1,Matches,2022-2023,Serie-A
Gianluca Pegolo,it ITA,GK,Sassuolo,41.0,1981.0,2.0,0,0,0,0,0,0,1,0.0,1,0,0,0,0,0,1,0,Matches,2022-2023,Serie-A
Pietro Pellegri,it ITA,FW,Torino,21.0,2001.0,5.2,6,2,1,3,2,2,3,66.7,1,5,1,4,0,6,4,0,Matches,2022-2023,Serie-A
Lorenzo Pellegrini,it ITA,MF,Roma,26.0,1996.0,28.3,52,29,24,24,4,22,48,45.8,26,27,4,23,26,78,22,0,Matches,2022-2023,Serie-A
Luca Pellegrini,it ITA,DF,Lazio,23.0,1999.0,2.0,1,0,0,1,0,1,4,25.0,3,3,0,3,7,8,4,0,Matches,2022-2023,Serie-A
Pepín,gq EQG,MF,Monza,25.0,1996.0,12.5,28,19,10,11,7,9,27,33.3,18,14,3,11,13,41,17,0,Matches,2022-2023,Serie-A
Roberto Pereyra,ar ARG,"DF,MF",Udinese,31.0,1991.0,31.3,36,20,21,12,3,16,44,36.4,28,20,5,15,16,52,28,0,Matches,2022-2023,Serie-A
Nehuén Pérez,ar ARG,DF,Udinese,22.0,2000.0,31.3,77,40,54,20,3,39,55,70.9,16,53,23,30,35,112,106,1,Matches,2022-2023,Serie-A
Simone Perilli,it ITA,GK,Hellas Verona,27.0,1995.0,1.0,0,0,0,0,0,0,0,,0,0,0,0,0,0,0,0,Matches,2022-2023,Serie-A
Mattia Perin,it ITA,GK,Juventus,29.0,1992.0,10.5,0,0,0,0,0,0,0,,0,0,0,0,0,0,0,0,Matches,2022-2023,Serie-A
Samuele Perisan,it ITA,GK,Empoli,24.0,1997.0,7.0,0,0,0,0,0,0,0,,0,0,0,0,0,0,2,0,Matches,2022-2023,Serie-A
Matteo Pessina,it ITA,MF,Monza,25.0,1997.0,32.6,57,36,28,21,8,26,62,41.9,36,50,15,35,37,94,33,1,Matches,2022-2023,Serie-A
Andrea Petagna,it ITA,FW,Monza,27.0,1995.0,18.5,7,5,2,3,2,3,6,50.0,3,16,4,12,3,10,18,0,Matches,2022-2023,Serie-A
Giuseppe Pezzella,it ITA,DF,Lecce,24.0,1997.0,10.2,21,9,16,2,3,9,16,56.3,7,11,3,8,8,29,31,1,Matches,2022-2023,Serie-A
Krzysztof Piątek,pl POL,FW,Salernitana,27.0,1995.0,23.8,18,11,3,9,6,5,21,23.8,16,17,4,13,2,20,39,0,Matches,2022-2023,Serie-A
Roberto Piccoli,it ITA,FW,Hellas Verona,21.0,2001.0,2.1,1,0,1,0,0,0,2,0.0,2,2,0,2,0,1,2,0,Matches,2022-2023,Serie-A
Roberto Piccoli,it ITA,FW,Empoli,21.0,2001.0,5.7,1,1,1,0,0,0,3,0.0,3,4,1,3,1,2,9,0,Matches,2022-2023,Serie-A
Charles Pickel,cd COD,MF,Cremonese,25.0,1997.0,27.6,55,23,25,26,4,32,57,56.1,25,37,5,32,24,79,36,1,Matches,2022-2023,Serie-A
Andrea Pinamonti,it ITA,FW,Sassuolo,23.0,1999.0,24.0,10,7,0,5,5,3,7,42.9,4,19,2,17,2,12,11,0,Matches,2022-2023,Serie-A
Lorenzo Pirola,it ITA,DF,Salernitana,20.0,2002.0,21.6,33,29,18,14,1,19,27,70.4,8,50,35,15,30,63,85,1,Matches,2022-2023,Serie-A
Niccolò Pisilli,it ITA,MF,Roma,17.0,2004.0,0.0,0,0,0,0,0,0,0,,0,0,0,0,0,0,0,0,Matches,2022-2023,Serie-A
Marko Pjaca,hr CRO,"MF,FW",Empoli,27.0,1995.0,5.8,4,3,3,1,0,3,5,60.0,2,3,0,3,3,7,3,0,Matches,2022-2023,Serie-A
Tommaso Pobega,it ITA,MF,Milan,23.0,1999.0,9.8,27,16,8,15,4,13,20,65.0,7,12,4,8,9,36,11,0,Matches,2022-2023,Serie-A
Paul Pogba,fr FRA,"MF,FW",Juventus,29.0,1993.0,1.2,0,0,0,0,0,0,1,0.0,1,0,0,0,0,0,2,0,Matches,2022-2023,Serie-A
Matteo Politano,it ITA,FW,Napoli,28.0,1993.0,13.0,18,9,9,5,4,11,25,44.0,14,6,0,6,7,25,7,0,Matches,2022-2023,Serie-A
Marin Pongračić,hr CRO,DF,Lecce,24.0,1997.0,8.8,16,14,8,7,1,5,7,71.4,2,4,3,1,16,32,31,0,Matches,2022-2023,Serie-A
Stefan Posch,at AUT,DF,Bologna,25.0,1997.0,28.1,81,43,41,29,11,44,75,58.7,31,44,15,29,35,116,69,0,Matches,2022-2023,Serie-A
Ivan Provedel,it ITA,GK,Lazio,28.0,1994.0,37.9,1,0,1,0,0,0,0,,0,0,0,0,0,1,15,1,Matches,2022-2023,Serie-A
Ignacio Pussetto,ar ARG,"MF,DF",Sampdoria,26.0,1995.0,1.7,6,3,2,3,1,3,4,75.0,1,4,0,4,0,6,3,0,Matches,2022-2023,Serie-A
Niklas Pyyhtiä,fi FIN,MF,Bologna,18.0,2003.0,1.2,1,0,0,1,0,0,1,0.0,1,1,1,0,1,2,4,0,Matches,2022-2023,Serie-A
Fabio Quagliarella,it ITA,FW,Sampdoria,39.0,1983.0,8.9,2,1,1,1,0,1,7,14.3,6,5,1,4,0,2,9,0,Matches,2022-2023,Serie-A
Giacomo Quagliata,it ITA,DF,Cremonese,22.0,2000.0,7.8,10,8,7,1,2,5,11,45.5,6,7,2,5,11,21,8,0,Matches,2022-2023,Serie-A
Adrien Rabiot,fr FRA,MF,Juventus,27.0,1995.0,30.5,65,35,31,23,11,30,57,52.6,27,37,7,30,26,91,44,1,Matches,2022-2023,Serie-A
Nemanja Radonjić,rs SRB,"MF,FW",Torino,26.0,1996.0,16.2,2,1,2,0,0,0,4,0.0,4,3,0,3,2,4,4,0,Matches,2022-2023,Serie-A
Ivan Radovanović,rs SRB,"MF,DF",Salernitana,33.0,1988.0,7.5,12,4,8,4,0,4,10,40.0,6,9,3,6,7,19,9,1,Matches,2022-2023,Serie-A
Ionuț Radu,ro ROU,GK,Cremonese,25.0,1997.0,9.0,0,0,0,0,0,0,0,,0,0,0,0,0,0,1,3,Matches,2022-2023,Serie-A
Ștefan Radu,ro ROU,FW,Lazio,35.0,1986.0,0.0,0,0,0,0,0,0,0,,0,0,0,0,0,0,0,0,Matches,2022-2023,Serie-A
Antonio Raimondo,it ITA,FW,Bologna,18.0,2004.0,0.2,0,0,0,0,0,0,0,,0,0,0,0,0,0,1,0,Matches,2022-2023,Serie-A
Luca Ranieri,it ITA,DF,Fiorentina,23.0,1999.0,5.6,9,4,6,3,0,6,9,66.7,3,5,3,2,11,20,15,1,Matches,2022-2023,Serie-A
Andrea Ranocchia,it ITA,DF,Monza,34.0,1988.0,0.5,3,1,1,2,0,3,4,75.0,1,5,5,0,0,3,7,0,Matches,2022-2023,Serie-A
Filippo Ranocchia,it ITA,MF,Monza,21.0,2001.0,5.9,11,6,5,4,2,4,12,33.3,8,5,1,4,4,15,7,0,Matches,2022-2023,Serie-A
Giacomo Raspadori,it ITA,FW,Sassuolo,22.0,2000.0,0.5,0,0,0,0,0,0,0,,0,0,0,0,0,0,0,0,Matches,2022-2023,Serie-A
Giacomo Raspadori,it ITA,"FW,MF",Napoli,22.0,2000.0,10.1,10,8,0,6,4,4,10,40.0,6,9,0,9,4,14,4,0,Matches,2022-2023,Serie-A
Nicola Ravaglia,it ITA,GK,Sampdoria,33.0,1988.0,9.0,0,0,0,0,0,0,1,0.0,1,0,0,0,0,0,7,0,Matches,2022-2023,Serie-A
Ante Rebić,hr CRO,"FW,MF",Milan,28.0,1993.0,10.9,10,8,1,3,6,3,11,27.3,8,6,1,5,1,11,5,0,Matches,2022-2023,Serie-A
Arkadiusz Reca,pl POL,DF,Spezia,27.0,1995.0,24.1,44,28,22,12,10,19,32,59.4,13,21,5,16,24,68,54,0,Matches,2022-2023,Serie-A
Panagiotis Retsos,gr GRE,DF,Hellas Verona,23.0,1998.0,1.4,5,4,2,2,1,3,3,100.0,0,4,1,3,2,7,3,0,Matches,2022-2023,Serie-A
Franck Ribéry,fr FRA,MF,Salernitana,39.0,1983.0,0.4,0,0,0,0,0,0,0,,0,1,0,1,0,0,0,0,Matches,2022-2023,Serie-A
Samuele Ricci,it ITA,MF,Torino,20.0,2001.0,23.0,32,21,17,10,5,18,23,78.3,5,20,5,15,17,49,29,1,Matches,2022-2023,Serie-A
Tomás Rincón,ve VEN,MF,Sampdoria,34.0,1988.0,28.4,56,27,22,26,8,29,61,47.5,32,37,7,30,30,86,18,0,Matches,2022-2023,Serie-A
Pablo Rodríguez,es ESP,"FW,MF",Lecce,20.0,2001.0,0.6,2,1,2,0,0,0,2,0.0,2,3,0,3,0,2,0,0,Matches,2022-2023,Serie-A
Ricardo Rodríguez,ch SUI,DF,Torino,29.0,1992.0,29.7,54,33,30,17,7,28,42,66.7,14,30,15,15,38,92,61,0,Matches,2022-2023,Serie-A
Rogério,br BRA,DF,Sassuolo,24.0,1998.0,33.3,37,21,22,8,7,17,35,48.6,18,32,9,23,37,74,70,0,Matches,2022-2023,Serie-A
Filippo Romagna,it ITA,DF,Sassuolo,25.0,1997.0,0.5,0,0,0,0,0,0,0,,0,1,1,0,0,0,2,0,Matches,2022-2023,Serie-A
Alessio Romagnoli,it ITA,DF,Lazio,27.0,1995.0,32.5,33,15,19,14,0,11,22,50.0,11,33,26,7,38,71,108,0,Matches,2022-2023,Serie-A
Simone Romagnoli,it ITA,DF,Lecce,32.0,1990.0,1.9,6,5,3,3,0,2,2,100.0,0,4,1,3,1,7,11,0,Matches,2022-2023,Serie-A
Luka Romero,ar ARG,FW,Lazio,17.0,2004.0,1.7,0,0,0,0,0,0,3,0.0,3,4,0,4,3,3,1,0,Matches,2022-2023,Serie-A
Marten de Roon,nl NED,MF,Atalanta,31.0,1991.0,32.9,77,39,37,35,5,37,81,45.7,44,37,4,33,36,113,58,0,Matches,2022-2023,Serie-A
Francesco Rossi,it ITA,GK,Atalanta,31.0,1991.0,0.0,0,0,0,0,0,0,0,,0,0,0,0,0,0,0,0,Matches,2022-2023,Serie-A
Nicolò Rovella,it ITA,MF,Monza,20.0,2001.0,19.3,45,29,22,21,2,13,36,36.1,23,20,1,19,40,85,17,0,Matches,2022-2023,Serie-A
Nicolò Rovella,it ITA,MF,Juventus,20.0,2001.0,0.3,1,1,0,1,0,1,1,100.0,0,0,0,0,0,1,0,0,Matches,2022-2023,Serie-A
Amir Rrahmani,xk KVX,DF,Napoli,28.0,1994.0,27.2,33,18,20,13,0,17,26,65.4,9,36,20,16,14,47,79,1,Matches,2022-2023,Serie-A
Ruan,br BRA,DF,Sassuolo,23.0,1999.0,19.0,38,26,25,12,1,19,29,65.5,10,29,17,12,24,62,80,3,Matches,2022-2023,Serie-A
Daniele Rugani,it ITA,DF,Juventus,28.0,1994.0,6.3,7,0,6,1,0,4,4,100.0,0,7,5,2,7,14,32,0,Matches,2022-2023,Serie-A
Matteo Ruggeri,it ITA,"DF,MF",Atalanta,20.0,2002.0,9.2,17,12,5,9,3,8,16,50.0,8,14,3,11,12,29,16,0,Matches,2022-2023,Serie-A
Mário Rui,pt POR,DF,Napoli,31.0,1991.0,19.4,34,22,17,13,4,20,41,48.8,21,17,4,13,15,49,24,1,Matches,2022-2023,Serie-A
Alessandro Russo,it ITA,GK,Sassuolo,21.0,2001.0,1.0,0,0,0,0,0,0,0,,0,0,0,0,0,0,1,1,Matches,2022-2023,Serie-A
Abdelhamid Sabiri,ma MAR,"MF,FW",Sampdoria,25.0,1996.0,11.9,18,7,5,9,4,4,13,30.8,9,18,4,14,2,20,5,0,Matches,2022-2023,Serie-A
Alexis Saelemaekers,be BEL,"FW,DF",Milan,23.0,1999.0,15.6,31,20,12,16,3,19,41,46.3,22,13,1,12,19,50,11,0,Matches,2022-2023,Serie-A
Jacopo Sala,it ITA,MF,Spezia,30.0,1991.0,1.2,1,0,1,0,0,0,2,0.0,2,2,0,2,1,2,2,0,Matches,2022-2023,Serie-A
Lazar Samardzic,rs SRB,MF,Udinese,20.0,2002.0,20.5,33,16,9,20,4,17,43,39.5,26,13,0,13,11,44,16,0,Matches,2022-2023,Serie-A
Junior Sambia,fr FRA,DF,Salernitana,25.0,1996.0,7.7,12,5,7,4,1,6,10,60.0,4,9,3,6,8,20,16,1,Matches,2022-2023,Serie-A
Antonio Sanabria,py PAR,FW,Torino,26.0,1996.0,27.0,11,5,3,3,5,1,7,14.3,6,9,2,7,4,15,7,0,Matches,2022-2023,Serie-A
Leandro Sanca,gw GNB,"FW,MF",Spezia,22.0,2000.0,0.4,1,1,0,0,1,1,1,100.0,0,0,0,0,0,1,0,0,Matches,2022-2023,Serie-A
Alex Sandro,br BRA,DF,Juventus,31.0,1991.0,19.9,35,20,16,16,3,15,22,68.2,7,27,10,17,15,50,64,1,Matches,2022-2023,Serie-A
Nicola Sansone,it ITA,FW,Bologna,30.0,1991.0,8.2,12,4,6,4,2,5,10,50.0,5,0,0,0,0,12,4,0,Matches,2022-2023,Serie-A
Riccardo Saponara,it ITA,FW,Fiorentina,30.0,1991.0,13.4,10,5,3,6,1,5,9,55.6,4,7,1,6,5,15,9,1,Matches,2022-2023,Serie-A
Mouhamadou Sarr,sn SEN,GK,Cremonese,25.0,1997.0,2.0,0,0,0,0,0,0,0,,0,0,0,0,0,0,2,0,Matches,2022-2023,Serie-A
Martin Satriano,uy URU,FW,Empoli,21.0,2001.0,18.9,13,8,5,6,2,6,14,42.9,8,5,0,5,3,16,22,0,Matches,2022-2023,Serie-A
Giorgio Scalvini,it ITA,DF,Atalanta,18.0,2003.0,25.9,54,29,30,18,6,29,55,52.7,26,36,13,23,56,110,57,2,Matches,2022-2023,Serie-A
Jerdy Schouten,nl NED,MF,Bologna,25.0,1997.0,27.9,63,38,28,33,2,27,49,55.1,22,40,17,23,40,103,43,1,Matches,2022-2023,Serie-A
Perr Schuurs,nl NED,DF,Torino,22.0,1999.0,25.8,51,25,29,17,5,14,26,53.8,12,28,16,12,28,79,102,0,Matches,2022-2023,Serie-A
Demba Seck,sn SEN,"MF,FW",Torino,21.0,2001.0,5.8,5,2,3,2,0,2,3,66.7,1,3,1,2,1,6,1,0,Matches,2022-2023,Serie-A
Telasco Segovia,ve VEN,MF,Sampdoria,19.0,2003.0,0.0,0,0,0,0,0,0,0,,0,0,0,0,0,0,0,0,Matches,2022-2023,Serie-A
Jacopo Segre,it ITA,DF,Torino,25.0,1997.0,0.2,0,0,0,0,0,0,0,,0,0,0,0,0,0,0,0,Matches,2022-2023,Serie-A
Vivaldo Semedo,pt POR,"FW,MF",Udinese,17.0,2005.0,0.4,0,0,0,0,0,0,0,,0,1,0,1,0,0,1,0,Matches,2022-2023,Serie-A
Stefano Sensi,it ITA,MF,Monza,26.0,1995.0,18.0,41,26,25,13,3,18,48,37.5,30,13,3,10,20,61,4,0,Matches,2022-2023,Serie-A
Luigi Sepe,it ITA,GK,Salernitana,31.0,1991.0,17.0,0,0,0,0,0,0,1,0.0,1,0,0,0,0,0,0,0,Matches,2022-2023,Serie-A
Leonardo Sernicola,it ITA,DF,Cremonese,25.0,1997.0,25.7,45,33,25,13,7,29,43,67.4,14,23,6,17,38,83,55,0,Matches,2022-2023,Serie-A
Stephan El Shaarawy,it ITA,"DF,MF",Roma,29.0,1992.0,16.9,21,9,8,10,3,6,22,27.3,16,11,1,10,15,36,11,0,Matches,2022-2023,Serie-A
Eldor Shomurodov,uz UZB,FW,Spezia,27.0,1995.0,9.0,5,5,3,1,1,2,11,18.2,9,5,1,4,3,8,4,0,Matches,2022-2023,Serie-A
Eldor Shomurodov,uz UZB,FW,Roma,27.0,1995.0,1.3,1,0,1,0,0,0,2,0.0,2,1,0,1,1,2,0,0,Matches,2022-2023,Serie-A
Marco Silvestri,it ITA,GK,Udinese,31.0,1991.0,38.0,2,1,2,0,0,2,3,66.7,1,0,0,0,1,3,15,1,Matches,2022-2023,Serie-A
Giovanni Simeone,ar ARG,FW,Napoli,27.0,1995.0,4.5,12,3,3,5,4,3,8,37.5,5,2,1,1,1,13,4,0,Matches,2022-2023,Serie-A
Wilfried Singo,ci CIV,DF,Torino,21.0,2000.0,22.7,27,17,14,10,3,12,19,63.2,7,15,2,13,12,39,33,1,Matches,2022-2023,Serie-A
Salvatore Sirigu,it ITA,GK,Fiorentina,35.0,1987.0,1.0,0,0,0,0,0,0,0,,0,0,0,0,0,0,1,0,Matches,2022-2023,Serie-A
Leo Skiri Østigård,no NOR,DF,Napoli,22.0,1999.0,4.7,4,1,3,1,0,1,1,100.0,0,3,3,0,6,10,18,1,Matches,2022-2023,Serie-A
Łukasz Skorupski,pl POL,GK,Bologna,31.0,1991.0,37.0,2,1,2,0,0,1,2,50.0,1,0,0,0,0,2,19,2,Matches,2022-2023,Serie-A
Milan Škriniar,sk SVK,DF,Inter,27.0,1995.0,19.7,29,18,14,11,4,18,32,56.3,14,18,13,5,13,42,46,3,Matches,2022-2023,Serie-A
Chris Smalling,eng ENG,DF,Roma,32.0,1989.0,31.2,26,15,16,10,0,13,21,61.9,8,51,36,15,43,69,123,0,Matches,2022-2023,Serie-A
Ola Solbakken,no NOR,"MF,FW",Roma,23.0,1998.0,5.6,2,2,1,1,0,2,7,28.6,5,2,0,2,2,4,8,0,Matches,2022-2023,Serie-A
Brandon Soppy,fr FRA,DF,Udinese,20.0,2002.0,1.0,1,1,0,1,0,0,0,,0,4,0,4,1,2,1,0,Matches,2022-2023,Serie-A
Brandon Soppy,fr FRA,DF,Atalanta,20.0,2002.0,7.1,8,5,4,4,0,3,9,33.3,6,10,0,10,3,11,7,0,Matches,2022-2023,Serie-A
Roberto Soriano,it ITA,"FW,MF",Bologna,31.0,1991.0,14.7,31,16,9,16,6,13,25,52.0,12,23,2,21,6,37,14,0,Matches,2022-2023,Serie-A
Joaquin Sosa,uy URU,DF,Bologna,20.0,2002.0,7.6,6,2,5,1,0,4,18,22.2,14,5,3,2,6,12,31,0,Matches,2022-2023,Serie-A
Riccardo Sottil,it ITA,FW,Fiorentina,23.0,1999.0,9.3,4,3,2,0,2,2,5,40.0,3,2,0,2,0,4,0,0,Matches,2022-2023,Serie-A
Matìas Soulé,ar ARG,"MF,FW",Juventus,19.0,2003.0,4.7,7,4,3,2,2,5,7,71.4,2,7,1,6,3,10,3,0,Matches,2022-2023,Serie-A
Adama Soumaoro,fr FRA,DF,Bologna,30.0,1992.0,20.7,25,17,11,12,2,5,7,71.4,2,18,13,5,15,40,75,1,Matches,2022-2023,Serie-A
Leonardo Spinazzola,it ITA,DF,Roma,29.0,1993.0,18.4,15,8,7,6,2,8,23,34.8,15,13,3,10,9,24,25,0,Matches,2022-2023,Serie-A
Marco Sportiello,it ITA,GK,Atalanta,30.0,1992.0,14.9,1,0,1,0,0,1,3,33.3,2,0,0,0,0,1,2,0,Matches,2022-2023,Serie-A
Petar Stojanović,si SVN,DF,Empoli,26.0,1995.0,17.0,42,22,28,10,4,26,43,60.5,17,17,5,12,11,53,55,0,Matches,2022-2023,Serie-A
Gabriel Strefezza,br BRA,"FW,MF",Lecce,25.0,1997.0,27.1,50,24,18,20,12,27,53,50.9,26,36,3,33,16,66,15,0,Matches,2022-2023,Serie-A
Dávid Strelec,sk SVK,FW,Spezia,21.0,2001.0,1.9,2,2,0,1,1,2,2,100.0,0,0,0,0,0,2,0,0,Matches,2022-2023,Serie-A
Isaac Success,ng NGA,FW,Udinese,26.0,1996.0,20.2,8,4,2,5,1,3,8,37.5,5,13,2,11,4,12,18,0,Matches,2022-2023,Serie-A
Ibrahim Sulemana,gh GHA,MF,Hellas Verona,19.0,2003.0,7.2,19,13,10,7,2,6,12,50.0,6,8,2,6,14,33,15,0,Matches,2022-2023,Serie-A
Mile Svilar,rs SRB,GK,Roma,22.0,1999.0,3.0,0,0,0,0,0,0,0,,0,0,0,0,0,0,1,0,Matches,2022-2023,Serie-A
Wojciech Szczęsny,pl POL,GK,Juventus,32.0,1990.0,27.5,1,0,1,0,0,0,1,0.0,1,0,0,0,0,1,7,0,Matches,2022-2023,Serie-A
Benjamin Tahirovic,ba BIH,MF,Roma,19.0,2003.0,3.9,8,5,5,2,1,4,12,33.3,8,9,4,5,3,11,3,0,Matches,2022-2023,Serie-A
Adrien Tameze,cm CMR,MF,Hellas Verona,28.0,1994.0,33.7,51,30,21,26,4,28,63,44.4,35,51,14,37,37,88,55,2,Matches,2022-2023,Serie-A
Ciprian Tătărușanu,ro ROU,GK,Milan,36.0,1986.0,16.0,0,0,0,0,0,0,0,,0,0,0,0,1,1,2,0,Matches,2022-2023,Serie-A
Filippo Terracciano,it ITA,"DF,MF",Hellas Verona,19.0,2003.0,9.1,20,13,11,7,2,15,20,75.0,5,7,4,3,10,30,14,0,Matches,2022-2023,Serie-A
Pietro Terracciano,it ITA,GK,Fiorentina,32.0,1990.0,29.0,2,1,2,0,0,2,3,66.7,1,0,0,0,1,3,14,0,Matches,2022-2023,Serie-A
Aleksa Terzić,rs SRB,DF,Fiorentina,22.0,1999.0,10.4,16,9,9,4,3,11,21,52.4,10,13,4,9,5,21,16,0,Matches,2022-2023,Serie-A
Florian Thauvin,fr FRA,"FW,MF",Udinese,29.0,1993.0,6.1,2,1,0,2,0,2,13,15.4,11,5,0,5,2,4,2,0,Matches,2022-2023,Serie-A
Malick Thiaw,de GER,DF,Milan,20.0,2001.0,15.1,31,26,22,9,0,11,20,55.0,9,11,5,6,12,43,65,1,Matches,2022-2023,Serie-A
Kristian Thorstvedt,no NOR,MF,Sassuolo,23.0,1999.0,12.6,16,7,4,9,3,6,17,35.3,11,19,5,14,14,30,13,0,Matches,2022-2023,Serie-A
Jeremy Toljan,de GER,DF,Sassuolo,27.0,1994.0,29.7,36,23,17,14,5,22,33,66.7,11,31,14,17,18,54,60,1,Matches,2022-2023,Serie-A
Rafael Tolói,it ITA,DF,Atalanta,31.0,1990.0,30.9,69,44,37,32,0,35,64,54.7,29,42,18,24,57,126,88,1,Matches,2022-2023,Serie-A
Fikayo Tomori,eng ENG,DF,Milan,24.0,1997.0,30.7,70,34,44,25,1,22,34,64.7,12,46,25,21,29,99,88,1,Matches,2022-2023,Serie-A
Sandro Tonali,it ITA,MF,Milan,22.0,2000.0,30.1,64,41,35,24,5,27,44,61.4,17,34,9,25,25,89,26,1,Matches,2022-2023,Serie-A
Lorenzo Tonelli,it ITA,DF,Empoli,32.0,1990.0,0.2,0,0,0,0,0,0,1,0.0,1,0,0,0,0,0,0,0,Matches,2022-2023,Serie-A
William Troost-Ekong,ng NGA,DF,Salernitana,28.0,1993.0,4.9,11,3,7,4,0,6,7,85.7,1,7,4,3,6,17,10,0,Matches,2022-2023,Serie-A
Frank Tsadjout,it ITA,FW,Cremonese,23.0,1999.0,11.7,10,8,3,6,1,3,9,33.3,6,7,1,6,8,18,9,0,Matches,2022-2023,Serie-A
Alessandro Tuia,it ITA,DF,Lecce,32.0,1990.0,5.7,10,6,6,4,0,3,9,33.3,6,3,1,2,15,25,29,0,Matches,2022-2023,Serie-A
Martin Turk,si SVN,GK,Sampdoria,18.0,2003.0,4.0,0,0,0,0,0,0,0,,0,0,0,0,0,0,1,0,Matches,2022-2023,Serie-A
Destiny Udogie,it ITA,DF,Udinese,19.0,2002.0,30.0,71,45,42,24,5,34,59,57.6,25,34,6,28,36,107,25,0,Matches,2022-2023,Serie-A
Samir Ujkani,xk KVX,GK,Empoli,34.0,1988.0,0.1,0,0,0,0,0,0,0,,0,0,0,0,0,0,0,0,Matches,2022-2023,Serie-A
Samuel Umtiti,fr FRA,DF,Lecce,28.0,1993.0,23.5,52,34,25,25,2,18,26,69.2,8,26,14,12,26,78,79,0,Matches,2022-2023,Serie-A
Diego Valencia,cl CHI,"MF,FW",Salernitana,22.0,2000.0,2.6,8,5,4,2,2,2,9,22.2,7,10,1,9,1,9,2,0,Matches,2022-2023,Serie-A
Emanuele Valeri,it ITA,DF,Cremonese,23.0,1998.0,30.9,54,27,29,21,4,29,69,42.0,40,17,3,14,22,76,44,1,Matches,2022-2023,Serie-A
Mattia Valoti,it ITA,"MF,FW",Monza,28.0,1993.0,5.0,17,10,7,9,1,5,16,31.3,11,13,3,10,3,20,6,0,Matches,2022-2023,Serie-A
Johan Vásquez,mx MEX,DF,Cremonese,23.0,1998.0,20.1,41,26,34,7,0,18,39,46.2,21,27,20,7,45,86,93,1,Matches,2022-2023,Serie-A
Matías Vecino,uy URU,MF,Lazio,30.0,1991.0,18.8,47,27,13,23,11,23,48,47.9,25,33,10,23,16,63,39,1,Matches,2022-2023,Serie-A
Miguel Veloso,pt POR,MF,Hellas Verona,36.0,1986.0,12.9,33,10,20,12,1,16,26,61.5,10,26,6,20,6,39,14,0,Matches,2022-2023,Serie-A
Lorenzo Venuti,it ITA,DF,Fiorentina,27.0,1995.0,10.3,18,7,6,11,1,11,18,61.1,7,7,2,5,5,23,17,2,Matches,2022-2023,Serie-A
Daniele Verde,it ITA,"FW,MF",Spezia,26.0,1996.0,11.1,4,4,3,0,1,3,7,42.9,4,6,0,6,8,12,4,0,Matches,2022-2023,Serie-A
Simone Verdi,it ITA,"MF,FW",Hellas Verona,30.0,1992.0,12.2,15,10,7,5,3,6,17,35.3,11,8,1,7,0,15,2,0,Matches,2022-2023,Serie-A
Valerio Verre,it ITA,MF,Sampdoria,28.0,1994.0,7.5,14,7,6,5,3,8,17,47.1,9,9,1,8,9,23,3,0,Matches,2022-2023,Serie-A
Guglielmo Vicario,it ITA,GK,Empoli,25.0,1996.0,30.9,1,1,1,0,0,1,2,50.0,1,0,0,0,0,1,15,2,Matches,2022-2023,Serie-A
Ronaldo Vieira,eng ENG,MF,Torino,24.0,1998.0,0.2,1,0,0,1,0,1,1,100.0,0,0,0,0,0,1,2,0,Matches,2022-2023,Serie-A
Ronaldo Vieira,eng ENG,MF,Sampdoria,24.0,1998.0,9.1,18,10,4,12,2,10,13,76.9,3,15,5,10,13,31,10,2,Matches,2022-2023,Serie-A
Emanuel Vignato,it ITA,"MF,FW",Bologna,21.0,2000.0,2.7,4,4,2,2,0,2,4,50.0,2,2,0,2,3,7,0,0,Matches,2022-2023,Serie-A
Emanuel Vignato,it ITA,"MF,FW",Empoli,21.0,2000.0,0.6,2,0,2,0,0,0,0,,0,0,0,0,0,2,1,0,Matches,2022-2023,Serie-A
Samuele Vignato,it ITA,"MF,FW",Monza,18.0,2004.0,0.7,0,0,0,0,0,0,0,,0,1,0,1,0,0,0,0,Matches,2022-2023,Serie-A
Tonny Vilhena,nl NED,MF,Salernitana,27.0,1995.0,25.2,44,22,16,23,5,20,50,40.0,30,17,7,10,18,62,21,0,Matches,2022-2023,Serie-A
Gonzalo Villar,es ESP,MF,Sampdoria,24.0,1998.0,7.7,13,7,4,8,1,7,15,46.7,8,11,3,8,4,17,9,1,Matches,2022-2023,Serie-A
Matías Viña,uy URU,DF,Roma,24.0,1997.0,0.6,3,1,1,1,1,1,3,33.3,2,5,1,4,2,5,5,0,Matches,2022-2023,Serie-A
Dušan Vlahović,rs SRB,FW,Juventus,22.0,2000.0,21.4,11,6,0,7,4,4,10,40.0,6,10,3,7,3,14,8,1,Matches,2022-2023,Serie-A
Nikola Vlašić,hr CRO,"MF,FW",Torino,24.0,1997.0,30.3,32,21,9,16,7,15,34,44.1,19,25,2,23,10,42,14,0,Matches,2022-2023,Serie-A
Joel Voelkerling Persson,se SWE,"FW,MF",Lecce,19.0,2003.0,1.1,1,1,0,0,1,0,1,0.0,1,1,0,1,0,1,0,0,Matches,2022-2023,Serie-A
Mërgim Vojvoda,xk KVX,DF,Torino,27.0,1995.0,19.1,22,12,15,6,1,12,24,50.0,12,14,2,12,10,32,31,1,Matches,2022-2023,Serie-A
Cristian Volpato,it ITA,MF,Roma,18.0,2003.0,2.5,3,2,1,1,1,0,2,0.0,2,2,0,2,2,5,0,0,Matches,2022-2023,Serie-A
Lukáš Vorlický,cz CZE,"MF,FW",Atalanta,20.0,2002.0,0.3,0,0,0,0,0,0,0,,0,0,0,0,1,1,0,0,Matches,2022-2023,Serie-A
Aster Vranckx,be BEL,MF,Milan,19.0,2002.0,2.7,3,2,0,2,1,2,7,28.6,5,3,1,2,2,5,1,0,Matches,2022-2023,Serie-A
Stefan de Vrij,nl NED,DF,Inter,30.0,1992.0,21.6,28,18,19,9,0,8,14,57.1,6,18,10,8,40,68,80,0,Matches,2022-2023,Serie-A
Walace,br BRA,MF,Udinese,27.0,1995.0,35.4,82,39,42,31,9,41,90,45.6,49,47,12,35,51,133,51,1,Matches,2022-2023,Serie-A
Sebastian Walukiewicz,pl POL,DF,Empoli,22.0,2000.0,6.7,9,6,7,2,0,4,6,66.7,2,10,9,1,7,16,30,0,Matches,2022-2023,Serie-A
Georginio Wijnaldum,nl NED,MF,Roma,31.0,1990.0,8.5,4,3,1,3,0,0,2,0.0,2,7,1,6,2,6,3,0,Matches,2022-2023,Serie-A
Harry Winks,eng ENG,MF,Sampdoria,26.0,1996.0,19.1,27,12,7,18,2,14,43,32.6,29,14,8,6,24,51,24,0,Matches,2022-2023,Serie-A
Przemysław Wiśniewski,pl POL,DF,Spezia,24.0,1998.0,11.1,13,6,7,6,0,6,18,33.3,12,16,8,8,11,24,66,0,Matches,2022-2023,Serie-A
Gerard Yepes,es ESP,MF,Sampdoria,19.0,2002.0,2.2,5,3,2,3,0,1,3,33.3,2,3,0,3,4,9,3,0,Matches,2022-2023,Serie-A
Mattia Zaccagni,it ITA,FW,Lazio,27.0,1995.0,30.8,42,28,16,18,8,14,38,36.8,24,37,3,34,21,63,10,1,Matches,2022-2023,Serie-A
Denis Zakaria,ch SUI,MF,Juventus,25.0,1996.0,1.4,6,3,1,4,1,2,2,100.0,0,2,0,2,2,8,1,0,Matches,2022-2023,Serie-A
Nicola Zalewski,pl POL,DF,Roma,20.0,2002.0,24.4,45,26,25,15,5,22,71,31.0,49,27,1,26,31,76,23,0,Matches,2022-2023,Serie-A
Andre-Frank Zambo Anguissa,cm CMR,MF,Napoli,26.0,1995.0,33.9,53,32,16,29,8,16,64,25.0,48,50,4,46,49,102,25,0,Matches,2022-2023,Serie-A
Luca Zanimacchia,it ITA,"MF,FW",Cremonese,24.0,1998.0,8.3,21,13,11,6,4,8,21,38.1,13,9,0,9,9,30,5,0,Matches,2022-2023,Serie-A
Nicolò Zaniolo,it ITA,"MF,FW",Roma,23.0,1999.0,9.9,7,5,2,4,1,2,7,28.6,5,11,0,11,2,9,0,0,Matches,2022-2023,Serie-A
Alessandro Zanoli,it ITA,DF,Sampdoria,21.0,2000.0,17.1,22,14,14,6,2,8,17,47.1,9,19,15,4,12,34,39,0,Matches,2022-2023,Serie-A
Alessandro Zanoli,it ITA,DF,Napoli,21.0,2000.0,0.1,1,0,0,1,0,0,0,,0,0,0,0,0,1,1,0,Matches,2022-2023,Serie-A
Mattia Zanotti,it ITA,DF,Inter,19.0,2003.0,0.3,0,0,0,0,0,0,1,0.0,1,2,0,2,0,0,0,0,Matches,2022-2023,Serie-A
Duván Zapata,co COL,FW,Atalanta,31.0,1991.0,15.4,8,4,1,3,4,3,5,60.0,2,6,2,4,4,12,17,1,Matches,2022-2023,Serie-A
Davide Zappacosta,it ITA,DF,Atalanta,30.0,1992.0,16.3,34,18,17,12,5,15,22,68.2,7,23,2,21,9,43,16,0,Matches,2022-2023,Serie-A
Karim Zedadka,fr FRA,FW,Napoli,22.0,2000.0,0.2,0,0,0,0,0,0,0,,0,0,0,0,0,0,1,0,Matches,2022-2023,Serie-A
Deyovaisio Zeefuik,nl NED,DF,Hellas Verona,24.0,1998.0,0.1,1,1,0,1,0,0,0,,0,0,0,0,0,1,0,0,Matches,2022-2023,Serie-A
Marvin Zeegelaar,nl NED,DF,Udinese,31.0,1990.0,3.9,8,4,6,2,0,3,4,75.0,1,2,0,2,3,11,5,0,Matches,2022-2023,Serie-A
Alessio Zerbin,it ITA,FW,Napoli,23.0,1999.0,2.2,10,5,4,5,1,4,8,50.0,4,2,0,2,2,12,2,0,Matches,2022-2023,Serie-A
Piotr Zieliński,pl POL,MF,Napoli,28.0,1994.0,25.4,17,10,1,11,5,12,25,48.0,13,16,5,11,14,31,7,0,Matches,2022-2023,Serie-A
David Zima,cz CZE,DF,Torino,21.0,2000.0,4.5,9,5,5,4,0,3,4,75.0,1,7,2,5,9,18,11,2,Matches,2022-2023,Serie-A
Joshua Zirkzee,nl NED,FW,Bologna,21.0,2001.0,9.1,4,2,1,1,2,2,7,28.6,5,4,1,3,4,8,4,0,Matches,2022-2023,Serie-A
Jeroen Zoet,nl NED,GK,Spezia,31.0,1991.0,3.7,1,1,1,0,0,1,1,100.0,0,0,0,0,0,1,1,0,Matches,2022-2023,Serie-A
Nadir Zortea,it ITA,"DF,MF",Atalanta,23.0,1999.0,2.5,10,5,3,7,0,3,4,75.0,1,4,0,4,0,10,4,0,Matches,2022-2023,Serie-A
Nadir Zortea,it ITA,DF,Sassuolo,23.0,1999.0,7.3,15,8,12,2,1,9,14,64.3,5,10,4,6,4,19,21,0,Matches,2022-2023,Serie-A
Petar Zovko,ba BIH,GK,Spezia,20.0,2002.0,0.8,1,0,1,0,0,1,1,100.0,0,0,0,0,0,1,0,0,Matches,2022-2023,Serie-A
Szymon Żurkowski,pl POL,MF,Fiorentina,24.0,1997.0,0.4,0,0,0,0,0,0,0,,0,0,0,0,0,0,0,0,Matches,2022-2023,Serie-A
Szymon Żurkowski,pl POL,MF,Spezia,24.0,1997.0,4.7,9,3,4,4,1,2,15,13.3,13,9,2,7,4,13,6,0,Matches,2022-2023,Serie-A
Milan Đurić,ba BIH,FW,Hellas Verona,32.0,1990.0,15.2,2,1,1,0,1,1,3,33.3,2,7,4,3,1,3,24,0,Matches,2022-2023,Serie-A
Filip Đuričić,rs SRB,"MF,FW",Sampdoria,30.0,1992.0,24.1,43,22,18,20,5,14,32,43.8,18,19,6,13,7,50,8,0,Matches,2022-2023,Serie-A
Tammy Abraham,eng ENG,FW,Roma,25.0,1997.0,2.7,3,1,0,1,2,0,0,,0,1,0,1,0,3,4,0,Matches,2023-2024,Serie-A
Francesco Acerbi,it ITA,DF,Inter,35.0,1988.0,26.5,22,13,16,6,0,11,14,78.6,3,20,13,7,32,54,77,1,Matches,2023-2024,Serie-A
Yacine Adli,fr FRA,MF,Milan,23.0,2000.0,15.6,34,17,17,13,4,13,35,37.1,22,22,8,14,20,54,15,1,Matches,2023-2024,Serie-A
Michel Aebischer,ch SUI,MF,Bologna,26.0,1997.0,24.8,35,20,9,20,6,15,34,44.1,19,28,6,22,12,47,22,0,Matches,2023-2024,Serie-A
Lucien Agoume,fr FRA,MF,Inter,21.0,2002.0,0.1,0,0,0,0,0,0,0,,0,0,0,0,0,0,0,0,Matches,2023-2024,Serie-A
Marley Aké,fr FRA,FW,Udinese,22.0,2001.0,0.1,0,0,0,0,0,0,0,,0,0,0,0,0,0,0,0,Matches,2023-2024,Serie-A
Ebenezer Akinsanmiro,ng NGA,MF,Inter,18.0,2004.0,0.2,0,0,0,0,0,0,1,0.0,1,0,0,0,0,0,0,0,Matches,2023-2024,Serie-A
Jean-Daniel Akpa-Akpro,ci CIV,MF,Monza,30.0,1992.0,7.8,20,11,14,4,2,3,9,33.3,6,10,4,6,12,32,15,1,Matches,2023-2024,Serie-A
David Akpan Ankeye,ng NGA,FW,Genoa,21.0,2002.0,0.6,1,0,0,1,0,0,1,0.0,1,1,0,1,0,1,0,0,Matches,2023-2024,Serie-A
Luis Alberto,es ESP,MF,Lazio,30.0,1992.0,25.7,35,20,16,12,7,15,53,28.3,38,34,4,30,7,42,13,0,Matches,2023-2024,Serie-A
Carlos Alcaraz,ar ARG,MF,Juventus,20.0,2002.0,4.2,6,6,0,6,0,5,10,50.0,5,5,2,3,5,11,4,0,Matches,2023-2024,Serie-A
Pontus Almqvist,se SWE,"FW,MF",Lecce,24.0,1999.0,23.4,45,29,16,22,7,23,51,45.1,28,21,2,19,14,59,10,0,Matches,2023-2024,Serie-A
Lorenzo Amatucci,it ITA,MF,Fiorentina,19.0,2004.0,0.2,0,0,0,0,0,0,0,,0,0,0,0,0,0,0,0,Matches,2023-2024,Serie-A
Bruno Amione,ar ARG,DF,Hellas Verona,21.0,2002.0,6.4,11,3,9,2,0,4,5,80.0,1,4,2,2,9,20,19,2,Matches,2023-2024,Serie-A
Felipe Anderson,br BRA,"FW,MF",Lazio,30.0,1993.0,30.8,78,45,32,33,13,34,90,37.8,56,45,3,42,27,105,23,0,Matches,2023-2024,Serie-A
Angeliño,es ESP,DF,Roma,26.0,1997.0,12.7,21,11,12,6,3,11,19,57.9,8,11,5,6,12,33,37,1,Matches,2023-2024,Serie-A
Houssem Aouar,dz ALG,"MF,FW",Roma,25.0,1998.0,8.4,16,11,4,10,2,3,12,25.0,9,5,0,5,4,20,2,1,Matches,2023-2024,Serie-A
Simone Aresti,it ITA,GK,Cagliari,37.0,1986.0,0.0,0,0,0,0,0,0,0,,0,0,0,0,0,0,0,0,Matches,2023-2024,Serie-A
Marko Arnautović,at AUT,FW,Inter,34.0,1989.0,8.9,10,4,3,5,2,4,7,57.1,3,8,1,7,5,15,5,0,Matches,2023-2024,Serie-A
Kristjan Asllani,al ALB,MF,Inter,21.0,2002.0,8.7,7,2,3,4,0,2,11,18.2,9,9,3,6,11,18,8,0,Matches,2023-2024,Serie-A
Emil Audero,id IDN,GK,Inter,26.0,1997.0,3.7,0,0,0,0,0,0,0,,0,0,0,0,0,0,1,0,Matches,2023-2024,Serie-A
Tommaso Augello,it ITA,DF,Cagliari,28.0,1994.0,26.9,26,19,18,6,2,16,25,64.0,9,21,10,11,17,43,89,0,Matches,2023-2024,Serie-A
Carlos Augusto,br BRA,DF,Inter,24.0,1999.0,19.2,29,21,20,9,0,15,22,68.2,7,20,8,12,16,45,52,0,Matches,2023-2024,Serie-A
Yann Aurel Bisseck,de GER,DF,Inter,22.0,2000.0,10.0,14,6,10,3,1,6,9,66.7,3,10,7,3,5,19,23,0,Matches,2023-2024,Serie-A
Sardar Azmoun,ir IRN,"FW,MF",Roma,28.0,1995.0,6.5,8,5,2,5,1,4,8,50.0,4,4,1,3,3,11,6,1,Matches,2023-2024,Serie-A
Paulo Azzi,br BRA,"DF,MF",Cagliari,29.0,1994.0,10.6,19,11,10,6,3,9,18,50.0,9,11,2,9,16,35,23,0,Matches,2023-2024,Serie-A
Oussama El Azzouzi,ma MAR,MF,Bologna,22.0,2001.0,6.1,12,7,4,5,3,7,14,50.0,7,8,2,6,6,18,12,0,Matches,2023-2024,Serie-A
Milan Badelj,hr CRO,MF,Genoa,34.0,1989.0,28.2,51,27,23,24,4,24,61,39.3,37,45,13,32,50,101,54,1,Matches,2023-2024,Serie-A
Jaime Báez,uy URU,"FW,MF",Frosinone,28.0,1995.0,5.6,4,1,0,2,2,0,7,0.0,7,5,0,5,4,8,1,0,Matches,2023-2024,Serie-A
Nicola Bagnolini,it ITA,GK,Bologna,19.0,2004.0,0.1,0,0,0,0,0,0,0,,0,0,0,0,0,0,0,0,Matches,2023-2024,Serie-A
Nedim Bajrami,al ALB,"MF,FW",Sassuolo,24.0,1999.0,14.6,13,6,6,3,4,5,13,38.5,8,5,1,4,6,19,8,0,Matches,2023-2024,Serie-A
Mitchel Bakker,nl NED,DF,Atalanta,23.0,2000.0,4.2,7,3,6,1,0,2,12,16.7,10,5,0,5,3,10,6,0,Matches,2023-2024,Serie-A
Tommaso Baldanzi,it ITA,"MF,FW",Empoli,20.0,2003.0,8.3,4,2,1,1,2,3,10,30.0,7,7,0,7,2,6,0,0,Matches,2023-2024,Serie-A
Tommaso Baldanzi,it ITA,"FW,MF",Roma,20.0,2003.0,5.8,9,5,3,4,2,1,1,100.0,0,2,0,2,0,9,4,0,Matches,2023-2024,Serie-A
Lameck Banda,zm ZAM,FW,Lecce,22.0,2001.0,15.0,27,23,11,12,4,7,21,33.3,14,18,0,18,3,30,7,0,Matches,2023-2024,Serie-A
Daniel Bandeira,pt POR,MF,Hellas Verona,23.0,2000.0,5.0,6,5,1,4,1,3,7,42.9,4,3,0,3,3,9,9,0,Matches,2023-2024,Serie-A
Mattia Bani,it ITA,DF,Genoa,29.0,1993.0,25.6,26,10,18,7,1,11,22,50.0,11,51,31,20,22,48,116,1,Matches,2023-2024,Serie-A
Antonín Barák,cz CZE,"MF,FW",Fiorentina,28.0,1994.0,9.0,6,2,1,3,2,3,7,42.9,4,5,0,5,2,8,4,0,Matches,2023-2024,Serie-A
Nicolò Barella,it ITA,MF,Inter,26.0,1997.0,31.6,46,30,17,20,9,19,63,30.2,44,31,1,30,10,56,12,1,Matches,2023-2024,Serie-A
Enzo Barrenechea,ar ARG,MF,Frosinone,22.0,2001.0,31.2,65,42,28,29,8,28,70,40.0,42,47,12,35,27,92,61,2,Matches,2023-2024,Serie-A
Davide Bartesaghi,it ITA,"DF,MF",Milan,17.0,2005.0,0.9,2,0,1,1,0,2,4,50.0,2,1,1,0,0,2,7,0,Matches,2023-2024,Serie-A
Federico Baschirotto,it ITA,DF,Lecce,26.0,1996.0,36.6,21,12,16,5,0,8,15,53.3,7,42,26,16,23,44,144,1,Matches,2023-2024,Serie-A
Toma Bašić,hr CRO,MF,Salernitana,26.0,1996.0,12.9,20,13,10,9,1,10,27,37.0,17,18,6,12,14,34,29,0,Matches,2023-2024,Serie-A
Alessandro Bastoni,it ITA,DF,Inter,24.0,1999.0,25.2,46,33,31,12,3,26,40,65.0,14,25,11,14,23,69,48,1,Matches,2023-2024,Serie-A
Simone Bastoni,it ITA,"MF,DF",Empoli,26.0,1996.0,8.3,22,13,12,7,3,11,22,50.0,11,8,0,8,11,33,18,0,Matches,2023-2024,Serie-A
Reda Belahyane,ma MAR,MF,Hellas Verona,19.0,2004.0,1.0,1,1,0,1,0,1,1,100.0,0,0,0,0,1,2,0,0,Matches,2023-2024,Serie-A
Raoul Bellanova,it ITA,DF,Torino,23.0,2000.0,33.8,36,26,15,17,4,18,31,58.1,13,21,4,17,15,51,36,3,Matches,2023-2024,Serie-A
Andrea Belotti,it ITA,FW,Fiorentina,29.0,1993.0,10.5,8,3,1,5,2,5,12,41.7,7,8,1,7,2,10,3,0,Matches,2023-2024,Serie-A
Andrea Belotti,it ITA,FW,Roma,29.0,1993.0,7.5,8,4,2,3,3,3,6,50.0,3,7,0,7,2,10,3,0,Matches,2023-2024,Serie-A
Lucas Beltrán,ar ARG,"FW,MF",Fiorentina,22.0,2001.0,18.8,27,14,4,18,5,11,20,55.0,9,29,3,26,2,29,11,0,Matches,2023-2024,Serie-A
Ismaël Bennacer,dz ALG,MF,Milan,25.0,1997.0,12.8,29,19,11,16,2,11,22,50.0,11,12,4,8,12,41,9,2,Matches,2023-2024,Serie-A
Domenico Berardi,it ITA,FW,Sassuolo,28.0,1994.0,15.9,17,8,7,9,1,2,21,9.5,19,17,0,17,13,30,9,0,Matches,2023-2024,Serie-A
Bartosz Bereszyński,pl POL,DF,Empoli,31.0,1992.0,19.6,41,25,25,13,3,24,40,60.0,16,22,10,12,21,62,52,0,Matches,2023-2024,Serie-A
Etrit Berisha,al ALB,GK,Empoli,34.0,1989.0,14.0,0,0,0,0,0,0,1,0.0,1,0,0,0,0,0,7,1,Matches,2023-2024,Serie-A
Medon Berisha,al ALB,"FW,MF",Lecce,19.0,2003.0,2.3,3,1,3,0,0,0,2,0.0,2,2,2,0,1,4,0,0,Matches,2023-2024,Serie-A
Victor Bernth Kristiansen,dk DEN,DF,Bologna,20.0,2002.0,25.6,52,34,23,22,7,20,35,57.1,15,35,8,27,12,64,45,1,Matches,2023-2024,Serie-A
Beto,gw GNB,FW,Udinese,25.0,1998.0,0.8,1,0,0,0,1,0,0,,0,0,0,0,0,1,0,0,Matches,2023-2024,Serie-A
Davide Bettella,it ITA,MF,Monza,23.0,2000.0,0.0,0,0,0,0,0,0,0,,0,0,0,0,0,0,0,0,Matches,2023-2024,Serie-A
Sam Beukema,nl NED,DF,Bologna,24.0,1998.0,28.3,27,11,14,11,2,16,25,64.0,9,35,21,14,15,42,99,2,Matches,2023-2024,Serie-A
Jaka Bijol,si SVN,DF,Udinese,24.0,1999.0,23.2,43,27,34,9,0,22,35,62.9,13,36,21,15,23,66,140,1,Matches,2023-2024,Serie-A
El Bilal Touré,ml MLI,FW,Atalanta,21.0,2001.0,4.4,1,1,0,1,0,0,1,0.0,1,0,0,0,1,2,2,0,Matches,2023-2024,Serie-A
Cristiano Biraghi,it ITA,DF,Fiorentina,30.0,1992.0,26.2,47,28,20,24,3,28,52,53.8,24,30,5,25,14,61,43,0,Matches,2023-2024,Serie-A
Davide Biraschi,it ITA,DF,Genoa,29.0,1994.0,1.0,3,3,1,2,0,1,3,33.3,2,0,0,0,2,5,5,0,Matches,2023-2024,Serie-A
Samuele Birindelli,it ITA,DF,Monza,24.0,1999.0,22.4,28,19,16,7,5,14,25,56.0,11,30,11,19,18,46,48,0,Matches,2023-2024,Serie-A
Alexis Blin,fr FRA,MF,Lecce,26.0,1996.0,18.2,33,19,11,19,3,15,43,34.9,28,16,2,14,22,55,39,0,Matches,2023-2024,Serie-A
Jérôme Boateng,de GER,DF,Salernitana,34.0,1988.0,2.6,0,0,0,0,0,0,0,,0,6,5,1,4,4,21,0,Matches,2023-2024,Serie-A
Emil Bohinen,no NOR,MF,Genoa,24.0,1999.0,0.6,1,1,0,1,0,0,0,,0,1,0,1,0,1,3,0,Matches,2023-2024,Serie-A
Emil Bohinen,no NOR,MF,Salernitana,24.0,1999.0,5.9,8,6,5,3,0,2,10,20.0,8,8,2,6,14,22,6,1,Matches,2023-2024,Serie-A
Daniel Boloca,ro ROU,MF,Sassuolo,24.0,1998.0,22.5,48,33,18,25,5,27,46,58.7,19,23,13,10,14,62,33,2,Matches,2023-2024,Serie-A
Giacomo Bonaventura,it ITA,MF,Fiorentina,33.0,1989.0,25.3,26,13,6,10,10,9,21,42.9,12,16,1,15,14,40,10,0,Matches,2023-2024,Serie-A
Federico Bonazzoli,it ITA,"FW,MF",Hellas Verona,26.0,1997.0,11.3,4,1,1,3,0,1,8,12.5,7,9,1,8,3,7,3,0,Matches,2023-2024,Serie-A
Warren Bondo,fr FRA,MF,Monza,19.0,2003.0,16.4,29,22,16,10,3,13,17,76.5,4,13,3,10,6,35,13,0,Matches,2023-2024,Serie-A
Giovanni Bonfanti,it ITA,DF,Atalanta,20.0,2003.0,1.0,4,2,2,2,0,2,3,66.7,1,1,1,0,1,5,1,0,Matches,2023-2024,Serie-A
Kevin Bonifazi,it ITA,DF,Bologna,27.0,1996.0,1.0,4,0,0,4,0,1,2,50.0,1,0,0,0,0,4,7,1,Matches,2023-2024,Serie-A
Kevin Bonifazi,it ITA,DF,Frosinone,27.0,1996.0,3.4,5,3,2,3,0,2,3,66.7,1,1,0,1,3,8,9,0,Matches,2023-2024,Serie-A
Gennaro Borrelli,it ITA,FW,Frosinone,23.0,2000.0,0.3,0,0,0,0,0,0,0,,0,0,0,0,0,0,0,0,Matches,2023-2024,Serie-A
Erik Botheim,no NOR,"FW,MF",Salernitana,23.0,2000.0,3.5,2,0,2,0,0,0,1,0.0,1,3,0,3,0,2,2,0,Matches,2023-2024,Serie-A
Mehdi Bourabia,ma MAR,MF,Frosinone,31.0,1991.0,2.2,5,4,1,4,0,2,4,50.0,2,3,0,3,0,5,4,0,Matches,2023-2024,Serie-A
Edoardo Bove,it ITA,MF,Roma,21.0,2002.0,19.8,60,31,16,31,13,27,46,58.7,19,21,1,20,11,71,11,1,Matches,2023-2024,Serie-A
Domagoj Bradarić,hr CRO,DF,Salernitana,23.0,1999.0,30.5,29,20,13,10,6,15,25,60.0,10,22,7,15,32,61,62,1,Matches,2023-2024,Serie-A
Josip Brekalo,hr CRO,FW,Fiorentina,25.0,1998.0,7.2,8,6,6,2,0,2,11,18.2,9,7,0,7,1,9,0,0,Matches,2023-2024,Serie-A
Gleison Bremer,br BRA,DF,Juventus,26.0,1997.0,35.9,58,42,32,21,5,21,29,72.4,8,45,27,18,40,98,147,0,Matches,2023-2024,Serie-A
Brenner,br BRA,"MF,FW",Udinese,23.0,2000.0,2.1,8,7,1,5,2,4,7,57.1,3,2,0,2,0,8,2,0,Matches,2023-2024,Serie-A
Marco Brescianini,it ITA,MF,Frosinone,23.0,2000.0,25.8,28,13,13,12,3,9,25,36.0,16,22,5,17,10,38,37,0,Matches,2023-2024,Serie-A
Dylan Bronn,tn TUN,"DF,MF",Salernitana,28.0,1995.0,0.6,0,0,0,0,0,0,1,0.0,1,2,0,2,0,0,4,0,Matches,2023-2024,Serie-A
Tajon Buchanan,ca CAN,DF,Inter,24.0,1999.0,1.8,1,1,0,0,1,1,2,50.0,1,1,0,1,0,1,4,0,Matches,2023-2024,Serie-A
Alessandro Buongiorno,it ITA,DF,Torino,24.0,1999.0,28.1,70,39,43,24,3,24,34,70.6,10,20,12,8,69,139,131,0,Matches,2023-2024,Serie-A
Rareș-Cătălin Burnete,ro ROU,FW,Lecce,19.0,2004.0,0.1,0,0,0,0,0,0,0,,0,0,0,0,0,0,0,0,Matches,2023-2024,Serie-A
Jovane Cabral,cv CPV,"MF,FW",Salernitana,25.0,1998.0,7.5,13,9,4,7,2,3,9,33.3,6,3,0,3,1,14,4,0,Matches,2023-2024,Serie-A
Liberato Cacace,nz NZL,DF,Empoli,22.0,2000.0,21.2,40,24,24,13,3,24,38,63.2,14,23,6,17,19,59,56,0,Matches,2023-2024,Serie-A
Jens Cajuste,se SWE,MF,Napoli,23.0,1999.0,11.3,36,24,13,17,6,20,37,54.1,17,20,3,17,4,40,15,0,Matches,2023-2024,Serie-A
Davide Calabria,it ITA,DF,Milan,26.0,1996.0,24.3,70,38,38,25,7,44,72,61.1,28,26,7,19,24,94,49,1,Matches,2023-2024,Serie-A
Riccardo Calafiori,it ITA,DF,Bologna,21.0,2002.0,26.1,47,32,28,16,3,22,32,68.8,10,38,13,25,50,97,74,3,Matches,2023-2024,Serie-A
Mattia Caldara,it ITA,DF,Milan,29.0,1994.0,0.4,1,1,1,0,0,1,1,100.0,0,1,1,0,1,2,1,0,Matches,2023-2024,Serie-A
Luca Caldirola,it ITA,DF,Monza,32.0,1991.0,23.8,25,14,19,4,2,13,22,59.1,9,26,17,9,29,54,53,0,Matches,2023-2024,Serie-A
Hakan Çalhanoğlu,tr TUR,MF,Inter,29.0,1994.0,28.4,66,33,29,29,8,32,49,65.3,17,29,13,16,24,90,22,0,Matches,2023-2024,Serie-A
Francesco Camarda,it ITA,FW,Milan,15.0,2008.0,0.2,0,0,0,0,0,0,2,0.0,2,0,0,0,0,0,0,0,Matches,2023-2024,Serie-A
Nicolò Cambiaghi,it ITA,"FW,MF",Empoli,22.0,2000.0,28.4,51,39,15,20,16,16,35,45.7,19,26,1,25,14,65,8,0,Matches,2023-2024,Serie-A
Andrea Cambiaso,it ITA,"DF,FW",Juventus,23.0,2000.0,26.4,47,30,23,15,9,25,43,58.1,18,28,3,25,11,58,26,1,Matches,2023-2024,Serie-A
Matteo Cancellieri,it ITA,"FW,MF",Empoli,21.0,2002.0,19.9,35,22,12,16,7,13,36,36.1,23,19,0,19,6,41,18,0,Matches,2023-2024,Serie-A
Antonio Candreva,it ITA,"MF,FW",Salernitana,36.0,1987.0,30.6,18,13,8,8,2,9,25,36.0,16,9,0,9,7,25,23,0,Matches,2023-2024,Serie-A
Luigi Canotto,it ITA,FW,Frosinone,29.0,1994.0,0.2,0,0,0,0,0,0,0,,0,0,0,0,0,0,0,0,Matches,2023-2024,Serie-A
Gianluca Caprari,it ITA,"MF,FW",Monza,30.0,1993.0,3.2,2,1,1,1,0,0,1,0.0,1,0,0,0,2,4,0,0,Matches,2023-2024,Serie-A
Elia Caprile,it ITA,GK,Empoli,21.0,2001.0,23.0,1,0,1,0,0,1,1,100.0,0,0,0,0,0,1,16,2,Matches,2023-2024,Serie-A
Francesco Caputo,it ITA,FW,Empoli,35.0,1987.0,14.1,2,0,0,0,2,0,1,0.0,1,4,0,4,1,3,3,0,Matches,2023-2024,Serie-A
Andrea Carboni,it ITA,DF,Monza,22.0,2001.0,16.5,38,22,24,12,2,20,31,64.5,11,23,13,10,17,55,56,1,Matches,2023-2024,Serie-A
Valentin Carboni,ar ARG,"MF,FW",Monza,18.0,2005.0,13.0,25,15,10,12,3,8,26,30.8,18,12,1,11,7,32,4,0,Matches,2023-2024,Serie-A
Marco Carnesecchi,it ITA,GK,Atalanta,23.0,2000.0,26.9,0,0,0,0,0,0,0,,0,0,0,0,0,0,22,3,Matches,2023-2024,Serie-A
Nicolò Casale,it ITA,DF,Lazio,25.0,1998.0,17.3,15,9,13,2,0,6,15,40.0,9,19,16,3,12,27,61,0,Matches,2023-2024,Serie-A
Giuseppe Caso,it ITA,"FW,MF",Frosinone,24.0,1998.0,4.6,4,3,2,0,2,2,3,66.7,1,0,0,0,0,4,0,0,Matches,2023-2024,Serie-A
Valentín Castellanos,ar ARG,FW,Lazio,24.0,1998.0,18.7,22,10,1,12,9,6,20,30.0,14,22,2,20,2,24,18,0,Matches,2023-2024,Serie-A
Samu Castillejo,es ESP,"FW,MF",Sassuolo,28.0,1995.0,6.0,12,10,5,5,2,7,19,36.8,12,16,1,15,1,13,3,0,Matches,2023-2024,Serie-A
Santiago Castro,ar ARG,FW,Bologna,18.0,2004.0,2.7,2,1,0,1,1,1,3,33.3,2,1,0,1,1,3,1,0,Matches,2023-2024,Serie-A
Gaetano Castrovilli,it ITA,"FW,MF",Fiorentina,26.0,1997.0,4.1,3,2,1,2,0,1,8,12.5,7,4,0,4,2,5,3,0,Matches,2023-2024,Serie-A
Danilo Cataldi,it ITA,MF,Lazio,28.0,1994.0,15.1,24,12,7,16,1,8,18,44.4,10,15,7,8,17,41,19,1,Matches,2023-2024,Serie-A
Emil Ceide,no NOR,"FW,MF",Sassuolo,21.0,2001.0,2.0,2,2,1,1,0,1,1,100.0,0,6,1,5,0,2,0,0,Matches,2023-2024,Serie-A
Zeki Çelik,tr TUR,DF,Roma,26.0,1997.0,7.5,23,16,10,10,3,14,25,56.0,11,12,5,7,8,31,25,0,Matches,2023-2024,Serie-A
Fabien Centonze,fr FRA,DF,Hellas Verona,27.0,1996.0,7.5,14,8,10,4,0,5,10,50.0,5,14,2,12,10,24,18,0,Matches,2023-2024,Serie-A
Michele Cerofolini,it ITA,GK,Frosinone,24.0,1999.0,7.5,0,0,0,0,0,0,0,,0,0,0,0,0,0,5,1,Matches,2023-2024,Serie-A
Alberto Cerri,it ITA,FW,Empoli,27.0,1996.0,6.1,3,3,1,1,1,2,5,40.0,3,3,1,2,3,6,7,0,Matches,2023-2024,Serie-A
Leonardo Cerri,it ITA,DF,Juventus,20.0,2003.0,0.1,0,0,0,0,0,0,0,,0,0,0,0,0,0,0,0,Matches,2023-2024,Serie-A
Charlys,br BRA,MF,Hellas Verona,19.0,2004.0,0.3,0,0,0,0,0,0,0,,0,0,0,0,1,1,0,0,Matches,2023-2024,Serie-A
Walid Cheddira,ma MAR,FW,Frosinone,25.0,1998.0,23.6,12,7,1,8,3,4,8,50.0,4,6,1,5,5,17,10,0,Matches,2023-2024,Serie-A
Federico Chiesa,it ITA,FW,Juventus,25.0,1997.0,24.4,20,10,7,6,7,3,13,23.1,10,17,1,16,6,26,4,0,Matches,2023-2024,Serie-A
Oliver Christensen,dk DEN,GK,Fiorentina,24.0,1999.0,4.0,0,0,0,0,0,0,0,,0,0,0,0,0,0,1,0,Matches,2023-2024,Serie-A
Samuel Chukwueze,ng NGA,FW,Milan,24.0,1999.0,11.3,18,7,11,5,2,9,17,52.9,8,3,1,2,6,24,3,0,Matches,2023-2024,Serie-A
Alphadjo Cissè,it ITA,FW,Hellas Verona,16.0,2006.0,0.1,0,0,0,0,0,0,0,,0,0,0,0,0,0,0,0,Matches,2023-2024,Serie-A
Giorgio Cittadini,it ITA,DF,Monza,21.0,2002.0,0.2,1,1,1,0,0,1,1,100.0,0,1,1,0,0,1,0,0,Matches,2023-2024,Serie-A
Giorgio Cittadini,it ITA,DF,Genoa,21.0,2002.0,1.2,5,4,4,1,0,3,3,100.0,0,1,0,1,3,8,5,0,Matches,2023-2024,Serie-A
Patrick Ciurria,it ITA,"DF,MF",Monza,28.0,1995.0,17.8,30,18,13,13,4,13,21,61.9,8,20,5,15,9,39,28,0,Matches,2023-2024,Serie-A
Lorenzo Colombo,it ITA,FW,Monza,21.0,2002.0,15.1,17,12,3,9,5,8,14,57.1,6,18,5,13,0,17,14,0,Matches,2023-2024,Serie-A
Andrea Colpani,it ITA,"MF,FW",Monza,24.0,1999.0,29.5,25,15,6,13,6,11,20,55.0,9,11,4,7,14,39,14,0,Matches,2023-2024,Serie-A
Pietro Comuzzo,it ITA,"DF,FW",Fiorentina,18.0,2005.0,0.5,1,1,1,0,0,1,1,100.0,0,1,0,1,1,2,2,0,Matches,2023-2024,Serie-A
Andrea Consigli,it ITA,GK,Sassuolo,36.0,1987.0,35.0,0,0,0,0,0,0,0,,0,1,0,1,1,1,19,1,Matches,2023-2024,Serie-A
Nikita Contini Baranovsky,it ITA,GK,Napoli,27.0,1996.0,0.2,0,0,0,0,0,0,0,,0,0,0,0,0,0,1,0,Matches,2023-2024,Serie-A
Diego Coppola,it ITA,DF,Hellas Verona,19.0,2003.0,18.2,36,22,25,9,2,20,33,60.6,13,26,9,17,27,63,89,1,Matches,2023-2024,Serie-A
Tommaso Corazza,it ITA,DF,Bologna,19.0,2004.0,2.2,10,4,9,1,0,4,9,44.4,5,2,0,2,5,15,3,0,Matches,2023-2024,Serie-A
Jeppe Corfitzen,dk DEN,FW,Lecce,18.0,2004.0,0.1,1,0,0,1,0,1,1,100.0,0,0,0,0,0,1,0,0,Matches,2023-2024,Serie-A
Giacomo Corona,it ITA,FW,Empoli,19.0,2004.0,0.1,0,0,0,0,0,0,0,,0,0,0,0,0,0,0,0,Matches,2023-2024,Serie-A
João Costa,br BRA,"MF,FW",Roma,18.0,2005.0,0.2,0,0,0,0,0,0,0,,0,0,0,0,0,0,0,0,Matches,2023-2024,Serie-A
Benoît Costil,fr FRA,GK,Salernitana,36.0,1987.0,13.0,2,1,1,1,0,2,3,66.7,1,0,0,0,0,2,5,1,Matches,2023-2024,Serie-A
Lassana Coulibaly,ml MLI,MF,Salernitana,27.0,1996.0,23.1,47,32,20,21,6,22,49,44.9,27,23,5,18,16,63,29,0,Matches,2023-2024,Serie-A
Mamadou Coulibaly,sn SEN,DF,Salernitana,24.0,1999.0,0.0,0,0,0,0,0,0,0,,0,0,0,0,0,0,0,0,Matches,2023-2024,Serie-A
Alessio Cragno,it ITA,GK,Sassuolo,29.0,1994.0,3.0,0,0,0,0,0,0,0,,0,0,0,0,0,0,3,1,Matches,2023-2024,Serie-A
Bryan Cristante,it ITA,"MF,DF",Roma,28.0,1995.0,36.5,72,41,33,28,11,28,50,56.0,22,36,6,30,25,97,55,2,Matches,2023-2024,Serie-A
Juan Cruz,ar ARG,"FW,MF",Hellas Verona,24.0,1999.0,1.2,2,2,0,0,2,0,0,,0,1,0,1,1,3,0,0,Matches,2023-2024,Serie-A
Juan Cuadrado,co COL,DF,Inter,35.0,1988.0,3.0,4,3,2,2,0,3,5,60.0,2,6,1,5,1,5,2,0,Matches,2023-2024,Serie-A
Marvin Cuni,al ALB,FW,Frosinone,22.0,2001.0,5.9,8,3,1,3,4,3,4,75.0,1,10,1,9,1,9,0,0,Matches,2023-2024,Serie-A
Danilo D'Ambrosio,it ITA,DF,Monza,34.0,1988.0,17.1,57,34,34,20,3,28,41,68.3,13,22,13,9,14,71,31,0,Matches,2023-2024,Serie-A
Flavius Daniliuc,at AUT,DF,Salernitana,22.0,2001.0,8.3,19,11,12,5,2,9,19,47.4,10,13,4,9,8,27,15,0,Matches,2023-2024,Serie-A
Danilo,br BRA,DF,Juventus,32.0,1991.0,27.2,60,36,38,18,4,32,48,66.7,16,34,15,19,37,97,94,0,Matches,2023-2024,Serie-A
Matteo Darmian,it ITA,DF,Inter,33.0,1989.0,26.7,48,22,23,15,10,20,53,37.7,33,27,11,16,13,61,55,0,Matches,2023-2024,Serie-A
Juan David Cabal,co COL,DF,Hellas Verona,22.0,2001.0,16.6,36,27,19,14,3,18,29,62.1,11,30,9,21,26,62,55,2,Matches,2023-2024,Serie-A
Keinan Davis,eng ENG,"FW,MF",Udinese,25.0,1998.0,2.1,0,0,0,0,0,0,0,,0,0,0,0,0,0,3,0,Matches,2023-2024,Serie-A
Paweł Dawidowicz,pl POL,DF,Hellas Verona,28.0,1995.0,23.8,53,30,33,18,2,17,29,58.6,12,17,9,8,24,77,114,1,Matches,2023-2024,Serie-A
Charles De Ketelaere,be BEL,"FW,MF",Atalanta,22.0,2001.0,22.5,33,21,3,12,18,10,20,50.0,10,30,2,28,7,40,6,0,Matches,2023-2024,Serie-A
Mattia De Sciglio,it ITA,DF,Juventus,30.0,1992.0,0.5,0,0,0,0,0,0,0,,0,1,0,1,1,1,2,0,Matches,2023-2024,Serie-A
Lorenzo De Silvestri,it ITA,DF,Bologna,35.0,1988.0,7.5,10,8,5,2,3,4,7,57.1,3,9,4,5,6,16,27,0,Matches,2023-2024,Serie-A
Koni De Winter,be BEL,DF,Genoa,21.0,2002.0,26.4,44,25,26,13,5,21,31,67.7,10,30,10,20,21,65,78,0,Matches,2023-2024,Serie-A
Grégoire Defrel,mq MTQ,"FW,MF",Sassuolo,32.0,1991.0,8.4,17,8,7,5,5,7,15,46.7,8,10,0,10,3,20,9,0,Matches,2023-2024,Serie-A
Alessandro Deiola,it ITA,MF,Cagliari,27.0,1995.0,17.9,33,19,13,16,4,18,47,38.3,29,16,6,10,9,42,37,0,Matches,2023-2024,Serie-A
Alessandro Dellavalle,it ITA,DF,Torino,19.0,2004.0,0.2,0,0,0,0,0,0,0,,0,1,1,0,1,1,0,0,Matches,2023-2024,Serie-A
Diego Demme,de GER,MF,Napoli,31.0,1991.0,0.8,1,1,0,1,0,0,1,0.0,1,0,0,0,0,1,0,0,Matches,2023-2024,Serie-A
Leander Dendoncker,be BEL,MF,Napoli,28.0,1995.0,0.3,0,0,0,0,0,0,0,,0,1,1,0,0,0,0,0,Matches,2023-2024,Serie-A
Mattia Destro,it ITA,"FW,MF",Empoli,32.0,1991.0,4.1,2,1,0,2,0,1,1,100.0,0,4,0,4,2,4,3,0,Matches,2023-2024,Serie-A
Federico Di Francesco,it ITA,"FW,MF",Lecce,29.0,1994.0,0.2,1,0,0,1,0,0,0,,0,0,0,0,0,1,0,0,Matches,2023-2024,Serie-A
Raffaele Di Gennaro,it ITA,GK,Inter,29.0,1993.0,0.3,0,0,0,0,0,0,0,,0,0,0,0,0,0,0,0,Matches,2023-2024,Serie-A
Michele Di Gregorio,it ITA,GK,Monza,26.0,1997.0,31.9,1,0,1,0,0,1,4,25.0,3,1,0,1,1,2,10,2,Matches,2023-2024,Serie-A
Giovanni Di Lorenzo,it ITA,DF,Napoli,29.0,1993.0,35.9,58,36,26,26,6,32,68,47.1,36,43,16,27,24,82,45,0,Matches,2023-2024,Serie-A
Alessandro Di Pardo,it ITA,"DF,MF",Cagliari,24.0,1999.0,4.0,4,1,3,0,1,0,3,0.0,3,9,2,7,5,9,7,0,Matches,2023-2024,Serie-A
Boulaye Dia,sn SEN,"FW,MF",Salernitana,26.0,1996.0,12.7,4,2,2,2,0,1,3,33.3,2,5,0,5,3,7,7,0,Matches,2023-2024,Serie-A
Federico Dimarco,it ITA,DF,Inter,25.0,1997.0,23.1,42,25,19,14,9,17,35,48.6,18,18,3,15,9,51,34,1,Matches,2023-2024,Serie-A
Tiago Djaló,pt POR,DF,Juventus,23.0,2000.0,0.2,0,0,0,0,0,0,0,,0,1,0,1,0,0,1,0,Matches,2023-2024,Serie-A
Koffi Djidji,ci CIV,DF,Torino,30.0,1992.0,8.4,14,9,9,5,0,3,4,75.0,1,10,5,5,10,24,20,0,Matches,2023-2024,Serie-A
Berat Djimsiti,al ALB,DF,Atalanta,30.0,1993.0,31.5,42,24,29,12,1,19,31,61.3,12,53,33,20,57,99,100,0,Matches,2023-2024,Serie-A
Dodô,br BRA,DF,Fiorentina,24.0,1998.0,5.8,5,3,1,4,0,2,5,40.0,3,2,0,2,5,10,11,0,Matches,2023-2024,Serie-A
Josh Doig,sct SCO,DF,Hellas Verona,21.0,2002.0,9.2,16,9,9,7,0,13,17,76.5,4,12,3,9,4,20,17,1,Matches,2023-2024,Serie-A
Josh Doig,sct SCO,DF,Sassuolo,21.0,2002.0,14.9,25,17,16,9,0,15,27,55.6,12,31,10,21,16,41,38,0,Matches,2023-2024,Serie-A
Nicolás Domínguez,ar ARG,MF,Bologna,25.0,1998.0,1.1,1,0,1,0,0,0,2,0.0,2,3,0,3,0,1,2,0,Matches,2023-2024,Serie-A
Giulio Donati,it ITA,DF,Monza,33.0,1990.0,0.4,0,0,0,0,0,0,0,,0,0,0,0,0,0,1,1,Matches,2023-2024,Serie-A
Patrick Dorgu,dk DEN,"DF,MF",Lecce,18.0,2004.0,17.4,43,22,22,17,4,22,34,64.7,12,16,5,11,9,52,45,2,Matches,2023-2024,Serie-A
Alberto Dossena,it ITA,DF,Cagliari,24.0,1998.0,33.1,55,35,43,12,0,32,48,66.7,16,50,27,23,45,100,172,2,Matches,2023-2024,Serie-A
Radu Drăgușin,ro ROU,DF,Genoa,21.0,2002.0,19.0,16,11,9,6,1,8,9,88.9,1,18,12,6,21,37,87,3,Matches,2023-2024,Serie-A
Ondrej Duda,sk SVK,MF,Hellas Verona,28.0,1994.0,27.3,59,39,17,35,7,31,52,59.6,21,29,12,17,26,85,21,0,Matches,2023-2024,Serie-A
Denzel Dumfries,nl NED,DF,Inter,27.0,1996.0,18.2,22,13,9,11,2,9,23,39.1,14,15,6,9,12,34,33,1,Matches,2023-2024,Serie-A
Alfred Duncan,gh GHA,MF,Fiorentina,30.0,1993.0,21.0,35,22,13,15,7,15,35,42.9,20,27,5,22,11,46,13,0,Matches,2023-2024,Serie-A
Paulo Dybala,ar ARG,"FW,MF",Roma,29.0,1993.0,21.8,22,13,3,10,9,2,18,11.1,16,12,0,12,3,25,6,1,Matches,2023-2024,Serie-A
Festy Ebosele,ie IRL,DF,Udinese,20.0,2002.0,18.9,33,20,23,9,1,21,35,60.0,14,33,2,31,10,43,27,0,Matches,2023-2024,Serie-A
Enzo Ebosse,cm CMR,DF,Udinese,24.0,1999.0,0.1,1,1,1,0,0,0,1,0.0,1,0,0,0,1,2,0,0,Matches,2023-2024,Serie-A
Tyronne Ebuehi,ng NGA,DF,Empoli,27.0,1995.0,12.2,14,9,9,5,0,7,11,63.6,4,9,4,5,6,20,27,1,Matches,2023-2024,Serie-A
Éderson,br BRA,MF,Atalanta,24.0,1999.0,31.9,83,49,38,38,7,44,63,69.8,19,48,8,40,41,124,33,1,Matches,2023-2024,Serie-A
Kingsley Ehizibue,nl NED,DF,Udinese,28.0,1995.0,10.6,22,14,16,4,2,11,18,61.1,7,21,3,18,8,30,36,0,Matches,2023-2024,Serie-A
Emmanuel Ekong,se SWE,FW,Empoli,21.0,2002.0,0.1,0,0,0,0,0,0,0,,0,0,0,0,0,0,0,0,Matches,2023-2024,Serie-A
Caleb Ekuban,gh GHA,FW,Genoa,29.0,1994.0,12.6,8,4,2,4,2,5,9,55.6,4,11,3,8,1,9,7,0,Matches,2023-2024,Serie-A
Elif Elmas,mk MKD,"FW,MF",Napoli,23.0,1999.0,3.8,4,3,1,3,0,2,2,100.0,0,2,0,2,2,6,8,0,Matches,2023-2024,Serie-A
Martin Erlic,hr CRO,DF,Sassuolo,25.0,1998.0,29.1,37,22,26,8,3,20,30,66.7,10,31,16,15,28,65,128,1,Matches,2023-2024,Serie-A
Giovanni Fabbian,it ITA,"MF,FW",Bologna,20.0,2003.0,11.7,17,10,9,7,1,7,12,58.3,5,5,2,3,7,24,11,0,Matches,2023-2024,Serie-A
Nicolò Fagioli,it ITA,MF,Juventus,22.0,2001.0,4.9,5,3,1,3,1,3,7,42.9,4,3,0,3,4,9,1,0,Matches,2023-2024,Serie-A
Wladimiro Falcone,it ITA,GK,Lecce,28.0,1995.0,38.0,0,0,0,0,0,0,0,,0,1,0,1,1,1,21,2,Matches,2023-2024,Serie-A
Davide Faraoni,it ITA,DF,Hellas Verona,31.0,1991.0,6.7,13,10,5,6,2,7,10,70.0,3,9,5,4,6,19,21,0,Matches,2023-2024,Serie-A
Davide Faraoni,it ITA,DF,Fiorentina,31.0,1991.0,4.4,9,4,5,2,2,5,11,45.5,6,3,1,2,5,14,14,0,Matches,2023-2024,Serie-A
Federico Fazio,ar ARG,DF,Salernitana,36.0,1987.0,15.1,18,11,14,4,0,8,14,57.1,6,22,19,3,17,35,99,1,Matches,2023-2024,Serie-A
Jacopo Fazzini,it ITA,MF,Empoli,20.0,2003.0,13.7,49,25,27,13,9,30,53,56.6,23,21,3,18,12,61,18,0,Matches,2023-2024,Serie-A
Lewis Ferguson,sct SCO,MF,Bologna,23.0,1999.0,30.1,37,21,16,17,4,16,37,43.2,21,25,8,17,17,54,27,1,Matches,2023-2024,Serie-A
Andrea Ferraris,it ITA,MF,Monza,20.0,2003.0,0.1,1,1,1,0,0,0,0,,0,0,0,0,0,1,0,0,Matches,2023-2024,Serie-A
João Ferreira,pt POR,DF,Udinese,22.0,2001.0,20.2,58,42,36,18,4,34,58,58.6,24,27,6,21,29,87,89,0,Matches,2023-2024,Serie-A
Seydou Fini,it ITA,"DF,FW",Genoa,17.0,2006.0,0.4,0,0,0,0,0,0,0,,0,0,0,0,0,0,0,0,Matches,2023-2024,Serie-A
Vincenzo Fiorillo,it ITA,GK,Salernitana,33.0,1990.0,4.0,0,0,0,0,0,0,0,,0,0,0,0,0,0,0,1,Matches,2023-2024,Serie-A
Alessandro Florenzi,it ITA,DF,Milan,32.0,1991.0,19.2,43,21,26,12,5,26,48,54.2,22,16,9,7,20,63,25,1,Matches,2023-2024,Serie-A
Michael Folorunsho,it ITA,"MF,FW",Hellas Verona,25.0,1998.0,30.9,50,28,21,22,7,23,57,40.4,34,45,12,33,17,67,44,2,Matches,2023-2024,Serie-A
Davide Frattesi,it ITA,MF,Inter,23.0,1999.0,10.6,10,6,3,7,0,4,8,50.0,4,9,3,6,5,15,19,0,Matches,2023-2024,Serie-A
Morten Frendrup,dk DEN,MF,Genoa,22.0,2001.0,34.9,133,72,47,70,16,55,91,60.4,36,55,14,41,51,184,42,1,Matches,2023-2024,Serie-A
Remo Freuler,ch SUI,MF,Bologna,31.0,1992.0,29.2,78,50,41,32,5,38,69,55.1,31,37,9,28,36,114,53,2,Matches,2023-2024,Serie-A
Gerardo Fusco,it ITA,FW,Salernitana,18.0,2005.0,0.2,0,0,0,0,0,0,0,,0,0,0,0,0,0,0,0,Matches,2023-2024,Serie-A
Matteo Gabbia,it ITA,DF,Milan,23.0,1999.0,14.2,29,20,15,13,1,18,24,75.0,6,11,6,5,10,39,48,0,Matches,2023-2024,Serie-A
Gianluca Gaetano,it ITA,"FW,MF",Cagliari,23.0,2000.0,8.3,7,4,0,4,3,2,7,28.6,5,4,0,4,3,10,4,0,Matches,2023-2024,Serie-A
Gianluca Gaetano,it ITA,MF,Napoli,23.0,2000.0,1.8,4,1,0,4,0,2,4,50.0,2,5,2,3,1,5,4,0,Matches,2023-2024,Serie-A
Roberto Gagliardini,it ITA,"MF,DF",Monza,29.0,1994.0,26.2,61,30,27,25,9,31,50,62.0,19,30,11,19,31,92,38,0,Matches,2023-2024,Serie-A
Pablo Galdames Millán,cl CHI,"MF,DF",Genoa,26.0,1996.0,0.1,0,0,0,0,0,0,0,,0,1,0,1,0,0,0,0,Matches,2023-2024,Serie-A
Antonino Gallo,it ITA,DF,Lecce,23.0,2000.0,27.7,43,27,31,11,1,31,49,63.3,18,34,9,25,25,68,67,0,Matches,2023-2024,Serie-A
Luca Garritano,it ITA,"MF,DF",Frosinone,29.0,1994.0,5.4,10,5,7,2,1,5,15,33.3,10,13,0,13,4,14,8,1,Matches,2023-2024,Serie-A
Federico Gatti,it ITA,DF,Juventus,25.0,1998.0,29.3,33,19,16,16,1,19,24,79.2,5,26,15,11,19,52,90,1,Matches,2023-2024,Serie-A
Francesco Gelli,it ITA,"MF,DF",Frosinone,26.0,1996.0,17.3,19,13,8,4,7,10,24,41.7,14,19,3,16,11,30,27,1,Matches,2023-2024,Serie-A
Luca Gemello,it ITA,GK,Torino,23.0,2000.0,2.0,0,0,0,0,0,0,1,0.0,1,0,0,0,0,0,1,1,Matches,2023-2024,Serie-A
Valentin Gendrey,fr FRA,DF,Lecce,23.0,2000.0,33.8,55,33,35,16,4,30,46,65.2,16,40,11,29,35,90,99,0,Matches,2023-2024,Serie-A
Farés Ghedjemis,fr FRA,"FW,MF",Frosinone,20.0,2002.0,2.0,2,0,1,0,1,0,2,0.0,2,2,0,2,1,3,2,0,Matches,2023-2024,Serie-A
Lautaro Gianetti,ar ARG,DF,Udinese,29.0,1993.0,7.0,9,4,7,2,0,4,5,80.0,1,10,6,4,19,28,39,0,Matches,2023-2024,Serie-A
Mario Gila,es ESP,DF,Lazio,22.0,2000.0,20.1,32,14,23,8,1,19,34,55.9,15,27,14,13,20,52,69,0,Matches,2023-2024,Serie-A
Gvidas Gineitis,lt LTU,MF,Torino,19.0,2004.0,6.0,11,7,3,8,0,4,7,57.1,3,10,4,6,4,15,9,1,Matches,2023-2024,Serie-A
Olivier Giroud,fr FRA,FW,Milan,36.0,1986.0,26.3,17,11,6,6,5,2,14,14.3,12,14,3,11,6,23,22,0,Matches,2023-2024,Serie-A
Edoardo Goldaniga,it ITA,DF,Cagliari,29.0,1993.0,11.2,12,7,9,3,0,4,10,40.0,6,11,7,4,15,27,37,1,Matches,2023-2024,Serie-A
Pierluigi Gollini,it ITA,GK,Napoli,28.0,1995.0,7.0,1,1,1,0,0,1,1,100.0,0,0,0,0,1,2,2,0,Matches,2023-2024,Serie-A
Papu Gómez,ar ARG,"MF,FW",Monza,35.0,1988.0,0.5,0,0,0,0,0,0,2,0.0,2,0,0,0,1,1,0,0,Matches,2023-2024,Serie-A
Iron Gomis,fr FRA,MF,Salernitana,23.0,1999.0,1.5,4,1,2,2,0,0,1,0.0,1,2,0,2,2,6,2,0,Matches,2023-2024,Serie-A
Joan Gonzàlez,es ESP,MF,Lecce,21.0,2002.0,14.3,31,18,16,12,3,17,28,60.7,11,20,3,17,5,36,9,0,Matches,2023-2024,Serie-A
Nicolás González,ar ARG,FW,Fiorentina,25.0,1998.0,21.3,28,18,15,8,5,8,28,28.6,20,26,1,25,12,40,9,0,Matches,2023-2024,Serie-A
Alberto Grassi,it ITA,MF,Empoli,28.0,1995.0,20.1,30,18,13,13,4,10,26,38.5,16,26,11,15,41,71,37,0,Matches,2023-2024,Serie-A
Mattéo Guendouzi,fr FRA,MF,Lazio,24.0,1999.0,26.3,34,15,11,18,5,21,49,42.9,28,24,6,18,21,55,24,1,Matches,2023-2024,Serie-A
Axel Guessand,fr FRA,DF,Udinese,18.0,2004.0,0.5,1,1,0,1,0,1,1,100.0,0,1,0,1,0,1,0,0,Matches,2023-2024,Serie-A
Albert Guðmundsson,is ISL,"FW,MF",Genoa,26.0,1997.0,33.5,23,10,8,10,5,12,44,27.3,32,15,2,13,11,34,13,0,Matches,2023-2024,Serie-A
Emmanuel Gyasi,gh GHA,"DF,FW",Empoli,29.0,1994.0,20.9,34,17,18,13,3,15,32,46.9,17,30,12,18,5,39,27,1,Matches,2023-2024,Serie-A
Norbert Gyömbér,sk SVK,DF,Salernitana,31.0,1992.0,19.6,36,18,30,6,0,20,26,76.9,6,33,23,10,23,59,77,2,Matches,2023-2024,Serie-A
Nicolas Haas,ch SUI,MF,Empoli,27.0,1996.0,1.0,5,3,1,2,2,3,3,100.0,0,1,0,1,1,6,1,0,Matches,2023-2024,Serie-A
Ridgeciano Haps,sr SUR,DF,Genoa,30.0,1993.0,8.6,7,6,3,2,2,5,8,62.5,3,3,0,3,6,13,11,1,Matches,2023-2024,Serie-A
Abdou Harroui,nl NED,"MF,FW",Frosinone,25.0,1998.0,11.3,23,11,11,11,1,8,16,50.0,8,19,3,16,5,28,8,0,Matches,2023-2024,Serie-A
Hans Hateboer,nl NED,DF,Atalanta,29.0,1994.0,12.4,12,5,8,2,2,5,15,33.3,10,21,7,14,4,16,21,0,Matches,2023-2024,Serie-A
Pantelis Hatzidiakos,gr GRE,DF,Cagliari,26.0,1997.0,9.5,22,10,12,10,0,10,17,58.8,7,14,5,9,13,35,30,1,Matches,2023-2024,Serie-A
Silvan Hefti,ch SUI,"MF,DF",Genoa,25.0,1997.0,1.3,6,1,2,3,1,4,7,57.1,3,2,0,2,0,6,1,0,Matches,2023-2024,Serie-A
Liam Henderson,sct SCO,MF,Empoli,27.0,1996.0,0.1,0,0,0,0,0,0,0,,0,0,0,0,0,0,0,0,Matches,2023-2024,Serie-A
Matheus Henrique,br BRA,MF,Sassuolo,25.0,1997.0,27.8,43,29,21,18,4,18,43,41.9,25,18,8,10,25,68,31,6,Matches,2023-2024,Serie-A
Thomas Henry,fr FRA,FW,Hellas Verona,28.0,1994.0,3.7,0,0,0,0,0,0,0,,0,0,0,0,0,0,5,0,Matches,2023-2024,Serie-A
Theo Hernández,fr FRA,DF,Milan,25.0,1997.0,31.0,30,17,19,11,0,11,22,50.0,11,33,13,20,23,53,42,1,Matches,2023-2024,Serie-A
Isak Hien,se SWE,DF,Hellas Verona,24.0,1999.0,9.6,17,10,10,7,0,10,19,52.6,9,12,5,7,7,24,33,1,Matches,2023-2024,Serie-A
Isak Hien,se SWE,DF,Atalanta,24.0,1999.0,10.4,18,12,8,10,0,7,15,46.7,8,12,5,7,14,32,33,0,Matches,2023-2024,Serie-A
Emil Holm,se SWE,DF,Atalanta,23.0,2000.0,10.5,28,19,17,9,2,16,36,44.4,20,25,3,22,7,35,25,0,Matches,2023-2024,Serie-A
Martin Hongla,cm CMR,MF,Hellas Verona,25.0,1998.0,12.0,24,13,9,13,2,8,11,72.7,3,8,3,5,7,31,24,0,Matches,2023-2024,Serie-A
Sydney van Hooijdonk,nl NED,FW,Bologna,23.0,2000.0,2.4,3,0,0,2,1,1,2,50.0,1,1,1,0,1,4,4,0,Matches,2023-2024,Serie-A
Dean Huijsen,es ESP,DF,Roma,18.0,2005.0,5.7,10,5,5,5,0,1,4,25.0,3,7,4,3,4,14,26,2,Matches,2023-2024,Serie-A
Dean Huijsen,es ESP,DF,Juventus,18.0,2005.0,0.1,0,0,0,0,0,0,0,,0,0,0,0,0,0,1,0,Matches,2023-2024,Serie-A
Elseid Hysaj,al ALB,DF,Lazio,29.0,1994.0,13.3,24,14,8,13,3,15,24,62.5,9,16,6,10,17,41,31,0,Matches,2023-2024,Serie-A
Arijon Ibrahimović,de GER,"FW,DF",Frosinone,17.0,2005.0,5.3,7,6,4,2,1,1,9,11.1,8,4,0,4,1,8,3,0,Matches,2023-2024,Serie-A
Jonathan Ikone,fr FRA,FW,Fiorentina,25.0,1998.0,18.7,22,11,7,9,6,10,17,58.8,7,12,0,12,3,25,8,0,Matches,2023-2024,Serie-A
Chukwubuikem Ikwuemesi,ng NGA,FW,Salernitana,21.0,2001.0,11.8,3,1,0,2,1,2,6,33.3,4,1,1,0,1,4,8,0,Matches,2023-2024,Serie-A
Ivan Ilić,rs SRB,MF,Torino,22.0,2001.0,23.3,22,8,9,10,3,13,27,48.1,14,20,7,13,20,42,31,0,Matches,2023-2024,Serie-A
Samuel Iling-Junior,eng ENG,"DF,MF",Juventus,19.0,2003.0,9.0,23,13,9,11,3,11,18,61.1,7,17,5,12,6,29,19,0,Matches,2023-2024,Serie-A
Ciro Immobile,it ITA,FW,Lazio,33.0,1990.0,18.4,11,9,2,5,4,3,14,21.4,11,9,3,6,5,16,11,0,Matches,2023-2024,Serie-A
Gino Infantino,ar ARG,MF,Fiorentina,20.0,2003.0,1.1,1,1,0,1,0,0,1,0.0,1,4,0,4,3,4,1,0,Matches,2023-2024,Serie-A
Gustav Isaksen,dk DEN,FW,Lazio,22.0,2001.0,11.9,4,3,2,1,1,1,9,11.1,8,11,1,10,4,8,4,0,Matches,2023-2024,Serie-A
Ardian Ismajli,al ALB,DF,Empoli,26.0,1996.0,22.7,26,16,18,6,2,18,23,78.3,5,28,17,11,23,49,126,1,Matches,2023-2024,Serie-A
Armando Izzo,it ITA,DF,Monza,31.0,1992.0,18.3,27,17,17,9,1,16,27,59.3,11,20,16,4,27,54,49,1,Matches,2023-2024,Serie-A
Filip Jagiełło,pl POL,MF,Genoa,25.0,1997.0,0.4,0,0,0,0,0,0,1,0.0,1,1,1,0,1,1,0,0,Matches,2023-2024,Serie-A
Jakub Jankto,cz CZE,"MF,FW",Cagliari,27.0,1996.0,9.7,12,9,9,1,2,8,20,40.0,12,5,1,4,5,17,20,0,Matches,2023-2024,Serie-A
Juan Jesus,br BRA,DF,Napoli,32.0,1991.0,23.5,42,19,28,12,2,23,33,69.7,10,23,12,11,23,65,67,1,Matches,2023-2024,Serie-A
Alejandro Jiménez,es ESP,DF,Milan,18.0,2005.0,0.8,2,1,2,0,0,2,5,40.0,3,0,0,0,0,2,4,0,Matches,2023-2024,Serie-A
Kaio Jorge,br BRA,FW,Frosinone,21.0,2002.0,9.0,6,4,0,1,5,3,4,75.0,1,6,0,6,1,7,0,0,Matches,2023-2024,Serie-A
Luka Jović,rs SRB,FW,Milan,25.0,1997.0,9.7,6,4,0,3,3,4,6,66.7,2,3,0,3,1,7,9,0,Matches,2023-2024,Serie-A
Hamed Junior Traorè,ci CIV,MF,Napoli,23.0,2000.0,4.2,4,2,2,0,2,1,6,16.7,5,3,0,3,2,6,1,1,Matches,2023-2024,Serie-A
Mohamed Kaba,fr FRA,MF,Lecce,21.0,2001.0,15.3,39,23,15,16,8,17,34,50.0,17,22,4,18,12,51,13,0,Matches,2023-2024,Serie-A
Christian Kabasele,be BEL,DF,Udinese,32.0,1991.0,9.6,10,7,4,5,1,2,11,18.2,9,15,9,6,12,22,56,0,Matches,2023-2024,Serie-A
Yayah Kallon,sl SLE,FW,Hellas Verona,22.0,2001.0,0.0,0,0,0,0,0,0,0,,0,0,0,0,0,0,0,0,Matches,2023-2024,Serie-A
Pierre Kalulu,fr FRA,DF,Milan,23.0,2000.0,4.2,5,1,2,3,0,1,2,50.0,1,4,3,1,1,6,12,1,Matches,2023-2024,Serie-A
Daichi Kamada,jp JPN,MF,Lazio,26.0,1996.0,17.2,53,36,22,22,9,28,52,53.8,24,24,5,19,18,71,7,0,Matches,2023-2024,Serie-A
Hassane Kamara,ci CIV,DF,Udinese,29.0,1994.0,24.7,45,32,26,13,6,25,38,65.8,13,29,2,27,26,71,66,0,Matches,2023-2024,Serie-A
Yann Karamoh,fr FRA,"MF,FW",Torino,25.0,1998.0,1.8,1,0,0,0,1,0,0,,0,0,0,0,0,1,1,0,Matches,2023-2024,Serie-A
Jesper Karlsson,se SWE,FW,Bologna,25.0,1998.0,3.8,3,3,2,1,0,2,8,25.0,6,4,0,4,4,7,1,0,Matches,2023-2024,Serie-A
Rick Karsdorp,nl NED,DF,Roma,28.0,1995.0,13.2,25,18,11,8,6,16,24,66.7,8,13,4,9,9,34,16,0,Matches,2023-2024,Serie-A
Grigoris Kastanos,cy CYP,"MF,DF",Salernitana,25.0,1998.0,16.4,23,14,8,9,6,9,20,45.0,11,13,4,9,8,31,9,0,Matches,2023-2024,Serie-A
Michael Kayode,it ITA,DF,Fiorentina,19.0,2004.0,22.9,53,30,27,15,11,35,48,72.9,13,25,12,13,18,71,46,2,Matches,2023-2024,Serie-A
Moise Kean,it ITA,FW,Juventus,23.0,2000.0,7.3,7,4,3,2,2,1,3,33.3,2,4,1,3,2,9,5,0,Matches,2023-2024,Serie-A
Simon Kjær,dk DEN,DF,Milan,34.0,1989.0,13.0,24,15,11,11,2,14,22,63.6,8,22,16,6,14,38,46,2,Matches,2023-2024,Serie-A
Davy Klaassen,nl NED,MF,Inter,30.0,1993.0,2.3,4,2,0,4,0,1,3,33.3,2,5,1,4,3,7,4,0,Matches,2023-2024,Serie-A
Sead Kolašinac,ba BIH,DF,Atalanta,30.0,1993.0,24.2,44,32,23,19,2,30,49,61.2,19,22,9,13,21,65,47,0,Matches,2023-2024,Serie-A
Teun Koopmeiners,nl NED,MF,Atalanta,25.0,1998.0,29.2,39,24,12,22,5,17,50,34.0,33,33,3,30,10,49,35,0,Matches,2023-2024,Serie-A
Filip Kostić,rs SRB,DF,Juventus,30.0,1992.0,20.2,37,23,20,13,4,17,33,51.5,16,29,8,21,9,46,43,0,Matches,2023-2024,Serie-A
Christian Kouamé,ci CIV,FW,Fiorentina,25.0,1997.0,12.1,13,4,7,6,0,6,10,60.0,4,16,0,16,2,15,10,0,Matches,2023-2024,Serie-A
Viktor Kovalenko,ua UKR,MF,Empoli,27.0,1996.0,6.8,5,2,2,2,1,2,8,25.0,6,12,2,10,1,6,7,0,Matches,2023-2024,Serie-A
Rasmus Kristensen,dk DEN,DF,Roma,26.0,1997.0,19.4,36,19,25,8,3,28,50,56.0,22,27,7,20,8,44,50,0,Matches,2023-2024,Serie-A
Thomas Kristensen,dk DEN,DF,Udinese,21.0,2002.0,23.3,35,24,25,10,0,21,33,63.6,12,29,20,9,29,64,118,0,Matches,2023-2024,Serie-A
Nikola Krstović,me MNE,FW,Lecce,23.0,2000.0,26.4,17,6,3,9,5,6,10,60.0,4,12,4,8,4,21,22,0,Matches,2023-2024,Serie-A
Rade Krunić,ba BIH,MF,Milan,29.0,1993.0,7.6,10,8,3,6,1,4,9,44.4,5,7,3,4,11,21,14,0,Matches,2023-2024,Serie-A
Marash Kumbulla,al ALB,DF,Sassuolo,23.0,2000.0,4.0,3,2,2,1,0,1,2,50.0,1,8,6,2,0,3,22,0,Matches,2023-2024,Serie-A
Justin Kumi,it ITA,FW,Sassuolo,19.0,2004.0,0.0,0,0,0,0,0,0,0,,0,0,0,0,0,0,0,0,Matches,2023-2024,Serie-A
Berkan Kutlu,tr TUR,MF,Genoa,25.0,1998.0,2.2,6,4,5,1,0,3,6,50.0,3,3,0,3,4,10,5,0,Matches,2023-2024,Serie-A
Khvicha Kvaratskhelia,ge GEO,FW,Napoli,22.0,2001.0,30.4,42,21,11,19,12,15,49,30.6,34,15,1,14,13,55,9,0,Matches,2023-2024,Serie-A
Giorgi Kvernadze,ge GEO,"FW,DF",Frosinone,20.0,2003.0,0.7,3,0,2,0,1,2,2,100.0,0,1,0,1,1,4,0,0,Matches,2023-2024,Serie-A
Giorgos Kyriakopoulos,gr GRE,DF,Monza,27.0,1996.0,19.0,19,10,16,3,0,11,24,45.8,13,18,1,17,13,32,28,0,Matches,2023-2024,Serie-A
Gianluca Lapadula,pe PER,FW,Cagliari,33.0,1990.0,13.4,1,1,0,0,1,1,10,10.0,9,2,1,1,2,3,5,0,Matches,2023-2024,Serie-A
Armand Lauriente,fr FRA,FW,Sassuolo,24.0,1998.0,32.3,31,20,8,14,9,13,44,29.5,31,29,4,25,15,46,11,0,Matches,2023-2024,Serie-A
Valentino Lazaro,at AUT,"DF,MF",Torino,27.0,1996.0,22.2,18,11,7,9,2,13,19,68.4,6,14,1,13,8,26,29,0,Matches,2023-2024,Serie-A
Darko Lazović,rs SRB,"FW,MF",Hellas Verona,32.0,1990.0,21.4,26,16,11,6,9,16,31,51.6,15,10,1,9,6,32,14,0,Matches,2023-2024,Serie-A
Manuel Lazzari,it ITA,DF,Lazio,29.0,1993.0,18.6,26,18,13,10,3,18,28,64.3,10,20,4,16,12,38,37,1,Matches,2023-2024,Serie-A
Nicola Leali,it ITA,GK,Genoa,30.0,1993.0,2.0,0,0,0,0,0,0,0,,0,0,0,0,0,0,0,0,Matches,2023-2024,Serie-A
Rafael Leão,pt POR,FW,Milan,24.0,1999.0,27.9,16,10,3,8,5,8,13,61.5,5,15,1,14,9,25,19,0,Matches,2023-2024,Serie-A
Jesper Lindstrøm,dk DEN,"FW,MF",Napoli,23.0,2000.0,4.8,8,3,2,3,3,4,8,50.0,4,3,0,3,2,10,6,0,Matches,2023-2024,Serie-A
Karol Linetty,pl POL,MF,Torino,28.0,1995.0,20.6,30,21,9,20,1,9,29,31.0,20,24,8,16,23,53,27,1,Matches,2023-2024,Serie-A
Luca Lipani,it ITA,MF,Sassuolo,18.0,2005.0,4.3,9,7,4,3,2,3,11,27.3,8,9,2,7,6,15,7,0,Matches,2023-2024,Serie-A
Pol Lirola,es ESP,DF,Frosinone,25.0,1997.0,17.1,30,18,14,15,1,17,35,48.6,18,12,1,11,19,49,41,1,Matches,2023-2024,Serie-A
Marcin Listkowski,pl POL,FW,Lecce,25.0,1998.0,0.1,0,0,0,0,0,0,0,,0,0,0,0,0,0,0,0,Matches,2023-2024,Serie-A
Diego Llorente,es ESP,DF,Roma,29.0,1993.0,24.1,31,19,20,10,1,11,24,45.8,13,40,27,13,22,53,79,0,Matches,2023-2024,Serie-A
Stanislav Lobotka,sk SVK,MF,Napoli,28.0,1994.0,36.5,61,39,18,30,13,24,60,40.0,36,30,8,22,30,91,29,0,Matches,2023-2024,Serie-A
Manuel Locatelli,it ITA,MF,Juventus,25.0,1998.0,33.4,69,43,24,35,10,31,58,53.4,27,43,17,26,25,94,65,0,Matches,2023-2024,Serie-A
Ruben Loftus-Cheek,eng ENG,MF,Milan,27.0,1996.0,23.0,28,18,7,14,7,15,27,55.6,12,24,12,12,9,37,10,1,Matches,2023-2024,Serie-A
Ademola Lookman,ng NGA,"FW,MF",Atalanta,25.0,1997.0,21.0,20,15,2,11,7,8,22,36.4,14,19,0,19,9,29,0,1,Matches,2023-2024,Serie-A
Maxime Lopez,fr FRA,MF,Fiorentina,25.0,1997.0,8.9,18,9,5,10,3,6,12,50.0,6,3,1,2,7,25,6,0,Matches,2023-2024,Serie-A
Maxime Lopez,fr FRA,MF,Sassuolo,25.0,1997.0,1.6,2,1,1,1,0,1,2,50.0,1,1,1,0,2,4,0,0,Matches,2023-2024,Serie-A
Matteo Lovato,it ITA,DF,Torino,23.0,2000.0,6.0,10,7,5,5,0,4,5,80.0,1,9,5,4,13,23,10,0,Matches,2023-2024,Serie-A
Matteo Lovato,it ITA,DF,Salernitana,23.0,2000.0,10.5,27,14,17,8,2,16,24,66.7,8,14,7,7,18,45,41,1,Matches,2023-2024,Serie-A
Sandi Lovrić,si SVN,MF,Udinese,25.0,1998.0,22.1,25,12,9,11,5,9,23,39.1,14,21,2,19,21,46,24,0,Matches,2023-2024,Serie-A
Lorenzo Lucca,it ITA,FW,Udinese,22.0,2000.0,28.8,19,11,4,11,4,5,20,25.0,15,18,3,15,3,22,36,1,Matches,2023-2024,Serie-A
Jhon Lucumí,co COL,DF,Bologna,25.0,1998.0,24.6,48,29,31,17,0,27,36,75.0,9,32,17,15,16,64,68,2,Matches,2023-2024,Serie-A
José Luis Palomino,ar ARG,DF,Atalanta,33.0,1990.0,0.3,2,1,1,1,0,1,1,100.0,0,2,1,1,1,3,6,0,Matches,2023-2024,Serie-A
Romelu Lukaku,be BEL,FW,Roma,30.0,1993.0,29.3,6,5,1,2,3,2,4,50.0,2,7,1,6,0,6,19,1,Matches,2023-2024,Serie-A
Karlo Lulić,hr CRO,MF,Frosinone,27.0,1996.0,0.2,0,0,0,0,0,0,0,,0,1,0,1,1,1,0,0,Matches,2023-2024,Serie-A
Sebastiano Luperto,it ITA,DF,Empoli,26.0,1996.0,37.8,37,26,25,10,2,15,24,62.5,9,46,35,11,32,69,157,1,Matches,2023-2024,Serie-A
Mateus Lusuardi,br BRA,DF,Frosinone,19.0,2004.0,2.4,2,1,1,1,0,1,3,33.3,2,4,2,2,4,6,8,0,Matches,2023-2024,Serie-A
Zito Luvumbo,ao ANG,"FW,MF",Cagliari,21.0,2002.0,21.6,9,6,5,2,2,4,15,26.7,11,19,0,19,1,10,2,0,Matches,2023-2024,Serie-A
Charalambos Lykogiannis,gr GRE,DF,Bologna,29.0,1993.0,10.0,10,6,5,4,1,5,10,50.0,5,15,5,10,5,15,30,0,Matches,2023-2024,Serie-A
Giulio Maggiore,it ITA,MF,Salernitana,25.0,1998.0,20.0,49,29,26,22,1,20,42,47.6,22,27,5,22,24,73,38,0,Matches,2023-2024,Serie-A
Giangiacomo Magnani,it ITA,DF,Hellas Verona,27.0,1995.0,27.2,33,18,23,10,0,15,25,60.0,10,50,28,22,45,78,118,0,Matches,2023-2024,Serie-A
Mike Maignan,fr FRA,GK,Milan,28.0,1995.0,29.0,1,0,1,0,0,1,1,100.0,0,1,0,1,1,2,4,3,Matches,2023-2024,Serie-A
Antoine Makoumbou,cg CGO,MF,Cagliari,25.0,1998.0,30.0,41,24,21,15,5,15,30,50.0,15,23,4,19,16,57,27,2,Matches,2023-2024,Serie-A
Daniel Maldini,it ITA,"MF,FW",Monza,21.0,2001.0,3.7,3,2,0,2,1,3,6,50.0,3,2,0,2,2,5,1,0,Matches,2023-2024,Serie-A
Daniel Maldini,it ITA,"FW,MF",Empoli,21.0,2001.0,2.9,4,2,0,2,2,2,2,100.0,0,5,0,5,2,6,2,0,Matches,2023-2024,Serie-A
Youssef Maleh,ma MAR,MF,Empoli,24.0,1998.0,28.9,74,48,30,36,8,23,52,44.2,29,62,7,55,25,99,29,0,Matches,2023-2024,Serie-A
Ruslan Malinovskyi,ua UKR,MF,Genoa,30.0,1993.0,17.2,35,20,18,11,6,17,41,41.5,24,22,8,14,5,40,16,0,Matches,2023-2024,Serie-A
Gianluca Mancini,it ITA,DF,Roma,27.0,1996.0,31.9,34,20,21,11,2,11,27,40.7,16,38,26,12,36,70,77,1,Matches,2023-2024,Serie-A
Marco Mancosu,it ITA,"MF,FW",Cagliari,34.0,1988.0,1.7,3,0,0,2,1,1,2,50.0,1,0,0,0,0,3,0,0,Matches,2023-2024,Serie-A
Christos Mandas,gr GRE,GK,Lazio,21.0,2001.0,8.0,0,0,0,0,0,0,1,0.0,1,0,0,0,1,1,3,1,Matches,2023-2024,Serie-A
Rolando Mandragora,it ITA,MF,Fiorentina,26.0,1997.0,17.6,26,11,8,13,5,10,22,45.5,12,14,3,11,9,35,18,1,Matches,2023-2024,Serie-A
Kostas Manolas,gr GRE,DF,Salernitana,32.0,1991.0,5.4,9,5,6,3,0,6,8,75.0,2,10,7,3,2,11,20,0,Matches,2023-2024,Serie-A
Riccardo Marchizza,it ITA,DF,Frosinone,25.0,1998.0,12.8,7,6,4,3,0,3,13,23.1,10,10,2,8,7,14,33,0,Matches,2023-2024,Serie-A
Gian Marco Ferrari,it ITA,DF,Sassuolo,31.0,1992.0,25.2,22,10,11,11,0,12,18,66.7,6,28,17,11,25,47,76,0,Matches,2023-2024,Serie-A
Pablo Marí,es ESP,DF,Monza,29.0,1993.0,29.1,41,25,34,7,0,22,34,64.7,12,40,25,15,37,78,115,1,Matches,2023-2024,Serie-A
Mirko Marić,hr CRO,FW,Monza,28.0,1995.0,3.2,4,0,2,1,1,0,2,0.0,2,4,0,4,2,6,3,0,Matches,2023-2024,Serie-A
Răzvan Marin,ro ROU,MF,Empoli,27.0,1996.0,20.2,40,22,13,23,4,19,29,65.5,10,16,4,12,6,46,30,2,Matches,2023-2024,Serie-A
Agustín Martegani,ar ARG,MF,Salernitana,23.0,2000.0,8.1,13,7,7,3,3,6,18,33.3,12,4,1,3,4,17,7,1,Matches,2023-2024,Serie-A
Aarón Martín,es ESP,DF,Genoa,26.0,1997.0,15.3,21,10,7,10,4,9,22,40.9,13,12,4,8,9,30,15,0,Matches,2023-2024,Serie-A
Tommaso Martinelli,it ITA,GK,Fiorentina,17.0,2006.0,1.0,0,0,0,0,0,0,0,,0,0,0,0,0,0,0,0,Matches,2023-2024,Serie-A
Josep Martinez,es ESP,GK,Genoa,25.0,1998.0,36.0,0,0,0,0,0,0,0,,0,0,0,0,1,1,21,3,Matches,2023-2024,Serie-A
Lautaro Martínez,ar ARG,FW,Inter,25.0,1997.0,29.5,22,16,4,13,5,4,19,21.1,15,30,1,29,20,42,10,0,Matches,2023-2024,Serie-A
Lucas Martínez Quarta,ar ARG,DF,Fiorentina,27.0,1996.0,25.5,75,47,43,28,4,36,54,66.7,18,38,14,24,30,105,69,4,Matches,2023-2024,Serie-A
Adam Marušić,me MNE,DF,Lazio,30.0,1992.0,34.4,45,31,24,19,2,27,49,55.1,22,27,7,20,29,74,63,2,Matches,2023-2024,Serie-A
Adam Masina,ma MAR,DF,Udinese,29.0,1994.0,0.7,4,0,2,2,0,2,4,50.0,2,2,1,1,2,6,5,0,Matches,2023-2024,Serie-A
Adam Masina,ma MAR,DF,Torino,29.0,1994.0,11.4,17,12,8,8,1,5,20,25.0,15,12,6,6,11,28,30,0,Matches,2023-2024,Serie-A
Alan Matturro,uy URU,DF,Genoa,18.0,2004.0,1.2,1,1,1,0,0,1,1,100.0,0,6,3,3,2,3,4,0,Matches,2023-2024,Serie-A
Luca Mazzitelli,it ITA,MF,Frosinone,27.0,1995.0,24.6,45,23,15,24,6,26,49,53.1,23,23,7,16,19,64,62,0,Matches,2023-2024,Serie-A
Pasquale Mazzocchi,it ITA,DF,Salernitana,28.0,1995.0,14.1,25,19,14,10,1,16,29,55.2,13,14,6,8,5,30,31,0,Matches,2023-2024,Serie-A
Pasquale Mazzocchi,it ITA,DF,Napoli,28.0,1995.0,4.8,5,2,1,2,2,2,3,66.7,1,5,1,4,1,6,13,0,Matches,2023-2024,Serie-A
Jordi Mboula,es ESP,"FW,MF",Hellas Verona,24.0,1999.0,3.4,4,4,1,2,1,4,7,57.1,3,4,1,3,1,5,0,0,Matches,2023-2024,Serie-A
Weston McKennie,us USA,"MF,DF",Juventus,24.0,1998.0,28.8,48,29,31,11,6,17,27,63.0,10,28,7,21,18,66,69,0,Matches,2023-2024,Serie-A
Arthur Melo,br BRA,MF,Fiorentina,26.0,1996.0,22.1,45,30,17,24,4,26,42,61.9,16,27,3,24,18,63,8,0,Matches,2023-2024,Serie-A
Leonardo Mendicino,it ITA,MF,Atalanta,17.0,2006.0,0.0,0,0,0,0,0,0,0,,0,0,0,0,0,0,0,0,Matches,2023-2024,Serie-A
Alex Meret,it ITA,GK,Napoli,26.0,1997.0,30.8,1,0,1,0,0,1,2,50.0,1,0,0,0,0,1,10,1,Matches,2023-2024,Serie-A
Junior Messias,br BRA,"MF,DF",Genoa,32.0,1991.0,11.7,26,20,19,5,2,8,19,42.1,11,9,1,8,5,31,22,0,Matches,2023-2024,Serie-A
Nikola Milenković,rs SRB,DF,Fiorentina,25.0,1997.0,27.9,41,21,24,14,3,22,36,61.1,14,22,14,8,27,68,95,1,Matches,2023-2024,Serie-A
Arkadiusz Milik,pl POL,FW,Juventus,29.0,1994.0,10.2,9,5,2,5,2,3,5,60.0,2,7,1,6,5,14,3,0,Matches,2023-2024,Serie-A
Vanja Milinković-Savić,rs SRB,GK,Torino,26.0,1997.0,36.0,1,0,1,0,0,1,1,100.0,0,0,0,0,1,2,14,4,Matches,2023-2024,Serie-A
Yerry Mina,co COL,"DF,MF",Fiorentina,28.0,1994.0,0.5,1,1,1,0,0,1,2,50.0,1,0,0,0,0,1,2,0,Matches,2023-2024,Serie-A
Yerry Mina,co COL,DF,Cagliari,28.0,1994.0,13.5,20,13,14,6,0,13,19,68.4,6,23,14,9,4,24,77,0,Matches,2023-2024,Serie-A
Aleksei Miranchuk,ru RUS,"MF,FW",Atalanta,27.0,1995.0,13.1,12,6,6,4,2,5,13,38.5,8,6,1,5,2,14,5,1,Matches,2023-2024,Serie-A
Kevin Miranda,it ITA,DF,Sassuolo,20.0,2003.0,0.2,0,0,0,0,0,0,0,,0,0,0,0,0,0,1,0,Matches,2023-2024,Serie-A
Antonio Mirante,it ITA,GK,Milan,40.0,1983.0,2.0,0,0,0,0,0,0,0,,0,0,0,0,0,0,1,0,Matches,2023-2024,Serie-A
Fabio Miretti,it ITA,MF,Juventus,19.0,2003.0,12.3,18,14,6,8,4,10,26,38.5,16,10,1,9,7,25,6,0,Matches,2023-2024,Serie-A
Filippo Missori,it ITA,DF,Sassuolo,19.0,2004.0,3.0,6,3,2,4,0,4,11,36.4,7,3,2,1,4,10,8,0,Matches,2023-2024,Serie-A
Stefan Mitrović,rs SRB,"FW,MF",Hellas Verona,20.0,2002.0,4.3,6,3,0,5,1,2,5,40.0,3,6,1,5,0,6,4,0,Matches,2023-2024,Serie-A
Henrikh Mkhitaryan,am ARM,MF,Inter,34.0,1989.0,30.9,62,34,18,35,9,24,49,49.0,25,23,4,19,29,91,43,0,Matches,2023-2024,Serie-A
Ilario Monterisi,it ITA,DF,Frosinone,21.0,2001.0,16.3,23,13,14,7,2,12,26,46.2,14,22,18,4,8,31,63,0,Matches,2023-2024,Serie-A
Lorenzo Montipò,it ITA,GK,Hellas Verona,27.0,1996.0,37.0,1,1,1,0,0,1,3,33.3,2,0,0,0,0,1,25,2,Matches,2023-2024,Serie-A
Nikola Moro,hr CRO,MF,Bologna,25.0,1998.0,9.3,21,16,8,12,1,8,15,53.3,7,14,1,13,7,28,10,0,Matches,2023-2024,Serie-A
Dany Mota,pt POR,"FW,MF",Monza,25.0,1998.0,22.8,13,7,2,5,6,8,17,47.1,9,4,1,3,2,15,18,0,Matches,2023-2024,Serie-A
Samuele Mulattieri,it ITA,"FW,MF",Sassuolo,22.0,2000.0,5.1,1,1,0,0,1,1,2,50.0,1,7,2,5,1,2,2,0,Matches,2023-2024,Serie-A
Luis Muriel,co COL,"FW,MF",Atalanta,32.0,1991.0,4.5,3,2,0,2,1,1,1,100.0,0,4,0,4,1,4,0,0,Matches,2023-2024,Serie-A
Yunus Musah,us USA,"MF,FW",Milan,20.0,2002.0,16.4,25,14,15,6,4,8,15,53.3,7,18,4,14,10,35,16,1,Matches,2023-2024,Serie-A
Juan Musso,ar ARG,GK,Atalanta,29.0,1994.0,11.0,1,0,1,0,0,1,1,100.0,0,0,0,0,0,1,6,0,Matches,2023-2024,Serie-A
Kingstone Mutandwa,zm ZAM,"FW,MF",Cagliari,20.0,2003.0,0.4,1,0,1,0,0,1,4,25.0,3,1,0,1,0,1,2,0,Matches,2023-2024,Serie-A
Obite N'Dicka,ci CIV,DF,Roma,23.0,1999.0,24.1,32,18,12,19,1,12,20,60.0,8,30,16,14,16,48,75,0,Matches,2023-2024,Serie-A
Nahitan Nández,uy URU,"MF,DF",Cagliari,27.0,1995.0,26.0,59,40,27,23,9,27,64,42.2,37,25,2,23,19,78,32,0,Matches,2023-2024,Serie-A
Natan,br BRA,DF,Napoli,22.0,2001.0,10.6,14,10,10,3,1,5,10,50.0,5,12,9,3,8,22,32,0,Matches,2023-2024,Serie-A
Lapo Nava,it ITA,GK,Milan,19.0,2004.0,0.0,0,0,0,0,0,0,0,,0,0,0,0,0,0,0,0,Matches,2023-2024,Serie-A
Michel Ndary Adopo,fr FRA,MF,Atalanta,23.0,2000.0,1.2,4,3,0,3,1,1,1,100.0,0,0,0,0,0,4,2,1,Matches,2023-2024,Serie-A
Dan Ndoye,ch SUI,"FW,MF",Bologna,22.0,2000.0,19.7,30,15,17,11,2,17,39,43.6,22,20,1,19,10,40,14,0,Matches,2023-2024,Serie-A
Cyril Ngonge,be BEL,"FW,MF",Hellas Verona,23.0,2000.0,15.9,14,9,5,3,6,5,14,35.7,9,7,1,6,4,18,10,0,Matches,2023-2024,Serie-A
Cyril Ngonge,be BEL,FW,Napoli,23.0,2000.0,3.5,5,3,1,4,0,2,2,100.0,0,2,0,2,0,5,2,0,Matches,2023-2024,Serie-A
M'Baye Niang,sn SEN,FW,Empoli,28.0,1994.0,7.9,3,1,0,1,2,0,6,0.0,6,7,1,6,3,6,10,0,Matches,2023-2024,Serie-A
Hans Nicolussi Caviglia,it ITA,MF,Juventus,23.0,2000.0,3.0,5,2,1,3,1,4,6,66.7,2,5,1,4,0,5,2,0,Matches,2023-2024,Serie-A
Joseph Nonge,be BEL,MF,Juventus,18.0,2005.0,0.3,0,0,0,0,0,0,0,,0,0,0,0,0,0,1,0,Matches,2023-2024,Serie-A
Tijjani Noslin,nl NED,"FW,MF",Hellas Verona,24.0,1999.0,14.9,18,8,5,7,6,6,16,37.5,10,17,2,15,2,20,14,0,Matches,2023-2024,Serie-A
Simeon Nwankwo,ng NGA,FW,Salernitana,31.0,1992.0,7.6,6,3,0,2,4,1,3,33.3,2,7,0,7,0,6,4,0,Matches,2023-2024,Serie-A
M'Bala Nzola,ao ANG,FW,Fiorentina,26.0,1996.0,17.2,11,8,1,4,6,6,7,85.7,1,10,1,9,0,11,22,0,Matches,2023-2024,Serie-A
Adam Obert,sk SVK,DF,Cagliari,20.0,2002.0,10.5,17,9,8,8,1,8,17,47.1,9,13,7,6,21,38,41,1,Matches,2023-2024,Serie-A
Pedro Obiang,gq EQG,MF,Sassuolo,31.0,1992.0,5.0,8,4,3,4,1,2,10,20.0,8,6,4,2,8,16,10,0,Matches,2023-2024,Serie-A
Guillermo Ochoa,mx MEX,GK,Salernitana,38.0,1985.0,21.0,0,0,0,0,0,0,1,0.0,1,0,0,0,0,0,9,1,Matches,2023-2024,Serie-A
Jens Odgaard,dk DEN,"FW,MF",Bologna,24.0,1999.0,4.8,4,4,1,1,2,1,3,33.3,2,9,0,9,1,5,3,0,Matches,2023-2024,Serie-A
Noah Okafor,ch SUI,"FW,MF",Milan,23.0,2000.0,9.9,6,4,1,4,1,3,10,30.0,7,8,1,7,0,6,10,0,Matches,2023-2024,Serie-A
David Okereke,ng NGA,"FW,MF",Torino,25.0,1997.0,2.8,3,1,1,1,1,0,3,0.0,3,2,0,2,1,4,0,0,Matches,2023-2024,Serie-A
Caleb Okoli,it ITA,DF,Frosinone,22.0,2001.0,32.4,56,34,33,22,1,29,44,65.9,15,48,32,16,29,85,156,4,Matches,2023-2024,Serie-A
Maduka Okoye,ng NGA,GK,Udinese,23.0,1999.0,21.0,0,0,0,0,0,0,0,,0,0,0,0,1,1,4,2,Matches,2023-2024,Serie-A
Mathías Olivera,uy URU,DF,Napoli,25.0,1997.0,17.4,50,29,29,15,6,23,39,59.0,16,35,6,29,20,70,25,0,Matches,2023-2024,Serie-A
Gaetano Oristanio,it ITA,"FW,MF",Cagliari,20.0,2002.0,12.3,20,10,5,14,1,5,17,29.4,12,11,0,11,9,29,8,0,Matches,2023-2024,Serie-A
Riccardo Orsolini,it ITA,"FW,MF",Bologna,26.0,1997.0,19.9,23,14,13,4,6,9,30,30.0,21,25,3,22,8,31,19,1,Matches,2023-2024,Serie-A
Victor Osimhen,ng NGA,FW,Napoli,24.0,1998.0,22.0,9,5,0,4,5,2,4,50.0,2,5,1,4,2,11,18,0,Matches,2023-2024,Serie-A
Remi Oudin,fr FRA,"MF,FW",Lecce,26.0,1996.0,20.2,26,14,12,12,2,12,19,63.2,7,13,1,12,20,46,22,0,Matches,2023-2024,Serie-A
Anthony Oyono,ga GAB,DF,Frosinone,22.0,2001.0,13.3,37,26,21,14,2,23,34,67.6,11,17,3,14,9,46,32,0,Matches,2023-2024,Serie-A
Simone Pafundi,it ITA,MF,Udinese,17.0,2006.0,0.1,0,0,0,0,0,0,0,,0,0,0,0,0,0,0,0,Matches,2023-2024,Serie-A
Riccardo Pagano,it ITA,"MF,DF",Roma,18.0,2004.0,0.6,2,2,1,1,0,0,6,0.0,6,3,2,1,0,2,2,0,Matches,2023-2024,Serie-A
Christos Papadopoulos,gr GRE,FW,Genoa,18.0,2004.0,0.0,0,0,0,0,0,0,1,0.0,1,0,0,0,0,0,0,0,Matches,2023-2024,Serie-A
Leandro Paredes,ar ARG,MF,Roma,29.0,1994.0,29.3,57,36,30,22,5,33,77,42.9,44,26,7,19,29,86,43,1,Matches,2023-2024,Serie-A
Fabiano Parisi,it ITA,DF,Fiorentina,22.0,2000.0,16.2,30,15,11,12,7,15,26,57.7,11,21,5,16,17,47,26,0,Matches,2023-2024,Serie-A
Mario Pašalić,hr CRO,MF,Atalanta,28.0,1995.0,22.8,28,17,9,18,1,14,31,45.2,17,29,6,23,16,44,34,0,Matches,2023-2024,Serie-A
Triantafyllos Pasaridīs,gr GRE,DF,Salernitana,27.0,1996.0,5.0,11,7,9,2,0,9,14,64.3,5,7,3,4,3,14,19,0,Matches,2023-2024,Serie-A
Patric,es ESP,DF,Lazio,30.0,1993.0,17.9,13,8,10,3,0,8,18,44.4,10,15,9,6,6,19,44,0,Matches,2023-2024,Serie-A
Rui Patrício,pt POR,GK,Roma,35.0,1988.0,23.0,0,0,0,0,0,0,1,0.0,1,1,0,1,0,0,3,1,Matches,2023-2024,Serie-A
Benjamin Pavard,fr FRA,DF,Inter,27.0,1996.0,18.6,34,21,21,11,2,20,24,83.3,4,25,15,10,32,66,44,1,Matches,2023-2024,Serie-A
Leonardo Pavoletti,it ITA,FW,Cagliari,34.0,1988.0,7.0,1,1,0,0,1,0,1,0.0,1,2,1,1,0,1,7,0,Matches,2023-2024,Serie-A
Martín Payero,ar ARG,MF,Udinese,24.0,1998.0,20.0,54,32,28,19,7,19,46,41.3,27,25,7,18,15,69,21,0,Matches,2023-2024,Serie-A
Marcus Pedersen,no NOR,DF,Sassuolo,23.0,2000.0,17.9,36,24,25,5,6,21,25,84.0,4,19,5,14,10,46,51,0,Matches,2023-2024,Serie-A
Pedro,es ESP,"FW,MF",Lazio,36.0,1987.0,9.1,16,12,5,7,4,3,12,25.0,9,16,2,14,3,19,1,0,Matches,2023-2024,Serie-A
Pietro Pellegri,it ITA,FW,Torino,22.0,2001.0,8.4,5,1,1,4,0,1,5,20.0,4,4,1,3,2,7,3,0,Matches,2023-2024,Serie-A
Lorenzo Pellegrini,it ITA,MF,Roma,27.0,1996.0,20.7,35,20,14,16,5,17,51,33.3,34,28,5,23,20,55,22,0,Matches,2023-2024,Serie-A
Luca Pellegrini,it ITA,DF,Lazio,24.0,1999.0,8.7,18,13,7,10,1,9,17,52.9,8,7,3,4,9,27,20,0,Matches,2023-2024,Serie-A
Marco Pellegrino,ar ARG,DF,Salernitana,21.0,2002.0,6.1,8,6,4,3,1,5,10,50.0,5,11,6,5,10,18,28,0,Matches,2023-2024,Serie-A
Marco Pellegrino,ar ARG,DF,Milan,21.0,2002.0,0.8,1,1,0,0,1,0,2,0.0,2,1,1,0,1,2,2,0,Matches,2023-2024,Serie-A
Pepín,gq EQG,"MF,FW",Monza,26.0,1996.0,2.7,6,1,1,4,1,2,4,50.0,2,5,2,3,0,6,6,0,Matches,2023-2024,Serie-A
Pedro Pereira,pt POR,DF,Monza,25.0,1998.0,9.3,19,13,14,4,1,9,17,52.9,8,15,2,13,4,23,18,0,Matches,2023-2024,Serie-A
Roberto Pereyra,ar ARG,"FW,MF",Udinese,32.0,1991.0,20.6,19,9,11,5,3,11,29,37.9,18,20,4,16,7,26,18,0,Matches,2023-2024,Serie-A
Nehuén Pérez,ar ARG,DF,Udinese,23.0,2000.0,36.0,72,48,42,28,2,39,48,81.3,9,53,26,27,45,117,158,1,Matches,2023-2024,Serie-A
Simone Perilli,it ITA,GK,Hellas Verona,28.0,1995.0,1.0,0,0,0,0,0,0,0,,0,0,0,0,0,0,0,0,Matches,2023-2024,Serie-A
Mattia Perin,it ITA,GK,Juventus,30.0,1992.0,2.5,0,0,0,0,0,0,0,,0,0,0,0,0,0,1,0,Matches,2023-2024,Serie-A
Samuele Perisan,it ITA,GK,Empoli,25.0,1997.0,1.0,0,0,0,0,0,0,0,,0,0,0,0,0,0,0,0,Matches,2023-2024,Serie-A
Matteo Pessina,it ITA,MF,Monza,26.0,1997.0,35.8,44,25,20,20,4,23,49,46.9,26,29,11,18,27,71,46,1,Matches,2023-2024,Serie-A
Andrea Petagna,it ITA,FW,Cagliari,28.0,1995.0,11.1,4,2,1,0,3,1,2,50.0,1,6,3,3,1,5,4,0,Matches,2023-2024,Serie-A
Giuseppe Pezzella,it ITA,DF,Empoli,25.0,1997.0,12.1,25,14,19,5,1,20,28,71.4,8,17,6,11,2,27,35,0,Matches,2023-2024,Serie-A
Roberto Piccoli,it ITA,FW,Empoli,22.0,2001.0,0.4,1,1,0,0,1,1,1,100.0,0,0,0,0,0,1,0,0,Matches,2023-2024,Serie-A
Roberto Piccoli,it ITA,FW,Lecce,22.0,2001.0,15.3,10,6,3,5,2,1,4,25.0,3,17,1,16,4,14,16,0,Matches,2023-2024,Serie-A
Santiago Pierotti,ar ARG,"MF,FW",Lecce,22.0,2001.0,2.2,8,8,2,5,1,2,8,25.0,6,5,0,5,1,9,0,0,Matches,2023-2024,Serie-A
Niccolò Pierozzi,it ITA,DF,Salernitana,21.0,2001.0,9.7,17,11,13,4,0,11,22,50.0,11,24,7,17,11,28,36,0,Matches,2023-2024,Serie-A
Andrea Pinamonti,it ITA,FW,Sassuolo,24.0,1999.0,34.2,13,8,1,6,6,5,22,22.7,17,19,2,17,1,14,40,0,Matches,2023-2024,Serie-A
Carlo Pinsoglio,it ITA,GK,Juventus,33.0,1990.0,0.5,0,0,0,0,0,0,0,,0,0,0,0,0,0,0,0,Matches,2023-2024,Serie-A
Lorenzo Pirola,it ITA,DF,Salernitana,21.0,2002.0,22.1,39,23,25,14,0,15,28,53.6,13,46,30,16,25,64,93,1,Matches,2023-2024,Serie-A
Niccolò Pisilli,it ITA,MF,Roma,18.0,2004.0,0.1,0,0,0,0,0,0,0,,0,0,0,0,0,0,0,0,Matches,2023-2024,Serie-A
Tommaso Pobega,it ITA,MF,Milan,24.0,1999.0,3.5,16,9,11,5,0,6,13,46.2,7,10,2,8,6,22,7,0,Matches,2023-2024,Serie-A
Paul Pogba,fr FRA,MF,Juventus,30.0,1993.0,0.6,1,1,0,1,0,1,1,100.0,0,0,0,0,1,2,1,0,Matches,2023-2024,Serie-A
Matteo Politano,it ITA,FW,Napoli,29.0,1993.0,26.2,19,8,8,7,4,11,34,32.4,23,9,1,8,15,34,11,1,Matches,2023-2024,Serie-A
Marin Pongračić,hr CRO,DF,Lecce,25.0,1997.0,35.8,43,30,22,20,1,19,25,76.0,6,37,26,11,51,94,130,1,Matches,2023-2024,Serie-A
Stefan Posch,at AUT,DF,Bologna,26.0,1997.0,26.8,77,46,35,38,4,49,88,55.7,39,27,8,19,18,95,72,0,Matches,2023-2024,Serie-A
Matteo Prati,it ITA,MF,Cagliari,19.0,2003.0,21.9,45,25,15,27,3,26,42,61.9,16,29,6,23,15,60,26,1,Matches,2023-2024,Serie-A
Ivan Provedel,it ITA,GK,Lazio,29.0,1994.0,30.0,1,0,1,0,0,1,3,33.3,2,0,0,0,0,1,12,1,Matches,2023-2024,Serie-A
Christian Pulisic,us USA,"FW,MF",Milan,24.0,1998.0,28.9,35,26,14,11,10,17,30,56.7,13,20,1,19,10,45,10,1,Matches,2023-2024,Serie-A
George Pușcaș,ro ROU,FW,Genoa,27.0,1996.0,2.1,0,0,0,0,0,0,3,0.0,3,1,0,1,0,0,1,0,Matches,2023-2024,Serie-A
Domingos Quina,pt POR,MF,Udinese,23.0,1999.0,0.1,1,1,1,0,0,0,0,,0,0,0,0,0,1,0,0,Matches,2023-2024,Serie-A
Adrien Rabiot,fr FRA,MF,Juventus,28.0,1995.0,29.5,58,39,22,30,6,30,45,66.7,15,26,6,20,25,83,34,0,Matches,2023-2024,Serie-A
Uroš Račić,rs SRB,MF,Sassuolo,25.0,1998.0,9.1,10,4,6,4,0,0,9,0.0,9,16,7,9,7,17,22,0,Matches,2023-2024,Serie-A
Nemanja Radonjić,rs SRB,"MF,FW",Torino,27.0,1996.0,4.2,1,1,0,0,1,1,3,33.3,2,3,0,3,0,1,0,0,Matches,2023-2024,Serie-A
Boris Radunović,rs SRB,GK,Cagliari,27.0,1996.0,7.0,0,0,0,0,0,0,0,,0,0,0,0,1,1,1,2,Matches,2023-2024,Serie-A
Hamza Rafia,tn TUN,MF,Lecce,24.0,1999.0,13.4,44,31,13,27,4,13,30,43.3,17,27,1,26,11,55,13,0,Matches,2023-2024,Serie-A
Ylber Ramadani,al ALB,MF,Lecce,27.0,1996.0,33.0,68,41,32,29,7,37,96,38.5,59,54,13,41,44,112,44,0,Matches,2023-2024,Serie-A
Luca Ranieri,it ITA,DF,Fiorentina,24.0,1999.0,22.9,14,10,11,1,2,8,13,61.5,5,25,11,14,29,43,64,0,Matches,2023-2024,Serie-A
Filippo Ranocchia,it ITA,"MF,DF",Empoli,22.0,2001.0,5.3,16,11,7,9,0,7,16,43.8,9,9,1,8,3,19,14,0,Matches,2023-2024,Serie-A
Giacomo Raspadori,it ITA,"FW,MF",Napoli,23.0,2000.0,17.6,21,10,6,10,5,6,15,40.0,9,15,1,14,3,24,7,0,Matches,2023-2024,Serie-A
Federico Ravaglia,it ITA,GK,Bologna,23.0,1999.0,5.9,0,0,0,0,0,0,0,,0,0,0,0,0,0,2,0,Matches,2023-2024,Serie-A
Tijjani Reijnders,nl NED,MF,Milan,25.0,1998.0,31.3,46,25,10,31,5,21,43,48.8,22,26,8,18,18,64,26,0,Matches,2023-2024,Serie-A
Reinier,br BRA,"MF,FW",Frosinone,21.0,2002.0,11.8,21,10,6,12,3,5,17,29.4,12,24,4,20,10,31,5,0,Matches,2023-2024,Serie-A
Mateo Retegui,it ITA,FW,Genoa,24.0,1999.0,24.6,17,9,7,8,2,6,20,30.0,14,18,2,16,0,17,30,0,Matches,2023-2024,Serie-A
Samuele Ricci,it ITA,MF,Torino,21.0,2001.0,26.6,33,18,17,12,4,15,23,65.2,8,21,3,18,27,60,25,0,Matches,2023-2024,Serie-A
Ricardo Rodríguez,ch SUI,DF,Torino,30.0,1992.0,30.8,45,26,21,22,2,28,45,62.2,17,22,9,13,24,69,64,2,Matches,2023-2024,Serie-A
Alessio Romagnoli,it ITA,DF,Lazio,28.0,1995.0,26.8,25,18,14,11,0,16,24,66.7,8,29,17,12,29,54,115,0,Matches,2023-2024,Serie-A
Simone Romagnoli,it ITA,DF,Frosinone,33.0,1990.0,30.2,35,15,23,11,1,15,20,75.0,5,51,36,15,29,64,147,0,Matches,2023-2024,Serie-A
Luka Romero,ar ARG,"FW,MF",Milan,18.0,2004.0,1.0,0,0,0,0,0,0,3,0.0,3,2,0,2,0,0,0,0,Matches,2023-2024,Serie-A
Marten de Roon,nl NED,"MF,DF",Atalanta,32.0,1991.0,28.9,80,43,36,32,12,35,82,42.7,47,36,10,26,40,120,54,0,Matches,2023-2024,Serie-A
Francesco Rossi,it ITA,GK,Atalanta,32.0,1991.0,0.1,0,0,0,0,0,0,0,,0,0,0,0,0,0,0,0,Matches,2023-2024,Serie-A
Nicolò Rovella,it ITA,MF,Lazio,21.0,2001.0,14.6,46,28,25,17,4,16,36,44.4,20,27,6,21,23,69,29,0,Matches,2023-2024,Serie-A
Amir Rrahmani,xk KVX,DF,Napoli,29.0,1994.0,28.9,33,27,17,14,2,16,32,50.0,16,24,10,14,20,53,90,0,Matches,2023-2024,Serie-A
Ruan,br BRA,DF,Sassuolo,24.0,1999.0,16.8,25,15,11,10,4,10,18,55.6,8,18,15,3,24,49,68,2,Matches,2023-2024,Serie-A
Daniele Rugani,it ITA,DF,Juventus,29.0,1994.0,13.2,11,9,7,3,1,4,5,80.0,1,11,4,7,9,20,42,0,Matches,2023-2024,Serie-A
Matteo Ruggeri,it ITA,DF,Atalanta,21.0,2002.0,27.2,29,15,14,7,8,16,30,53.3,14,46,4,42,23,52,44,0,Matches,2023-2024,Serie-A
Mário Rui,pt POR,DF,Napoli,32.0,1991.0,13.4,27,15,17,5,5,14,21,66.7,7,17,2,15,15,42,19,0,Matches,2023-2024,Serie-A
Stefano Sabelli,it ITA,DF,Genoa,30.0,1993.0,27.0,50,24,28,19,3,15,46,32.6,31,27,6,21,23,73,35,0,Matches,2023-2024,Serie-A
Alexis Saelemaekers,be BEL,"FW,MF",Bologna,24.0,1999.0,21.0,32,22,13,14,5,12,27,44.4,15,13,1,12,13,45,10,1,Matches,2023-2024,Serie-A
Lazar Samardzic,rs SRB,MF,Udinese,21.0,2002.0,26.4,40,19,18,18,4,16,39,41.0,23,26,6,20,10,50,25,0,Matches,2023-2024,Serie-A
Junior Sambia,fr FRA,"DF,MF",Salernitana,26.0,1996.0,11.5,12,5,8,1,3,6,11,54.5,5,15,7,8,11,23,28,0,Matches,2023-2024,Serie-A
Antonio Sanabria,py PAR,"FW,MF",Torino,27.0,1996.0,23.7,18,15,5,9,4,4,9,44.4,5,7,1,6,6,24,12,0,Matches,2023-2024,Serie-A
Renato Sanches,pt POR,MF,Roma,25.0,1997.0,1.6,2,1,1,1,0,2,3,66.7,1,2,0,2,0,2,1,0,Matches,2023-2024,Serie-A
Alexis Sánchez,cl CHI,"FW,MF",Inter,34.0,1988.0,8.5,7,6,0,5,2,1,4,25.0,3,4,1,3,1,8,3,0,Matches,2023-2024,Serie-A
Alex Sandro,br BRA,DF,Juventus,32.0,1991.0,8.0,13,7,7,6,0,4,5,80.0,1,13,7,6,15,28,23,0,Matches,2023-2024,Serie-A
Nicola Sansone,it ITA,"FW,MF",Lecce,31.0,1991.0,8.5,11,6,6,2,3,5,16,31.3,11,7,1,6,4,15,5,2,Matches,2023-2024,Serie-A
Riccardo Saponara,it ITA,"FW,MF",Hellas Verona,31.0,1991.0,3.8,3,1,2,0,1,1,7,14.3,6,4,0,4,0,3,2,0,Matches,2023-2024,Serie-A
Zanos Savva,cy CYP,"DF,MF",Torino,17.0,2005.0,0.3,1,1,0,1,0,1,3,33.3,2,0,0,0,0,1,1,0,Matches,2023-2024,Serie-A
Saba Sazonov,ge GEO,DF,Torino,21.0,2002.0,4.0,9,7,4,5,0,3,3,100.0,0,8,5,3,3,12,22,0,Matches,2023-2024,Serie-A
Giorgio Scalvini,it ITA,DF,Atalanta,19.0,2003.0,28.3,53,33,29,19,5,19,40,47.5,21,44,17,27,59,112,71,0,Matches,2023-2024,Serie-A
Gianluca Scamacca,it ITA,FW,Atalanta,24.0,1999.0,16.1,15,9,4,5,6,7,14,50.0,7,7,1,6,4,19,9,0,Matches,2023-2024,Serie-A
Perr Schuurs,nl NED,DF,Torino,23.0,1999.0,8.6,20,12,11,8,1,3,9,33.3,6,10,2,8,9,29,23,0,Matches,2023-2024,Serie-A
Simone Scuffet,it ITA,GK,Cagliari,27.0,1996.0,31.0,1,0,1,0,0,1,2,50.0,1,1,0,1,1,2,9,0,Matches,2023-2024,Serie-A
Demba Seck,sn SEN,MF,Torino,22.0,2001.0,4.7,5,3,1,4,0,3,4,75.0,1,1,0,1,1,6,0,0,Matches,2023-2024,Serie-A
Demba Seck,sn SEN,"FW,MF",Frosinone,22.0,2001.0,3.3,7,4,2,3,2,4,5,80.0,1,3,0,3,1,8,1,0,Matches,2023-2024,Serie-A
Nikola Sekulov,it ITA,FW,Juventus,21.0,2002.0,0.1,0,0,0,0,0,0,0,,0,0,0,0,0,0,0,0,Matches,2023-2024,Serie-A
Vivaldo Semedo,pt POR,FW,Udinese,18.0,2005.0,0.1,0,0,0,0,0,0,0,,0,0,0,0,0,0,0,0,Matches,2023-2024,Serie-A
Stefano Sensi,it ITA,MF,Inter,27.0,1995.0,0.5,1,1,0,1,0,1,3,33.3,2,1,0,1,1,2,0,0,Matches,2023-2024,Serie-A
Suat Serdar,de GER,MF,Hellas Verona,26.0,1997.0,18.4,51,39,24,23,4,22,45,48.9,23,29,7,22,20,71,25,1,Matches,2023-2024,Serie-A
Andres Sfait,ro ROU,"DF,MF",Salernitana,18.0,2004.0,0.3,1,1,1,0,0,1,2,50.0,1,0,0,0,0,1,0,0,Matches,2023-2024,Serie-A
Stephan El Shaarawy,it ITA,"FW,DF",Roma,30.0,1992.0,19.3,21,13,14,4,3,6,15,40.0,9,11,4,7,13,34,15,2,Matches,2023-2024,Serie-A
Eldor Shomurodov,uz UZB,"FW,MF",Cagliari,28.0,1995.0,10.4,11,4,2,6,3,6,10,60.0,4,5,0,5,4,15,4,0,Matches,2023-2024,Serie-A
Steven Shpendi,al ALB,"FW,MF",Empoli,20.0,2003.0,4.6,0,0,0,0,0,0,4,0.0,4,2,1,1,1,1,0,0,Matches,2023-2024,Serie-A
Marco Silvestri,it ITA,GK,Udinese,32.0,1991.0,17.0,0,0,0,0,0,0,3,0.0,3,1,0,1,0,0,5,3,Matches,2023-2024,Serie-A
Giovanni Simeone,ar ARG,FW,Napoli,28.0,1995.0,8.9,12,4,1,3,8,3,12,25.0,9,11,0,11,1,13,7,0,Matches,2023-2024,Serie-A
Jan-Carlo Simic,rs SRB,DF,Milan,18.0,2005.0,1.6,1,1,1,0,0,0,0,,0,5,4,1,0,1,3,0,Matches,2023-2024,Serie-A
Leo Skiri Østigård,no NOR,DF,Napoli,23.0,1999.0,18.1,24,12,13,10,1,6,11,54.5,5,18,12,6,16,40,65,0,Matches,2023-2024,Serie-A
Łukasz Skorupski,pl POL,GK,Bologna,32.0,1991.0,32.0,2,2,2,0,0,2,3,66.7,1,0,0,0,1,3,11,3,Matches,2023-2024,Serie-A
Chris Smalling,eng ENG,DF,Roma,33.0,1989.0,4.3,1,1,1,0,0,1,4,25.0,3,6,5,1,5,6,8,0,Matches,2023-2024,Serie-A
Andrea Sodero,it ITA,MF,Empoli,18.0,2004.0,0.1,0,0,0,0,0,0,0,,0,0,0,0,0,0,0,0,Matches,2023-2024,Serie-A
Ola Solbakken,no NOR,FW,Roma,24.0,1998.0,0.3,0,0,0,0,0,0,0,,0,0,0,0,0,0,0,0,Matches,2023-2024,Serie-A
Daniele Sommariva,it ITA,GK,Genoa,26.0,1997.0,0.1,0,0,0,0,0,0,0,,0,0,0,0,0,0,0,0,Matches,2023-2024,Serie-A
Yann Sommer,ch SUI,GK,Inter,34.0,1988.0,34.0,2,1,2,0,0,2,2,100.0,0,1,0,1,0,2,7,1,Matches,2023-2024,Serie-A
Brandon Soppy,fr FRA,DF,Torino,21.0,2002.0,2.0,2,2,1,1,0,2,6,33.3,4,2,0,2,0,2,3,1,Matches,2023-2024,Serie-A
Alessandro Sorrentino,it ITA,GK,Monza,21.0,2002.0,6.1,0,0,0,0,0,0,0,,0,0,0,0,0,0,0,0,Matches,2023-2024,Serie-A
Riccardo Sottil,it ITA,FW,Fiorentina,24.0,1999.0,12.3,10,5,5,1,4,3,8,37.5,5,12,0,12,2,12,2,0,Matches,2023-2024,Serie-A
Matìas Soulé,ar ARG,"FW,MF",Frosinone,20.0,2003.0,34.7,41,27,12,14,15,19,40,47.5,21,38,4,34,18,59,9,0,Matches,2023-2024,Serie-A
Djed Spence,eng ENG,DF,Genoa,22.0,2000.0,9.5,16,10,12,4,0,8,10,80.0,2,20,5,15,8,24,28,0,Matches,2023-2024,Serie-A
Leonardo Spinazzola,it ITA,DF,Roma,30.0,1993.0,14.6,15,7,10,5,0,8,18,44.4,10,8,2,6,3,18,15,0,Matches,2023-2024,Serie-A
Marco Sportiello,it ITA,GK,Milan,31.0,1992.0,7.0,0,0,0,0,0,0,0,,0,0,0,0,0,0,2,0,Matches,2023-2024,Serie-A
Trivante Stewart,jm JAM,"FW,MF",Salernitana,23.0,2000.0,1.1,0,0,0,0,0,0,0,,0,1,0,1,0,0,0,0,Matches,2023-2024,Serie-A
Gabriel Strefezza,br BRA,FW,Lecce,26.0,1997.0,12.4,24,17,8,7,9,14,20,70.0,6,17,0,17,7,31,11,0,Matches,2023-2024,Serie-A
Kevin Strootman,nl NED,MF,Genoa,33.0,1990.0,13.4,34,19,13,18,3,15,31,48.4,16,20,6,14,7,41,22,0,Matches,2023-2024,Serie-A
Isaac Success,ng NGA,"FW,MF",Udinese,27.0,1996.0,9.8,6,4,0,5,1,1,3,33.3,2,6,1,5,2,8,11,0,Matches,2023-2024,Serie-A
Ibrahim Sulemana,gh GHA,MF,Cagliari,20.0,2003.0,14.9,36,14,15,15,6,17,27,63.0,10,24,5,19,7,43,23,0,Matches,2023-2024,Serie-A
Tomáš Suslov,sk SVK,"MF,FW",Hellas Verona,21.0,2002.0,23.2,42,30,11,22,9,15,47,31.9,32,15,0,15,6,48,8,0,Matches,2023-2024,Serie-A
Mile Svilar,rs SRB,GK,Roma,23.0,1999.0,15.0,0,0,0,0,0,0,0,,0,0,0,0,0,0,2,1,Matches,2023-2024,Serie-A
Karol Świderski,pl POL,"FW,MF",Hellas Verona,26.0,1997.0,5.6,7,3,1,3,3,2,3,66.7,1,6,4,2,1,8,8,0,Matches,2023-2024,Serie-A
Wojciech Szczęsny,pl POL,GK,Juventus,33.0,1990.0,35.0,0,0,0,0,0,0,0,,0,0,0,0,1,1,11,2,Matches,2023-2024,Serie-A
Przemysław Szymiński,pl POL,MF,Frosinone,29.0,1994.0,0.1,0,0,0,0,0,0,0,,0,1,1,0,0,0,0,0,Matches,2023-2024,Serie-A
Adrien Tameze,cm CMR,"DF,MF",Torino,29.0,1994.0,23.8,35,16,13,18,4,18,37,48.6,19,24,11,13,47,82,25,2,Matches,2023-2024,Serie-A
Elayis Tavsan,nl NED,"MF,FW",Hellas Verona,22.0,2001.0,0.6,0,0,0,0,0,0,1,0.0,1,0,0,0,0,0,1,0,Matches,2023-2024,Serie-A
Loum Tchaouna,fr FRA,"FW,MF",Salernitana,19.0,2003.0,23.3,20,10,5,13,2,10,20,50.0,10,20,1,19,4,24,16,1,Matches,2023-2024,Serie-A
Jackson Tchatchoua,cm CMR,DF,Hellas Verona,21.0,2001.0,19.2,39,26,25,12,2,23,48,47.9,25,17,7,10,23,62,49,2,Matches,2023-2024,Serie-A
Filippo Terracciano,it ITA,DF,Hellas Verona,20.0,2003.0,14.4,30,19,23,6,1,17,31,54.8,14,24,6,18,20,50,17,0,Matches,2023-2024,Serie-A
Filippo Terracciano,it ITA,"DF,FW",Milan,20.0,2003.0,0.8,2,2,1,1,0,1,3,33.3,2,3,0,3,0,2,1,0,Matches,2023-2024,Serie-A
Pietro Terracciano,it ITA,GK,Fiorentina,33.0,1990.0,33.0,1,1,1,0,0,1,3,33.3,2,1,0,1,0,1,8,0,Matches,2023-2024,Serie-A
Florian Thauvin,fr FRA,FW,Udinese,30.0,1993.0,19.0,7,4,2,4,1,4,13,30.8,9,9,1,8,3,10,2,0,Matches,2023-2024,Serie-A
Malick Thiaw,de GER,DF,Milan,21.0,2001.0,18.0,34,17,15,17,2,12,25,48.0,13,23,13,10,13,47,55,0,Matches,2023-2024,Serie-A
Morten Thorsby,no NOR,MF,Genoa,27.0,1996.0,12.9,19,11,9,8,2,7,14,50.0,7,21,5,16,4,23,20,0,Matches,2023-2024,Serie-A
Kristian Thorstvedt,no NOR,MF,Sassuolo,24.0,1999.0,26.6,40,22,7,28,5,22,44,50.0,22,25,9,16,21,61,36,0,Matches,2023-2024,Serie-A
Marcus Thuram,fr FRA,FW,Inter,25.0,1997.0,29.9,23,15,9,9,5,4,13,30.8,9,26,3,23,4,27,19,0,Matches,2023-2024,Serie-A
Antonio Tikvić,hr CRO,DF,Udinese,19.0,2004.0,0.0,0,0,0,0,0,0,0,,0,0,0,0,0,0,0,0,Matches,2023-2024,Serie-A
Jeremy Toljan,de GER,DF,Sassuolo,28.0,1994.0,23.1,13,10,8,4,1,9,15,60.0,6,17,5,12,16,29,49,1,Matches,2023-2024,Serie-A
Rafael Tolói,it ITA,DF,Atalanta,32.0,1990.0,10.7,20,9,7,8,5,14,27,51.9,13,9,4,5,13,33,29,0,Matches,2023-2024,Serie-A
Fikayo Tomori,eng ENG,DF,Milan,25.0,1997.0,23.6,42,24,29,10,3,18,29,62.1,11,34,23,11,26,68,75,1,Matches,2023-2024,Serie-A
Ahmed Touba,dz ALG,DF,Lecce,25.0,1998.0,3.1,6,4,3,3,0,3,4,75.0,1,4,3,1,7,13,20,0,Matches,2023-2024,Serie-A
Chaka Traorè,ci CIV,FW,Milan,18.0,2004.0,0.2,2,1,2,0,0,1,2,50.0,1,1,1,0,0,2,0,0,Matches,2023-2024,Serie-A
Stefano Turati,it ITA,GK,Frosinone,21.0,2001.0,30.5,0,0,0,0,0,0,0,,0,0,0,0,0,0,6,3,Matches,2023-2024,Serie-A
Kacper Urbanski,pl POL,"MF,FW",Bologna,18.0,2004.0,10.3,16,10,5,10,1,6,13,46.2,7,15,1,14,4,20,14,0,Matches,2023-2024,Serie-A
Emanuele Valeri,it ITA,DF,Frosinone,24.0,1998.0,13.1,19,16,10,5,4,10,21,47.6,11,14,3,11,9,28,22,0,Matches,2023-2024,Serie-A
Johan Vásquez,mx MEX,DF,Genoa,24.0,1998.0,31.7,51,33,38,11,2,32,50,64.0,18,50,26,24,45,96,113,0,Matches,2023-2024,Serie-A
Matías Vecino,uy URU,MF,Lazio,31.0,1991.0,12.8,32,17,12,20,0,20,31,64.5,11,17,5,12,12,44,21,0,Matches,2023-2024,Serie-A
Lorenzo Venuti,it ITA,DF,Lecce,28.0,1995.0,4.0,6,4,5,1,0,6,10,60.0,4,4,3,1,5,11,14,0,Matches,2023-2024,Serie-A
Simone Verdi,it ITA,FW,Torino,31.0,1992.0,0.0,0,0,0,0,0,0,0,,0,0,0,0,0,0,0,0,Matches,2023-2024,Serie-A
Emanuel Vignato,it ITA,"MF,FW",Salernitana,22.0,2000.0,3.5,10,7,4,5,1,5,6,83.3,1,1,0,1,1,11,7,0,Matches,2023-2024,Serie-A
Samuele Vignato,it ITA,"MF,FW",Monza,19.0,2004.0,3.8,6,4,2,3,1,2,3,66.7,1,2,0,2,1,7,1,0,Matches,2023-2024,Serie-A
Matías Viña,uy URU,DF,Sassuolo,25.0,1997.0,11.3,34,21,22,7,5,20,36,55.6,16,12,2,10,9,43,34,0,Matches,2023-2024,Serie-A
Rúben Vinagre,pt POR,"DF,FW",Hellas Verona,24.0,1999.0,3.1,4,2,1,1,2,3,4,75.0,1,6,3,3,1,5,4,0,Matches,2023-2024,Serie-A
Nicolas Viola,it ITA,"MF,FW",Cagliari,33.0,1989.0,13.4,13,9,2,8,3,7,17,41.2,10,9,0,9,2,15,6,0,Matches,2023-2024,Serie-A
Mattia Viti,it ITA,DF,Sassuolo,21.0,2002.0,10.9,24,15,14,7,3,10,22,45.5,12,20,10,10,10,34,44,0,Matches,2023-2024,Serie-A
Vitinha,pt POR,"FW,MF",Genoa,23.0,2000.0,3.2,2,2,1,0,1,1,2,50.0,1,2,0,2,0,2,2,0,Matches,2023-2024,Serie-A
Dušan Vlahović,rs SRB,FW,Juventus,23.0,2000.0,25.6,9,5,0,6,3,4,11,36.4,7,4,2,2,1,10,11,0,Matches,2023-2024,Serie-A
Nikola Vlašić,hr CRO,"MF,FW",Torino,25.0,1997.0,29.0,28,16,6,14,8,4,30,13.3,26,26,7,19,11,39,16,0,Matches,2023-2024,Serie-A
Alessandro Vogliacco,it ITA,DF,Genoa,24.0,1998.0,13.0,23,15,14,8,1,12,15,80.0,3,16,10,6,30,53,40,1,Matches,2023-2024,Serie-A
Mërgim Vojvoda,xk KVX,DF,Torino,28.0,1995.0,15.3,17,8,7,6,4,11,16,68.8,5,12,2,10,13,30,28,0,Matches,2023-2024,Serie-A
Cristian Volpato,it ITA,"MF,FW",Sassuolo,19.0,2003.0,7.2,16,8,9,6,1,9,25,36.0,16,7,0,7,1,17,5,0,Matches,2023-2024,Serie-A
Stefan de Vrij,nl NED,DF,Inter,31.0,1992.0,17.6,18,13,13,4,1,8,15,53.3,7,22,10,12,24,42,51,0,Matches,2023-2024,Serie-A
Walace,br BRA,MF,Udinese,28.0,1995.0,36.0,66,43,40,26,0,36,77,46.8,41,43,6,37,43,109,66,1,Matches,2023-2024,Serie-A
Sebastian Walukiewicz,pl POL,DF,Empoli,23.0,2000.0,22.8,39,28,33,6,0,28,41,68.3,13,50,31,19,15,54,121,0,Matches,2023-2024,Serie-A
Timothy Weah,us USA,"DF,FW",Juventus,23.0,2000.0,14.0,27,20,16,8,3,15,20,75.0,5,12,1,11,5,32,15,0,Matches,2023-2024,Serie-A
Shon Weissman,il ISR,"FW,DF",Salernitana,27.0,1996.0,5.5,4,3,2,0,2,0,4,0.0,4,2,1,1,3,7,4,0,Matches,2023-2024,Serie-A
Mateusz Wieteska,pl POL,DF,Cagliari,26.0,1997.0,10.7,14,11,9,3,2,3,10,30.0,7,10,5,5,14,28,48,0,Matches,2023-2024,Serie-A
Kenan Yıldız,tr TUR,"FW,MF",Juventus,18.0,2005.0,10.6,13,9,5,6,2,4,8,50.0,4,6,0,6,1,14,4,0,Matches,2023-2024,Serie-A
Mattia Zaccagni,it ITA,"FW,MF",Lazio,28.0,1995.0,21.7,27,16,11,15,1,9,21,42.9,12,26,2,24,21,48,15,0,Matches,2023-2024,Serie-A
Nicola Zalewski,pl POL,"DF,FW",Roma,21.0,2002.0,10.8,20,14,10,9,1,8,22,36.4,14,12,4,8,9,29,17,0,Matches,2023-2024,Serie-A
Andre-Frank Zambo Anguissa,cm CMR,MF,Napoli,27.0,1995.0,31.0,61,33,21,29,11,34,69,49.3,35,40,5,35,28,89,19,1,Matches,2023-2024,Serie-A
Alessandro Zanoli,it ITA,DF,Salernitana,22.0,2000.0,10.2,16,13,9,7,0,7,12,58.3,5,10,2,8,1,17,17,0,Matches,2023-2024,Serie-A
Alessandro Zanoli,it ITA,"DF,FW",Napoli,22.0,2000.0,0.6,1,1,1,0,0,0,0,,0,0,0,0,1,2,1,0,Matches,2023-2024,Serie-A
Duván Zapata,co COL,FW,Torino,32.0,1991.0,32.0,18,7,9,2,7,3,12,25.0,9,20,6,14,7,25,26,0,Matches,2023-2024,Serie-A
Duván Zapata,co COL,FW,Atalanta,32.0,1991.0,1.2,0,0,0,0,0,0,1,0.0,1,0,0,0,0,0,1,0,Matches,2023-2024,Serie-A
Gabriele Zappa,it ITA,DF,Cagliari,23.0,1999.0,28.5,54,31,29,16,9,29,41,70.7,12,29,5,24,20,74,75,2,Matches,2023-2024,Serie-A
Davide Zappacosta,it ITA,DF,Atalanta,31.0,1992.0,20.7,30,20,15,10,5,16,34,47.1,18,29,4,25,5,35,19,0,Matches,2023-2024,Serie-A
Oier Zarraga,es ESP,MF,Udinese,24.0,1999.0,4.5,3,3,2,1,0,1,5,20.0,4,5,2,3,5,8,16,1,Matches,2023-2024,Serie-A
Jordan Zemura,zw ZIM,DF,Udinese,23.0,1999.0,11.5,24,16,13,7,4,11,19,57.9,8,5,1,4,13,37,21,0,Matches,2023-2024,Serie-A
Alessio Zerbin,it ITA,"DF,FW",Monza,24.0,1999.0,7.6,18,10,13,2,3,4,13,30.8,9,16,3,13,3,21,5,0,Matches,2023-2024,Serie-A
Alessio Zerbin,it ITA,"FW,DF",Napoli,24.0,1999.0,1.7,5,2,1,3,1,2,7,28.6,5,1,0,1,0,5,0,0,Matches,2023-2024,Serie-A
Kevin Zeroli,it ITA,MF,Milan,18.0,2005.0,0.3,1,1,1,0,0,0,0,,0,1,0,1,0,1,1,0,Matches,2023-2024,Serie-A
Piotr Zieliński,pl POL,MF,Napoli,29.0,1994.0,21.4,23,15,6,13,4,12,24,50.0,12,12,1,11,9,32,15,0,Matches,2023-2024,Serie-A
David Zima,cz CZE,DF,Torino,22.0,2000.0,1.0,1,1,1,0,0,0,0,,0,0,0,0,3,4,7,0,Matches,2023-2024,Serie-A
Joshua Zirkzee,nl NED,FW,Bologna,22.0,2001.0,30.7,32,20,8,15,9,13,24,54.2,11,25,2,23,3,35,36,0,Matches,2023-2024,Serie-A
Nadir Zortea,it ITA,DF,Frosinone,24.0,1999.0,14.0,21,14,8,13,0,10,22,45.5,12,13,5,8,4,25,29,1,Matches,2023-2024,Serie-A
Nadir Zortea,it ITA,DF,Atalanta,24.0,1999.0,1.7,5,4,3,1,1,1,4,25.0,3,2,0,2,1,6,3,0,Matches,2023-2024,Serie-A
Szymon Żurkowski,pl POL,MF,Empoli,25.0,1997.0,9.6,15,6,5,8,2,5,15,33.3,10,5,1,4,6,21,11,0,Matches,2023-2024,Serie-A
Milan Đurić,ba BIH,FW,Hellas Verona,33.0,1990.0,13.4,1,0,0,0,1,0,3,0.0,3,0,0,0,1,2,13,0,Matches,2023-2024,Serie-A
Milan Đurić,ba BIH,FW,Monza,33.0,1990.0,14.0,5,5,0,5,0,2,4,50.0,2,6,2,4,0,5,27,0,Matches,2023-2024,Serie-A
Mateusz Łęgowski,pl POL,MF,Salernitana,20.0,2003.0,12.7,23,12,8,12,3,11,26,42.3,15,13,2,11,7,30,16,0,Matches,2023-2024,Serie-A
Ismael Aaneba,fr FRA,DF,Strasbourg,21.0,1999.0,0.1,0,0,0,0,0,0,0,,0,0,0,0,1,1,1,0,Matches,2020-2021,Ligue-1
Yunis Abdelhamid,ma MAR,DF,Reims,32.0,1987.0,32.1,59,37,36,23,0,26,42,61.9,16,34,15,19,61,120,132,0,Matches,2020-2021,Ligue-1
Mehdi Abeid,dz ALG,MF,Nantes,27.0,1992.0,14.7,34,19,16,14,4,15,30,50.0,15,9,2,7,20,54,10,0,Matches,2020-2021,Ligue-1
Laurent Abergel,fr FRA,MF,Lorient,27.0,1993.0,32.9,145,84,64,69,12,54,162,33.3,108,64,6,58,46,191,12,0,Matches,2020-2021,Ligue-1
Charles Abi,fr FRA,"FW,MF",Saint-Étienne,20.0,2000.0,10.1,8,2,5,0,3,3,12,25.0,9,6,2,4,4,12,5,0,Matches,2020-2021,Ligue-1
Matthis Abline,fr FRA,FW,Rennes,17.0,2003.0,0.0,0,0,0,0,0,0,0,,0,0,0,0,0,0,0,0,Matches,2020-2021,Ligue-1
Pape Abou Cissé,sn SEN,DF,Saint-Étienne,24.0,1995.0,14.0,15,13,10,5,0,6,10,60.0,4,7,4,3,27,42,87,0,Matches,2020-2021,Ligue-1
Yacine Adli,fr FRA,MF,Bordeaux,20.0,2000.0,26.9,74,37,30,33,11,35,92,38.0,57,27,2,25,39,113,17,2,Matches,2020-2021,Ligue-1
Nayef Aguerd,ma MAR,DF,Rennes,24.0,1996.0,35.0,37,30,28,9,0,21,33,63.6,12,34,22,12,47,84,102,0,Matches,2020-2021,Ligue-1
Ruben Aguilar,fr FRA,"DF,MF",Monaco,27.0,1993.0,24.7,63,37,32,21,10,32,52,61.5,20,30,3,27,47,110,43,1,Matches,2020-2021,Ligue-1
Matteo Ahlinvi,bj BEN,MF,Nîmes,21.0,1999.0,10.0,26,20,10,14,2,11,39,28.2,28,6,0,6,2,28,8,0,Matches,2020-2021,Ligue-1
Jean-Eudes Aholou,ci CIV,MF,Strasbourg,26.0,1994.0,23.8,46,25,18,25,3,19,48,39.6,29,17,5,12,53,99,32,0,Matches,2020-2021,Ligue-1
Jean-Eudes Aholou,ci CIV,MF,Monaco,26.0,1994.0,0.4,1,0,0,1,0,1,3,33.3,2,0,0,0,1,2,1,0,Matches,2020-2021,Ligue-1
Rayan Aït-Nouri,dz ALG,DF,Angers,19.0,2001.0,2.1,3,2,1,2,0,3,5,60.0,2,2,1,1,4,7,1,0,Matches,2020-2021,Ligue-1
Ludovic Ajorque,fr FRA,FW,Strasbourg,26.0,1994.0,33.0,30,18,6,18,6,7,31,22.6,24,14,5,9,11,41,54,0,Matches,2020-2021,Ligue-1
Marley Aké,fr FRA,FW,Marseille,19.0,2001.0,1.6,3,3,1,0,2,0,1,0.0,1,2,0,2,0,3,1,0,Matches,2020-2021,Ligue-1
Sofiane Alakouch,ma MAR,DF,Nîmes,22.0,1998.0,16.7,53,33,30,16,7,29,45,64.4,16,17,2,15,21,74,38,0,Matches,2020-2021,Ligue-1
Mohamed Ali Cho,fr FRA,"FW,MF",Angers,16.0,2004.0,3.9,9,7,2,6,1,4,9,44.4,5,4,0,4,3,12,0,0,Matches,2020-2021,Ligue-1
Rachid Alioui,ma MAR,FW,Angers,28.0,1992.0,0.2,0,0,0,0,0,0,1,0.0,1,0,0,0,0,0,0,0,Matches,2020-2021,Ligue-1
Saturnin Allagbé,bj BEN,GK,Dijon,26.0,1993.0,12.0,0,0,0,0,0,0,1,0.0,1,0,0,0,0,0,9,3,Matches,2020-2021,Ligue-1
Ibrahim Amadou,fr FRA,MF,Angers,27.0,1993.0,16.7,39,26,18,19,2,15,38,39.5,23,14,4,10,23,62,25,0,Matches,2020-2021,Ligue-1
Romain Amalfitano,fr FRA,"FW,DF",Dijon,30.0,1989.0,1.3,4,2,3,1,0,1,3,33.3,2,2,1,1,1,5,1,0,Matches,2020-2021,Ligue-1
Jordan Amavi,fr FRA,DF,Marseille,26.0,1994.0,9.0,11,9,9,1,1,9,12,75.0,3,12,2,10,27,38,33,1,Matches,2020-2021,Ligue-1
Thierry Ambrose,gp GLP,FW,Metz,23.0,1997.0,8.4,7,4,1,1,5,2,12,16.7,10,2,0,2,2,9,4,0,Matches,2020-2021,Ligue-1
Joachim Andersen,dk DEN,DF,Lyon,24.0,1996.0,2.1,2,1,1,1,0,2,2,100.0,0,1,1,0,2,4,6,0,Matches,2020-2021,Ligue-1
Benjamin André,fr FRA,MF,Lille,29.0,1990.0,32.1,114,68,47,61,6,53,122,43.4,69,39,10,29,76,190,49,0,Matches,2020-2021,Ligue-1
Victorien Angban,ci CIV,MF,Metz,23.0,1996.0,18.6,36,24,17,15,4,17,42,40.5,25,17,4,13,19,55,9,1,Matches,2020-2021,Ligue-1
Houssem Aouar,dz ALG,"MF,FW",Lyon,22.0,1998.0,19.8,17,12,0,13,4,8,25,32.0,17,17,1,16,17,34,4,0,Matches,2020-2021,Ligue-1
Adil Aouchiche,fr FRA,"MF,FW",Saint-Étienne,18.0,2002.0,19.2,38,20,12,17,9,13,49,26.5,36,15,1,14,10,48,6,0,Matches,2020-2021,Ligue-1
Dennis Appiah,fr FRA,DF,Nantes,28.0,1992.0,17.3,55,34,33,15,7,32,59,54.2,27,23,6,17,25,80,44,0,Matches,2020-2021,Ligue-1
Luiz Araújo,br BRA,MF,Lille,24.0,1996.0,16.6,38,25,12,18,8,8,28,28.6,20,23,1,22,11,49,3,0,Matches,2020-2021,Ligue-1
Karim Aribi,dz ALG,FW,Nîmes,26.0,1994.0,3.3,2,2,0,1,1,0,5,0.0,5,1,0,1,0,2,3,0,Matches,2020-2021,Ligue-1
Roger Assalé,ci CIV,"FW,MF",Dijon,26.0,1993.0,9.2,10,8,3,5,2,4,12,33.3,8,7,3,4,2,12,2,0,Matches,2020-2021,Ligue-1
Youcef Atal,dz ALG,"DF,FW",Nice,24.0,1996.0,10.6,25,12,11,14,0,13,26,50.0,13,10,2,8,26,51,12,0,Matches,2020-2021,Ligue-1
Jean-Kévin Augustin,fr FRA,FW,Nantes,23.0,1997.0,0.4,2,0,0,2,0,2,2,100.0,0,0,0,0,0,2,0,0,Matches,2020-2021,Ligue-1
Ludovic Baal,gf GUF,"DF,MF",Brest,34.0,1986.0,3.3,6,5,4,1,1,2,5,40.0,3,4,1,3,5,11,5,0,Matches,2020-2021,Ligue-1
Loïc Bade,fr FRA,DF,Lens,20.0,2000.0,29.0,57,34,47,10,0,30,55,54.5,25,43,17,26,74,131,135,2,Matches,2020-2021,Ligue-1
Benoît Badiashile,fr FRA,DF,Monaco,19.0,2001.0,31.9,24,17,15,9,0,13,28,46.4,15,21,12,9,58,82,102,4,Matches,2020-2021,Ligue-1
Stéphane Bahoken,cm CMR,FW,Angers,28.0,1992.0,18.0,9,6,1,7,1,4,12,33.3,8,9,0,9,9,18,9,0,Matches,2020-2021,Ligue-1
Stefan Bajic,fr FRA,GK,Saint-Étienne,18.0,2001.0,1.0,0,0,0,0,0,0,0,,0,0,0,0,0,0,1,0,Matches,2020-2021,Ligue-1
Mitchel Bakker,nl NED,DF,Paris S-G,20.0,2000.0,18.8,38,30,15,14,9,17,26,65.4,9,22,2,20,22,60,20,0,Matches,2020-2021,Ligue-1
Dilane Bakwa,fr FRA,"FW,MF",Bordeaux,17.0,2002.0,0.6,2,2,1,1,0,0,1,0.0,1,2,0,2,1,3,0,0,Matches,2020-2021,Ligue-1
Leonardo Balerdi,ar ARG,DF,Marseille,21.0,1999.0,18.2,29,18,19,7,3,14,31,45.2,17,17,9,8,28,57,65,3,Matches,2020-2021,Ligue-1
Fodé Ballo-Touré,sn SEN,DF,Monaco,23.0,1997.0,7.4,21,17,9,11,1,6,13,46.2,7,7,0,7,6,27,11,1,Matches,2020-2021,Ligue-1
Abdoulaye Bamba,ci CIV,DF,Angers,30.0,1990.0,15.0,27,17,19,7,1,19,28,67.9,9,7,1,6,19,46,34,0,Matches,2020-2021,Ligue-1
Jonathan Bamba,ci CIV,MF,Lille,24.0,1996.0,33.2,45,23,15,19,11,24,84,28.6,60,24,2,22,24,69,15,0,Matches,2020-2021,Ligue-1
Robson Bambu,br BRA,DF,Nice,22.0,1997.0,11.6,16,11,14,2,0,11,14,78.6,3,8,7,1,10,26,57,0,Matches,2020-2021,Ligue-1
Simon Banza,cd COD,FW,Lens,23.0,1996.0,15.2,13,6,0,4,9,1,14,7.1,13,16,1,15,7,20,15,0,Matches,2020-2021,Ligue-1
Danilo Barbosa,br BRA,DF,Nice,24.0,1996.0,2.8,6,3,5,1,0,4,6,66.7,2,2,1,1,2,8,11,2,Matches,2020-2021,Ligue-1
Melvin Bard,fr FRA,DF,Lyon,19.0,2000.0,4.8,12,8,7,4,1,6,11,54.5,5,10,2,8,6,18,14,0,Matches,2020-2021,Ligue-1
Toma Bašić,hr CRO,MF,Bordeaux,23.0,1996.0,28.9,33,22,15,16,2,16,58,27.6,42,21,5,16,32,65,42,1,Matches,2020-2021,Ligue-1
Cristian Battocchio,it ITA,MF,Brest,28.0,1992.0,3.9,5,2,1,4,0,2,9,22.2,7,0,0,0,4,9,5,0,Matches,2020-2021,Ligue-1
Paul Baysse,fr FRA,DF,Bordeaux,32.0,1988.0,29.0,35,18,21,13,1,16,21,76.2,5,33,24,9,52,87,123,1,Matches,2020-2021,Ligue-1
Erwan Belhadji,fr FRA,MF,Dijon,19.0,2001.0,0.3,3,0,3,0,0,3,5,60.0,2,1,0,1,0,3,0,0,Matches,2020-2021,Ligue-1
Haris Belkebla,dz ALG,MF,Brest,26.0,1994.0,30.3,69,39,32,28,9,31,66,47.0,35,26,5,21,57,126,34,0,Matches,2020-2021,Ligue-1
Jean-Ricner Bellegarde,fr FRA,"MF,FW",Strasbourg,22.0,1998.0,23.2,56,39,22,25,9,14,23,60.9,9,20,2,18,19,75,16,0,Matches,2020-2021,Ligue-1
Sami Ben Amar,ma MAR,MF,Nîmes,22.0,1998.0,0.1,0,0,0,0,0,0,0,,0,1,0,1,0,0,0,0,Matches,2020-2021,Ligue-1
Hatem Ben Arfa,fr FRA,"MF,FW",Bordeaux,33.0,1987.0,18.9,11,7,1,7,3,2,9,22.2,7,3,0,3,2,13,0,0,Matches,2020-2021,Ligue-1
Salim Ben Seghir,fr FRA,DF,Nice,17.0,2003.0,0.1,0,0,0,0,0,0,0,,0,0,0,0,0,0,0,0,Matches,2020-2021,Ligue-1
Wissam Ben Yedder,fr FRA,FW,Monaco,29.0,1990.0,29.0,18,9,2,10,6,3,13,23.1,10,16,0,16,13,31,3,0,Matches,2020-2021,Ligue-1
Samy Benchamma,fr FRA,"DF,MF",Montpellier,20.0,2000.0,0.5,1,1,1,0,0,0,0,,0,0,0,0,0,1,2,0,Matches,2020-2021,Ligue-1
Darío Benedetto,ar ARG,FW,Marseille,30.0,1990.0,17.5,6,4,1,4,1,5,13,38.5,8,9,2,7,3,9,17,0,Matches,2020-2021,Ligue-1
Walter Benítez,ar ARG,GK,Nice,27.0,1993.0,38.0,1,1,1,0,0,1,3,33.3,2,1,0,1,1,2,7,2,Matches,2020-2021,Ligue-1
Loris Benito,ch SUI,DF,Bordeaux,28.0,1992.0,29.5,42,26,27,12,3,22,48,45.8,26,33,10,23,42,84,70,0,Matches,2020-2021,Ligue-1
Bilal Benkhedim,fr FRA,FW,Saint-Étienne,19.0,2001.0,0.8,0,0,0,0,0,0,1,0.0,1,1,0,1,0,0,0,0,Matches,2020-2021,Ligue-1
Djamel Benlamri,dz ALG,DF,Lyon,30.0,1989.0,1.7,5,3,5,0,0,3,6,50.0,3,3,2,1,6,11,11,0,Matches,2020-2021,Ligue-1
Yassine Benrahou,fr FRA,MF,Nîmes,21.0,1999.0,13.8,16,9,8,6,2,7,25,28.0,18,9,0,9,4,20,5,1,Matches,2020-2021,Ligue-1
Yassine Benzia,dz ALG,"MF,FW",Dijon,25.0,1994.0,4.5,10,5,5,3,2,2,10,20.0,8,3,0,3,6,16,2,0,Matches,2020-2021,Ligue-1
Valon Berisha,xk KVX,MF,Reims,27.0,1993.0,18.3,40,23,19,17,4,11,47,23.4,36,14,2,12,25,65,21,1,Matches,2020-2021,Ligue-1
Paul Bernardoni,fr FRA,GK,Angers,23.0,1997.0,38.0,1,1,1,0,0,1,2,50.0,1,0,0,0,2,3,23,1,Matches,2020-2021,Ligue-1
Juan Bernat,es ESP,DF,Paris S-G,27.0,1993.0,2.2,5,3,0,4,1,3,5,60.0,2,4,0,4,1,6,6,0,Matches,2020-2021,Ligue-1
Dimitry Bertaud,cd COD,GK,Montpellier,22.0,1998.0,8.3,0,0,0,0,0,0,0,,0,0,0,0,1,1,2,0,Matches,2020-2021,Ligue-1
Loïc Bessile,tg TOG,DF,Bordeaux,21.0,1999.0,1.0,0,0,0,0,0,0,0,,0,2,1,1,1,1,3,0,Matches,2020-2021,Ligue-1
Giulian Biancone,fr FRA,"DF,MF",Monaco,20.0,2000.0,1.0,3,3,1,1,1,2,3,66.7,1,1,0,1,1,4,4,0,Matches,2020-2021,Ligue-1
El Bilal Touré,ml MLI,FW,Reims,18.0,2001.0,13.8,22,12,3,16,3,8,18,44.4,10,8,3,5,6,28,10,1,Matches,2020-2021,Ligue-1
Ludovic Blas,fr FRA,"MF,FW",Nantes,22.0,1997.0,31.0,58,30,19,36,3,23,54,42.6,31,33,4,29,21,79,19,0,Matches,2020-2021,Ligue-1
Antonin Bobichon,fr FRA,"MF,FW",Angers,24.0,1995.0,10.1,23,14,10,8,5,9,15,60.0,6,4,1,3,2,25,1,0,Matches,2020-2021,Ligue-1
Sacha Boey,fr FRA,DF,Dijon,19.0,2000.0,20.7,54,40,30,23,1,27,55,49.1,28,25,5,20,41,95,62,0,Matches,2020-2021,Ligue-1
Sacha Boey,fr FRA,DF,Rennes,19.0,2000.0,1.4,3,3,2,1,0,3,4,75.0,1,0,0,0,2,5,2,0,Matches,2020-2021,Ligue-1
Quentin Boisgard,fr FRA,"MF,FW",Lorient,23.0,1997.0,14.6,24,17,3,15,6,11,24,45.8,13,17,2,15,15,39,1,0,Matches,2020-2021,Ligue-1
Sven Botman,nl NED,DF,Lille,20.0,2000.0,36.8,31,21,18,12,1,14,26,53.8,12,31,21,10,57,88,126,2,Matches,2020-2021,Ligue-1
Denis Bouanga,ga GAB,"MF,FW",Saint-Étienne,25.0,1994.0,30.2,52,28,22,24,6,16,58,27.6,42,32,3,29,20,72,36,0,Matches,2020-2021,Ligue-1
Hicham Boudaoui,dz ALG,MF,Nice,20.0,1999.0,19.3,52,35,20,24,8,26,68,38.2,42,14,4,10,23,75,26,1,Matches,2020-2021,Ligue-1
Ryad Boudebouz,dz ALG,"MF,FW",Saint-Étienne,30.0,1990.0,7.2,9,4,1,7,1,4,8,50.0,4,3,0,3,5,14,5,0,Matches,2020-2021,Ligue-1
Sofiane Boufal,ma MAR,"FW,MF",Angers,26.0,1993.0,8.1,17,11,8,6,3,8,28,28.6,20,8,0,8,3,20,1,0,Matches,2020-2021,Ligue-1
Farid Boulaya,dz ALG,"MF,FW",Metz,27.0,1993.0,31.3,24,16,4,17,3,13,51,25.5,38,19,3,16,12,36,7,0,Matches,2020-2021,Ligue-1
Ismaël Boura,km COM,DF,Lens,19.0,2000.0,9.2,11,7,8,2,1,3,9,33.3,6,7,2,5,21,32,12,0,Matches,2020-2021,Ligue-1
Benjamin Bourigeaud,fr FRA,"MF,FW",Rennes,26.0,1994.0,28.4,40,23,17,16,7,21,71,29.6,50,37,1,36,19,59,25,0,Matches,2020-2021,Ligue-1
John Boye,gh GHA,DF,Metz,33.0,1987.0,33.8,58,34,43,13,2,31,54,57.4,23,36,20,16,80,138,146,1,Matches,2020-2021,Ligue-1
Umut Bozok,tr TUR,"MF,FW",Lorient,23.0,1996.0,0.7,0,0,0,0,0,0,2,0.0,2,0,0,0,0,0,0,0,Matches,2020-2021,Ligue-1
Domagoj Bradarić,hr CRO,DF,Lille,20.0,1999.0,14.0,28,18,11,13,4,12,27,44.4,15,14,4,10,26,54,21,0,Matches,2020-2021,Ligue-1
Lilian Brassier,fr FRA,DF,Brest,20.0,1999.0,10.7,19,10,12,4,3,7,11,63.6,4,13,6,7,23,42,38,1,Matches,2020-2021,Ligue-1
Anthony Briançon,fr FRA,DF,Nîmes,25.0,1994.0,13.6,12,7,9,3,0,9,19,47.4,10,19,12,7,33,45,57,2,Matches,2020-2021,Ligue-1
Jimmy Briand,fr FRA,FW,Bordeaux,34.0,1985.0,6.3,7,3,3,2,2,1,1,100.0,0,2,0,2,1,8,3,0,Matches,2020-2021,Ligue-1
Dylan Bronn,tn TUN,DF,Metz,25.0,1995.0,37.9,57,37,38,19,0,24,44,54.5,20,31,14,17,44,101,112,0,Matches,2020-2021,Ligue-1
Lucas Buadés,fr FRA,MF,Nîmes,22.0,1997.0,0.2,1,0,0,1,0,0,0,,0,0,0,0,0,1,0,0,Matches,2020-2021,Ligue-1
Patrick Burner,mq MTQ,DF,Nice,24.0,1996.0,0.0,0,0,0,0,0,0,0,,0,0,0,0,0,0,0,0,Matches,2020-2021,Ligue-1
Patrick Burner,mq MTQ,DF,Nîmes,24.0,1996.0,14.6,25,11,14,10,1,13,26,50.0,13,10,3,7,24,49,41,1,Matches,2020-2021,Ligue-1
Marcin Bułka,pl POL,GK,Paris S-G,20.0,1999.0,1.0,0,0,0,0,0,0,0,,0,0,0,0,0,0,0,1,Matches,2020-2021,Ligue-1
Jimmy Cabot,fr FRA,"FW,MF",Angers,26.0,1994.0,10.5,26,13,8,14,4,11,36,30.6,25,8,0,8,12,38,6,0,Matches,2020-2021,Ligue-1
Anthony Caci,fr FRA,DF,Strasbourg,23.0,1997.0,31.1,80,46,47,27,6,35,69,50.7,34,30,4,26,55,135,65,1,Matches,2020-2021,Ligue-1
Mathieu Cafaro,fr FRA,"MF,FW",Reims,23.0,1997.0,23.0,40,17,15,19,6,13,43,30.2,30,11,0,11,17,57,12,0,Matches,2020-2021,Ligue-1
Yannick Cahuzac,fr FRA,MF,Lens,35.0,1985.0,25.0,26,12,12,10,4,9,27,33.3,18,18,5,13,33,59,72,0,Matches,2020-2021,Ligue-1
Marc-Aurèle Caillard,fr FRA,GK,Metz,26.0,1994.0,4.0,0,0,0,0,0,0,0,,0,0,0,0,0,0,2,0,Matches,2020-2021,Ligue-1
Duje Ćaleta-Car,hr CRO,DF,Marseille,23.0,1996.0,31.3,29,17,19,9,1,17,30,56.7,13,29,22,7,44,73,130,0,Matches,2020-2021,Ligue-1
Mahdi Camara,fr FRA,"MF,DF",Saint-Étienne,22.0,1998.0,36.6,99,67,43,46,10,33,60,55.0,27,50,12,38,78,177,51,0,Matches,2020-2021,Ligue-1
Eduardo Camavinga,fr FRA,MF,Rennes,17.0,2002.0,26.7,98,58,39,48,11,38,77,49.4,39,36,2,34,23,121,15,1,Matches,2020-2021,Ligue-1
Pierrick Capelle,fr FRA,"MF,DF",Angers,33.0,1987.0,22.8,53,28,24,17,12,31,79,39.2,48,25,1,24,47,100,32,0,Matches,2020-2021,Ligue-1
Maxence Caqueret,fr FRA,MF,Lyon,20.0,2000.0,19.6,72,44,17,39,16,35,106,33.0,71,35,3,32,23,95,5,2,Matches,2020-2021,Ligue-1
Irvin Cardona,fr FRA,FW,Brest,22.0,1997.0,22.5,10,5,3,6,1,4,22,18.2,18,17,3,14,9,19,23,2,Matches,2020-2021,Ligue-1
Lionel Carole,fr FRA,DF,Strasbourg,29.0,1991.0,14.9,37,25,18,14,5,16,29,55.2,13,3,1,2,38,75,28,0,Matches,2020-2021,Ligue-1
Moreto Cassamã,gw GNB,MF,Reims,22.0,1998.0,22.6,49,36,24,23,2,27,49,55.1,22,19,6,13,36,85,33,4,Matches,2020-2021,Ligue-1
Jean-Charles Castelletto,cm CMR,DF,Nantes,25.0,1995.0,21.6,31,18,19,11,1,18,31,58.1,13,26,19,7,42,73,79,0,Matches,2020-2021,Ligue-1
Zeki Çelik,tr TUR,DF,Lille,23.0,1997.0,26.5,72,33,30,30,12,44,81,54.3,37,32,6,26,38,110,52,0,Matches,2020-2021,Ligue-1
Bersant Celina,xk KVX,"MF,FW",Dijon,23.0,1996.0,25.5,20,12,8,8,4,7,38,18.4,31,20,2,18,8,28,10,0,Matches,2020-2021,Ligue-1
Fabien Centonze,fr FRA,DF,Metz,24.0,1996.0,35.8,104,68,64,30,10,43,73,58.9,30,62,17,45,112,216,119,1,Matches,2020-2021,Ligue-1
Nassim Chadli,fr FRA,"FW,MF",Nîmes,19.0,2001.0,0.3,2,1,2,0,0,0,1,0.0,1,1,0,1,0,2,0,0,Matches,2020-2021,Ligue-1
Fouad Chafik,ma MAR,DF,Dijon,33.0,1986.0,18.0,39,24,29,8,2,16,35,45.7,19,19,10,9,21,60,41,0,Matches,2020-2021,Ligue-1
Mehdi Chahiri,ma MAR,"FW,MF",Strasbourg,24.0,1996.0,8.9,18,8,7,5,6,8,20,40.0,12,9,0,9,6,24,5,0,Matches,2020-2021,Ligue-1
Aníbal Chalá,ec ECU,DF,Dijon,24.0,1996.0,8.3,10,7,6,3,1,6,12,50.0,6,5,3,2,14,24,15,1,Matches,2020-2021,Ligue-1
Trevoh Chalobah,eng ENG,"DF,MF",Lorient,21.0,1999.0,24.9,45,26,32,13,0,24,50,48.0,26,20,7,13,69,114,56,0,Matches,2020-2021,Ligue-1
Gaëtan Charbonnier,fr FRA,"MF,FW",Brest,31.0,1988.0,17.4,24,15,6,11,7,12,32,37.5,20,15,1,14,9,33,19,0,Matches,2020-2021,Ligue-1
Brendan Chardonnet,fr FRA,DF,Brest,25.0,1994.0,30.2,51,29,31,19,1,27,41,65.9,14,54,41,13,64,115,151,0,Matches,2020-2021,Ligue-1
Xavier Chavalerin,fr FRA,MF,Reims,29.0,1991.0,28.3,92,50,47,38,7,26,74,35.1,48,43,9,34,43,135,29,1,Matches,2020-2021,Ligue-1
Pape Cheikh Diop,sn SEN,MF,Dijon,22.0,1997.0,12.1,24,14,15,6,3,13,33,39.4,20,14,2,12,6,30,6,0,Matches,2020-2021,Ligue-1
Rayan Cherki,fr FRA,"FW,MF",Lyon,16.0,2003.0,7.8,5,3,0,3,2,1,11,9.1,10,3,0,3,4,9,0,0,Matches,2020-2021,Ligue-1
Pedro Chirivella,es ESP,MF,Nantes,23.0,1997.0,25.3,26,8,7,13,6,14,49,28.6,35,23,4,19,41,67,19,0,Matches,2020-2021,Ligue-1
Joris Chotard,fr FRA,MF,Montpellier,18.0,2001.0,12.9,12,8,5,6,1,6,31,19.4,25,12,3,9,11,23,15,0,Matches,2020-2021,Ligue-1
Mounir Chouiar,fr FRA,"FW,MF",Dijon,21.0,1999.0,14.3,22,12,10,9,3,6,18,33.3,12,10,0,10,11,33,8,0,Matches,2020-2021,Ligue-1
Sébastien Cibois,fr FRA,GK,Brest,22.0,1998.0,3.0,0,0,0,0,0,0,0,,0,0,0,0,0,0,0,1,Matches,2020-2021,Ligue-1
Alexis Claude-Maurice,fr FRA,"MF,FW",Nice,22.0,1998.0,21.2,40,19,17,14,9,14,48,29.2,34,16,2,14,14,54,3,0,Matches,2020-2021,Ligue-1
Jonathan Clauss,fr FRA,DF,Lens,27.0,1992.0,28.0,43,20,12,20,11,17,38,44.7,21,24,1,23,45,88,46,0,Matches,2020-2021,Ligue-1
Marcus Coco,fr FRA,"MF,FW",Nantes,24.0,1996.0,16.4,36,21,17,15,4,16,36,44.4,20,16,3,13,20,56,17,0,Matches,2020-2021,Ligue-1
Racine Coly,sn SEN,MF,Nice,24.0,1995.0,0.2,0,0,0,0,0,0,0,,0,0,0,0,0,0,0,0,Matches,2020-2021,Ligue-1
Daniel Congré,fr FRA,DF,Montpellier,35.0,1985.0,36.6,59,35,45,12,2,36,70,51.4,34,50,33,17,69,128,144,3,Matches,2020-2021,Ligue-1
Sébastien Corchia,fr FRA,DF,Nantes,29.0,1990.0,23.0,55,30,29,19,7,33,60,55.0,27,28,10,18,38,93,40,1,Matches,2020-2021,Ligue-1
Maxwel Cornet,ci CIV,"DF,FW",Lyon,23.0,1996.0,27.2,70,41,39,24,7,33,58,56.9,25,23,5,18,43,113,47,1,Matches,2020-2021,Ligue-1
David Costa,pt POR,"MF,FW",Lens,19.0,2001.0,1.7,4,4,1,2,1,2,3,66.7,1,2,0,2,0,4,4,0,Matches,2020-2021,Ligue-1
Charles Costes,fr FRA,MF,Dijon,17.0,2002.0,0.0,0,0,0,0,0,0,0,,0,0,0,0,0,0,0,0,Matches,2020-2021,Ligue-1
Benoît Costil,fr FRA,GK,Bordeaux,33.0,1987.0,38.0,1,1,1,0,0,1,3,33.3,2,1,0,1,1,2,17,0,Matches,2020-2021,Ligue-1
Kalifa Coulibaly,ml MLI,FW,Nantes,28.0,1991.0,10.9,3,1,0,1,2,2,8,25.0,6,3,1,2,2,5,12,0,Matches,2020-2021,Ligue-1
Lassana Coulibaly,ml MLI,MF,Angers,24.0,1996.0,18.7,78,41,33,34,11,39,75,52.0,36,29,4,25,33,111,17,0,Matches,2020-2021,Ligue-1
Senou Coulibaly,ml MLI,DF,Dijon,25.0,1994.0,21.5,33,21,23,10,0,12,24,50.0,12,18,12,6,30,63,89,0,Matches,2020-2021,Ligue-1
Nicolas Cozza,fr FRA,DF,Montpellier,21.0,1999.0,15.2,39,30,27,11,1,20,40,50.0,20,20,11,9,26,65,62,0,Matches,2020-2021,Ligue-1
Andrés Cubas,py PAR,MF,Nîmes,24.0,1996.0,24.9,80,47,30,44,6,33,74,44.6,41,37,10,27,50,130,29,3,Matches,2020-2021,Ligue-1
Mickaël Cuisance,fr FRA,MF,Marseille,20.0,1999.0,11.4,24,11,2,15,7,10,33,30.3,23,13,1,12,3,27,4,0,Matches,2020-2021,Ligue-1
Damien Da Silva,fr FRA,DF,Rennes,32.0,1988.0,29.6,22,13,13,8,1,12,18,66.7,6,17,13,4,44,66,99,1,Matches,2020-2021,Ligue-1
Colin Dagba,fr FRA,DF,Paris S-G,21.0,1998.0,15.1,23,11,4,17,2,14,19,73.7,5,18,5,13,16,39,18,1,Matches,2020-2021,Ligue-1
Flavius Daniliuc,at AUT,DF,Nice,19.0,2001.0,16.4,23,15,15,5,3,10,21,47.6,11,17,6,11,14,37,32,0,Matches,2020-2021,Ligue-1
Dante,br BRA,DF,Nice,36.0,1983.0,8.6,10,5,6,4,0,3,7,42.9,4,6,4,2,10,20,20,0,Matches,2020-2021,Ligue-1
Jonathan David,ca CAN,FW,Lille,20.0,2000.0,26.2,17,10,5,5,7,9,24,37.5,15,19,1,18,3,20,9,0,Matches,2020-2021,Ligue-1
Mattia De Sciglio,it ITA,DF,Lyon,27.0,1992.0,16.3,29,17,15,11,3,18,27,66.7,9,13,4,9,27,56,45,0,Matches,2020-2021,Ligue-1
Thibault De Smet,be BEL,DF,Reims,22.0,1998.0,5.5,11,6,8,3,0,6,15,40.0,9,8,1,7,6,17,16,0,Matches,2020-2021,Ligue-1
Lucas Deaux,fr FRA,"MF,DF",Nîmes,31.0,1988.0,19.5,47,32,20,22,5,16,49,32.7,33,20,3,17,20,67,30,4,Matches,2020-2021,Ligue-1
Mathieu Debuchy,fr FRA,DF,Saint-Étienne,35.0,1985.0,23.4,58,33,37,17,4,40,62,64.5,22,27,9,18,45,103,61,0,Matches,2020-2021,Ligue-1
Romain Del Castillo,fr FRA,"MF,FW",Rennes,24.0,1996.0,7.2,30,11,5,14,11,5,25,20.0,20,6,0,6,3,33,4,1,Matches,2020-2021,Ligue-1
Thomas Delaine,fr FRA,"DF,FW",Metz,28.0,1992.0,19.8,32,18,19,11,2,20,35,57.1,15,22,5,17,24,56,30,1,Matches,2020-2021,Ligue-1
Jonathan Delaplace,fr FRA,DF,Lorient,34.0,1986.0,10.1,8,5,5,1,2,7,13,53.8,6,12,5,7,17,25,19,1,Matches,2020-2021,Ligue-1
Sacha Delaye,fr FRA,MF,Montpellier,18.0,2002.0,0.1,0,0,0,0,0,0,1,0.0,1,0,0,0,1,1,1,0,Matches,2020-2021,Ligue-1
Andy Delort,dz ALG,FW,Montpellier,28.0,1991.0,27.6,12,7,1,9,2,8,18,44.4,10,11,1,10,4,16,34,0,Matches,2020-2021,Ligue-1
Moussa Dembélé,fr FRA,FW,Lyon,24.0,1996.0,7.5,2,2,0,1,1,0,4,0.0,4,4,2,2,5,7,9,0,Matches,2020-2021,Ligue-1
Jason Denayer,be BEL,DF,Lyon,25.0,1995.0,29.0,25,16,16,9,0,6,13,46.2,7,36,25,11,27,52,91,1,Matches,2020-2021,Ligue-1
Kévin Denkey,tg TOG,FW,Nîmes,19.0,2000.0,5.8,4,2,0,3,1,0,3,0.0,3,2,0,2,1,5,2,0,Matches,2020-2021,Ligue-1
Clément Depres,fr FRA,FW,Nîmes,25.0,1994.0,0.2,0,0,0,0,0,0,0,,0,0,0,0,0,0,0,0,Matches,2020-2021,Ligue-1
Ángel Di María,ar ARG,"FW,MF",Paris S-G,32.0,1988.0,20.6,26,17,6,8,12,11,45,24.4,34,14,1,13,6,32,7,0,Matches,2020-2021,Ligue-1
Boulaye Dia,sn SEN,"FW,MF",Reims,23.0,1996.0,32.6,23,12,3,11,9,4,22,18.2,18,19,5,14,12,35,37,1,Matches,2020-2021,Ligue-1
Abdou Diallo,sn SEN,DF,Paris S-G,24.0,1996.0,16.6,16,11,9,5,2,8,13,61.5,5,15,8,7,25,41,36,0,Matches,2020-2021,Ligue-1
Habib Diallo,sn SEN,FW,Strasbourg,25.0,1995.0,25.8,11,6,3,6,2,7,18,38.9,11,12,2,10,13,24,12,0,Matches,2020-2021,Ligue-1
Habib Diallo,sn SEN,"FW,MF",Metz,25.0,1995.0,1.6,1,1,0,1,0,1,1,100.0,0,0,0,0,0,1,5,0,Matches,2020-2021,Ligue-1
Ibrahima Diallo,fr FRA,MF,Brest,21.0,1999.0,4.9,14,9,2,9,3,4,8,50.0,4,4,0,4,3,17,3,0,Matches,2020-2021,Ligue-1
Stéphane Diarra,fr FRA,"MF,FW",Lorient,21.0,1998.0,2.2,0,0,0,0,0,0,7,0.0,7,6,1,5,4,4,1,0,Matches,2020-2021,Ligue-1
Krépin Diatta,sn SEN,"MF,DF",Monaco,21.0,1999.0,4.3,4,3,1,1,2,1,3,33.3,2,5,1,4,4,8,1,0,Matches,2020-2021,Ligue-1
Bamba Dieng,sn SEN,"FW,DF",Marseille,20.0,2000.0,1.4,5,3,3,2,0,2,4,50.0,2,2,0,2,0,5,0,0,Matches,2020-2021,Ligue-1
Junior Dina Ebimbe,fr FRA,"FW,MF",Dijon,19.0,2000.0,23.8,38,25,14,19,5,15,45,33.3,30,17,1,16,14,52,9,0,Matches,2020-2021,Ligue-1
Tristan Dingomé,cm CMR,MF,Reims,29.0,1991.0,0.2,0,0,0,0,0,0,1,0.0,1,0,0,0,0,0,0,0,Matches,2020-2021,Ligue-1
Sinaly Diomande,ci CIV,DF,Lyon,19.0,2001.0,12.6,10,7,8,1,1,5,14,35.7,9,19,15,4,33,43,53,1,Matches,2020-2021,Ligue-1
Lois Diony,fr FRA,FW,Angers,27.0,1992.0,19.4,15,10,3,9,3,4,18,22.2,14,6,3,3,5,20,16,0,Matches,2020-2021,Ligue-1
Sofiane Diop,fr FRA,"MF,FW",Monaco,20.0,2000.0,22.5,49,34,17,25,7,18,53,34.0,35,25,1,24,31,80,15,0,Matches,2020-2021,Ligue-1
Andy Diouf,fr FRA,FW,Rennes,17.0,2003.0,0.1,0,0,0,0,0,0,0,,0,0,0,0,0,0,0,0,Matches,2020-2021,Ligue-1
Yehvann Diouf,fr FRA,GK,Reims,20.0,1999.0,1.5,0,0,0,0,0,0,0,,0,0,0,0,0,0,0,0,Matches,2020-2021,Ligue-1
Assane Dioussé,sn SEN,DF,Saint-Étienne,22.0,1997.0,0.0,0,0,0,0,0,0,0,,0,0,0,0,0,0,0,0,Matches,2020-2021,Ligue-1
Axel Disasi,fr FRA,DF,Monaco,22.0,1998.0,22.3,29,20,17,12,0,20,35,57.1,15,18,11,7,26,55,66,1,Matches,2020-2021,Ligue-1
Tiago Djaló,pt POR,DF,Lille,20.0,2000.0,9.7,22,13,14,5,3,15,23,65.2,8,10,4,6,9,31,23,0,Matches,2020-2021,Ligue-1
Alexander Djiku,gh GHA,"DF,MF",Strasbourg,25.0,1994.0,28.4,60,41,45,13,2,32,52,61.5,20,28,10,18,91,151,104,0,Matches,2020-2021,Ligue-1
Mihai Dobre,ro ROU,FW,Dijon,21.0,1998.0,5.9,12,5,6,2,4,7,14,50.0,7,5,0,5,10,22,3,0,Matches,2020-2021,Ligue-1
Jeremy Doku,be BEL,"MF,FW",Rennes,18.0,2002.0,25.7,44,25,9,24,11,11,26,42.3,15,18,1,17,11,55,1,0,Matches,2020-2021,Ligue-1
Kasper Dolberg,dk DEN,FW,Nice,22.0,1997.0,21.4,6,2,1,3,2,2,11,18.2,9,11,2,9,6,12,19,1,Matches,2020-2021,Ligue-1
Keagan Dolly,za RSA,MF,Montpellier,27.0,1993.0,5.0,7,2,6,0,1,4,8,50.0,4,3,0,3,5,12,2,0,Matches,2020-2021,Ligue-1
Anastasios Donis,gr GRE,MF,Reims,23.0,1996.0,1.1,4,1,2,0,2,1,1,100.0,0,0,0,0,0,4,0,0,Matches,2020-2021,Ligue-1
Cheick Doucouré,ml MLI,MF,Lens,20.0,2000.0,29.2,87,47,40,42,5,32,65,49.2,33,20,4,16,52,139,26,1,Matches,2020-2021,Ligue-1
Fodé Doucouré,ml MLI,DF,Reims,19.0,2001.0,3.7,11,8,7,4,0,4,9,44.4,5,2,0,2,4,15,11,0,Matches,2020-2021,Ligue-1
Mahamadou Doucouré,ml MLI,"FW,MF",Nîmes,20.0,2000.0,0.5,1,1,1,0,0,1,1,100.0,0,0,0,0,0,1,0,0,Matches,2020-2021,Ligue-1
Moussa Doumbia,ml MLI,"MF,FW",Reims,25.0,1994.0,10.0,10,6,4,4,2,4,22,18.2,18,5,1,4,10,20,4,0,Matches,2020-2021,Ligue-1
Souleyman Doumbia,ci CIV,DF,Angers,23.0,1996.0,24.7,48,33,25,19,4,22,36,61.1,14,18,4,14,42,90,50,0,Matches,2020-2021,Ligue-1
Mouhamadou Drammeh,fr FRA,MF,Reims,21.0,1999.0,1.9,0,0,0,0,0,0,2,0.0,2,0,0,0,2,2,7,0,Matches,2020-2021,Ligue-1
Julian Draxler,de GER,"MF,FW",Paris S-G,26.0,1993.0,11.8,13,6,5,6,2,5,20,25.0,15,4,0,4,14,27,0,0,Matches,2020-2021,Ligue-1
Matthieu Dreyer,fr FRA,GK,Lorient,31.0,1989.0,15.0,0,0,0,0,0,0,0,,0,0,0,0,0,0,4,2,Matches,2020-2021,Ligue-1
Leo Dubois,fr FRA,DF,Lyon,25.0,1994.0,32.3,38,26,19,16,3,19,37,51.4,18,27,9,18,31,69,69,2,Matches,2020-2021,Ligue-1
Haris Duljević,ba BIH,"MF,FW",Nîmes,26.0,1993.0,8.6,15,9,4,7,4,6,22,27.3,16,3,0,3,8,23,1,0,Matches,2020-2021,Ligue-1
Jean-Kevin Duverne,ht HAI,DF,Brest,23.0,1997.0,22.5,38,21,24,14,0,15,32,46.9,17,24,16,8,30,68,70,0,Matches,2020-2021,Ligue-1
Enzo Ebosse,cm CMR,DF,Angers,21.0,1999.0,2.9,5,3,5,0,0,3,4,75.0,1,1,1,0,2,7,13,0,Matches,2020-2021,Ligue-1
Bruno Ecuele Manga,ga GAB,DF,Dijon,32.0,1988.0,38.0,52,38,46,6,0,29,40,72.5,11,50,33,17,57,109,165,3,Matches,2020-2021,Ligue-1
Hugo Ekitike,fr FRA,"FW,MF",Reims,18.0,2002.0,1.0,1,1,0,0,1,0,1,0.0,1,0,0,0,0,1,0,0,Matches,2020-2021,Ligue-1
Niclas Eliasson,se SWE,"MF,FW",Nîmes,24.0,1995.0,20.0,28,14,9,12,7,11,24,45.8,13,20,1,19,23,51,16,0,Matches,2020-2021,Ligue-1
Renaud Emond,be BEL,"FW,MF",Nantes,28.0,1991.0,3.9,0,0,0,0,0,0,1,0.0,1,2,0,2,0,0,1,0,Matches,2020-2021,Ligue-1
Yoann Etienne,fr FRA,DF,Lorient,23.0,1997.0,1.0,2,0,1,1,0,1,1,100.0,0,1,0,1,1,3,2,0,Matches,2020-2021,Ligue-1
Fábio,br BRA,DF,Nantes,30.0,1990.0,16.7,62,37,37,23,2,35,61,57.4,26,29,8,21,37,99,49,0,Matches,2020-2021,Ligue-1
Cesc Fàbregas,es ESP,"MF,FW",Monaco,33.0,1987.0,9.7,20,12,6,9,5,9,22,40.9,13,11,1,10,13,33,3,0,Matches,2020-2021,Ligue-1
Bandiougou Fadiga,fr FRA,"FW,MF",Paris S-G,19.0,2001.0,0.7,1,0,1,0,0,0,0,,0,0,0,0,0,1,0,0,Matches,2020-2021,Ligue-1
Bandiougou Fadiga,fr FRA,"MF,FW",Brest,19.0,2001.0,0.5,0,0,0,0,0,0,2,0.0,2,0,0,0,0,0,0,0,Matches,2020-2021,Ligue-1
Wout Faes,be BEL,DF,Reims,22.0,1998.0,32.2,35,22,26,9,0,20,39,51.3,19,40,31,9,68,103,144,1,Matches,2020-2021,Ligue-1
Romain Faivre,fr FRA,"MF,FW",Brest,22.0,1998.0,32.1,54,27,26,23,5,21,54,38.9,33,30,0,30,30,84,18,0,Matches,2020-2021,Ligue-1
Wuilker Faríñez,ve VEN,GK,Lens,22.0,1998.0,1.2,0,0,0,0,0,0,0,,0,0,0,0,0,0,1,0,Matches,2020-2021,Ligue-1
Noah Fatar,fr FRA,"FW,MF",Angers,18.0,2002.0,0.2,1,0,0,0,1,0,0,,0,0,0,0,0,1,0,0,Matches,2020-2021,Ligue-1
Julien Faussurier,fr FRA,DF,Brest,33.0,1987.0,10.6,16,11,6,8,2,11,25,44.0,14,12,4,8,9,25,10,0,Matches,2020-2021,Ligue-1
Zinedine Ferhat,dz ALG,"FW,MF",Nîmes,27.0,1993.0,32.9,36,21,18,9,9,18,39,46.2,21,22,0,22,32,68,38,0,Matches,2020-2021,Ligue-1
Jordan Ferri,fr FRA,MF,Montpellier,28.0,1992.0,28.6,58,40,34,22,2,31,103,30.1,72,30,5,25,8,66,18,1,Matches,2020-2021,Ligue-1
Alexis Flips,fr FRA,"MF,FW",Reims,20.0,2000.0,0.5,0,0,0,0,0,0,2,0.0,2,0,0,0,0,0,1,0,Matches,2020-2021,Ligue-1
Alessandro Florenzi,it ITA,DF,Paris S-G,29.0,1991.0,17.1,24,16,9,9,6,12,29,41.4,17,7,1,6,17,41,25,0,Matches,2020-2021,Ligue-1
Mamadou Fofana,ml MLI,"MF,DF",Metz,22.0,1998.0,11.9,25,11,17,8,0,7,31,22.6,24,14,2,12,18,43,36,0,Matches,2020-2021,Ligue-1
Seko Fofana,ci CIV,MF,Lens,25.0,1995.0,25.7,16,8,3,10,3,4,26,15.4,22,16,5,11,34,50,23,1,Matches,2020-2021,Ligue-1
Wesley Fofana,fr FRA,DF,Saint-Étienne,19.0,2000.0,3.5,6,4,6,0,0,3,4,75.0,1,3,3,0,8,14,14,1,Matches,2020-2021,Ligue-1
Youssouf Fofana,fr FRA,MF,Monaco,21.0,1999.0,31.9,90,51,31,51,8,42,82,51.2,40,43,7,36,34,124,14,2,Matches,2020-2021,Ligue-1
Thomas Foket,be BEL,DF,Reims,25.0,1994.0,36.9,77,43,50,20,7,40,69,58.0,29,28,7,21,69,146,92,2,Matches,2020-2021,Ligue-1
Lamine Fomba,fr FRA,MF,Nîmes,22.0,1998.0,24.2,66,36,30,25,11,30,65,46.2,35,48,19,29,59,125,39,2,Matches,2020-2021,Ligue-1
Thomas Fontaine,mg MAD,DF,Lorient,29.0,1991.0,3.6,5,2,5,0,0,2,2,100.0,0,3,2,1,5,10,14,0,Matches,2020-2021,Ligue-1
José Fonte,pt POR,DF,Lille,36.0,1983.0,35.4,40,29,28,10,2,27,33,81.8,6,36,23,13,36,76,137,1,Matches,2020-2021,Ligue-1
Steven Fortes,cv CPV,DF,Lens,28.0,1992.0,15.9,33,20,20,10,3,16,22,72.7,6,25,10,15,27,60,52,0,Matches,2020-2021,Ligue-1
Yassin Fortune,fr FRA,FW,Angers,21.0,1999.0,0.2,0,0,0,0,0,0,0,,0,0,0,0,0,0,0,0,Matches,2020-2021,Ligue-1
Angelo Fulgini,fr FRA,MF,Angers,23.0,1996.0,30.3,22,13,4,12,6,12,34,35.3,22,17,0,17,15,37,9,0,Matches,2020-2021,Ligue-1
Baptiste Gabard,fr FRA,MF,Saint-Étienne,20.0,2000.0,1.5,4,3,1,3,0,1,5,20.0,4,4,0,4,1,5,0,0,Matches,2020-2021,Ligue-1
Idrissa Gana Gueye,sn SEN,MF,Paris S-G,30.0,1989.0,17.6,63,35,20,34,9,26,50,52.0,24,26,7,19,20,83,9,3,Matches,2020-2021,Ligue-1
Ignatius Ganago,cm CMR,FW,Lens,21.0,1999.0,14.5,4,3,0,2,2,3,12,25.0,9,7,1,6,6,10,3,0,Matches,2020-2021,Ligue-1
Yann Gboho,fr FRA,"MF,FW",Rennes,19.0,2001.0,3.4,6,3,3,1,2,3,8,37.5,5,1,0,1,1,7,3,1,Matches,2020-2021,Ligue-1
Valère Germain,fr FRA,"FW,MF",Marseille,30.0,1990.0,9.5,8,6,2,4,2,3,11,27.3,8,7,2,5,11,19,22,0,Matches,2020-2021,Ligue-1
Willem Geubbels,fr FRA,"MF,FW",Monaco,18.0,2001.0,3.3,12,8,5,7,0,5,13,38.5,8,9,0,9,3,15,5,0,Matches,2020-2021,Ligue-1
Andrei Girotto,br BRA,"DF,MF",Nantes,28.0,1992.0,29.6,65,41,50,15,0,39,70,55.7,31,34,15,19,59,124,103,0,Matches,2020-2021,Ligue-1
Aleksandr Golovin,ru RUS,"MF,FW",Monaco,24.0,1996.0,11.9,28,16,6,18,4,8,39,20.5,31,21,0,21,11,39,3,0,Matches,2020-2021,Ligue-1
Alfred Gomis,sn SEN,GK,Dijon,26.0,1993.0,5.0,1,0,1,0,0,1,2,50.0,1,0,0,0,1,2,7,0,Matches,2020-2021,Ligue-1
Alfred Gomis,sn SEN,GK,Rennes,26.0,1993.0,22.0,1,1,1,0,0,1,1,100.0,0,0,0,0,3,4,10,1,Matches,2020-2021,Ligue-1
Vagner Gonçalves,cv CPV,"FW,MF",Metz,24.0,1996.0,10.7,16,9,5,5,6,2,15,13.3,13,6,0,6,4,20,1,1,Matches,2020-2021,Ligue-1
Álvaro González,es ESP,DF,Marseille,30.0,1990.0,31.5,26,17,20,6,0,19,31,61.3,12,30,18,12,33,59,119,1,Matches,2020-2021,Ligue-1
Amine Gouiri,dz ALG,"FW,MF",Nice,20.0,2000.0,30.5,31,18,7,16,8,10,41,24.4,31,22,6,16,17,48,23,0,Matches,2020-2021,Ligue-1
Lucas Gourna-Douath,fr FRA,MF,Saint-Étienne,16.0,2003.0,14.7,32,22,18,11,3,15,28,53.6,13,10,0,10,24,56,18,0,Matches,2020-2021,Ligue-1
Jonathan Gradit,fr FRA,DF,Lens,27.0,1992.0,31.4,60,39,26,28,6,22,38,57.9,16,37,19,18,56,116,81,1,Matches,2020-2021,Ligue-1
Andrew Gravillon,gp GLP,DF,Lorient,22.0,1998.0,25.2,26,17,17,9,0,13,28,46.4,15,44,31,13,59,85,118,4,Matches,2020-2021,Ligue-1
Adrian Grbić,at AUT,FW,Lorient,23.0,1996.0,10.7,6,4,2,2,2,1,7,14.3,6,6,0,6,5,11,7,0,Matches,2020-2021,Ligue-1
Etienne Green,eng ENG,GK,Saint-Étienne,20.0,2000.0,8.0,0,0,0,0,0,0,0,,0,0,0,0,0,0,3,0,Matches,2020-2021,Ligue-1
Clément Grenier,fr FRA,"MF,FW",Rennes,29.0,1991.0,12.0,20,8,9,8,3,7,31,22.6,24,7,0,7,5,25,3,0,Matches,2020-2021,Ligue-1
Evann Guessand,ci CIV,FW,Nice,19.0,2001.0,0.3,0,0,0,0,0,0,1,0.0,1,1,1,0,1,1,1,0,Matches,2020-2021,Ligue-1
Kelyan Guessoum,fr FRA,DF,Nîmes,21.0,1999.0,12.5,13,7,11,1,1,11,16,68.8,5,8,6,2,24,37,51,0,Matches,2020-2021,Ligue-1
Lamine Gueye,sn SEN,"FW,MF",Metz,22.0,1998.0,16.2,18,9,4,11,3,7,24,29.2,17,7,2,5,21,39,5,0,Matches,2020-2021,Ligue-1
Pape Gueye,sn SEN,MF,Marseille,21.0,1999.0,22.9,49,21,25,19,5,15,45,33.3,30,25,6,19,47,96,34,0,Matches,2020-2021,Ligue-1
Frederic Guilbert,fr FRA,DF,Strasbourg,25.0,1994.0,12.4,37,19,23,11,3,21,34,61.8,13,14,1,13,33,70,32,0,Matches,2020-2021,Ligue-1
Bruno Guimarães,br BRA,MF,Lyon,22.0,1997.0,19.5,76,34,26,41,9,30,64,46.9,34,24,4,20,14,90,13,0,Matches,2020-2021,Ligue-1
Serhou Guirassy,gn GUI,FW,Rennes,24.0,1996.0,19.6,4,1,1,3,0,1,3,33.3,2,10,1,9,5,9,17,0,Matches,2020-2021,Ligue-1
Malo Gusto,fr FRA,"DF,MF",Lyon,17.0,2003.0,0.0,0,0,0,0,0,0,0,,0,0,0,0,0,0,0,0,Matches,2020-2021,Ligue-1
Massadio Haïdara,ml MLI,DF,Lens,27.0,1992.0,23.7,48,32,21,21,6,23,37,62.2,14,29,6,23,35,83,60,0,Matches,2020-2021,Ligue-1
Pierre-Yves Hamel,fr FRA,FW,Lorient,26.0,1994.0,9.4,15,8,3,9,3,1,6,16.7,5,12,1,11,10,25,6,0,Matches,2020-2021,Ligue-1
Romain Hamouma,fr FRA,"FW,MF",Saint-Étienne,33.0,1987.0,19.7,12,7,5,6,1,4,24,16.7,20,17,1,16,7,19,11,0,Matches,2020-2021,Ligue-1
Dalbert Henrique,br BRA,DF,Rennes,26.0,1993.0,4.1,7,6,4,2,1,6,8,75.0,2,8,2,6,5,12,8,0,Matches,2020-2021,Ligue-1
Luis Henrique,br BRA,"FW,DF",Marseille,18.0,2001.0,7.5,5,4,3,1,1,4,9,44.4,5,5,1,4,7,12,4,0,Matches,2020-2021,Ligue-1
Christophe Hérelle,mq MTQ,DF,Brest,27.0,1992.0,15.3,19,13,12,6,1,10,12,83.3,2,13,9,4,31,50,41,2,Matches,2020-2021,Ligue-1
Jérôme Hergault,fr FRA,"DF,MF",Lorient,34.0,1986.0,18.1,38,23,22,10,6,17,31,54.8,14,16,2,14,22,60,34,0,Matches,2020-2021,Ligue-1
Ander Herrera,es ESP,MF,Paris S-G,30.0,1989.0,20.6,53,35,17,26,10,30,77,39.0,47,31,5,26,31,84,22,1,Matches,2020-2021,Ligue-1
Vitorino Hilton,br BRA,DF,Montpellier,42.0,1977.0,23.5,15,10,10,4,1,3,14,21.4,11,34,26,8,38,53,104,3,Matches,2020-2021,Ligue-1
Franck Honorat,fr FRA,"MF,FW",Brest,23.0,1996.0,27.3,28,13,12,10,6,14,37,37.8,23,15,3,12,11,39,24,0,Matches,2020-2021,Ligue-1
Fraser Hornby,sct SCO,"FW,MF",Reims,20.0,1999.0,0.4,0,0,0,0,0,0,0,,0,0,0,0,1,1,0,0,Matches,2020-2021,Ligue-1
Adrien Hunou,fr FRA,"FW,MF",Rennes,26.0,1994.0,6.5,6,3,2,2,2,2,8,25.0,6,7,0,7,1,7,2,0,Matches,2020-2021,Ligue-1
Didier Ibrahim Ndong,ga GAB,MF,Dijon,26.0,1994.0,29.0,53,32,22,30,1,25,70,35.7,45,35,7,28,37,90,40,0,Matches,2020-2021,Ligue-1
Mauro Icardi,ar ARG,FW,Paris S-G,27.0,1993.0,12.0,6,2,1,2,3,4,13,30.8,9,3,1,2,3,9,7,0,Matches,2020-2021,Ligue-1
Jonathan Ikone,fr FRA,"MF,FW",Lille,22.0,1998.0,24.2,18,12,3,8,7,9,22,40.9,13,16,1,15,7,25,9,0,Matches,2020-2021,Ligue-1
Yun Il-lok,kr KOR,"MF,FW",Montpellier,28.0,1992.0,3.5,0,0,0,0,0,0,4,0.0,4,0,0,0,5,5,1,0,Matches,2020-2021,Ligue-1
Corentin Jean,fr FRA,"FW,MF",Lens,25.0,1995.0,6.4,4,3,1,1,2,0,5,0.0,5,4,0,4,2,6,2,0,Matches,2020-2021,Ligue-1
Jesé,es ESP,FW,Paris S-G,27.0,1993.0,0.3,0,0,0,0,0,0,1,0.0,1,0,0,0,0,0,0,0,Matches,2020-2021,Ligue-1
Stevan Jovetić,me MNE,"FW,MF",Monaco,30.0,1989.0,8.9,8,4,2,3,3,3,13,23.1,10,1,0,1,3,11,3,0,Matches,2020-2021,Ligue-1
Abdoul Kader Bamba,fr FRA,"FW,MF",Nantes,26.0,1994.0,10.2,18,3,7,8,3,11,18,61.1,7,10,0,10,7,25,4,1,Matches,2020-2021,Ligue-1
Tino Kadewere,zw ZIM,FW,Lyon,24.0,1996.0,22.3,35,22,12,16,7,17,49,34.7,32,16,3,13,21,56,31,0,Matches,2020-2021,Ligue-1
Gaël Kakuta,cd COD,"MF,FW",Lens,29.0,1991.0,26.6,38,23,10,18,10,8,44,18.2,36,24,3,21,17,55,4,0,Matches,2020-2021,Ligue-1
Arnaud Kalimuendo,fr FRA,FW,Paris S-G,18.0,2002.0,0.8,0,0,0,0,0,0,0,,0,0,0,0,0,0,0,0,Matches,2020-2021,Ligue-1
Arnaud Kalimuendo,fr FRA,"FW,MF",Lens,18.0,2002.0,13.5,8,2,2,2,4,1,7,14.3,6,11,0,11,2,10,2,0,Matches,2020-2021,Ligue-1
Samuel Kalu,ng NGA,"FW,MF",Bordeaux,22.0,1997.0,10.7,21,12,11,8,2,4,13,30.8,9,14,0,14,9,30,2,0,Matches,2020-2021,Ligue-1
Aboubakar Kamara,mr MTN,"FW,MF",Dijon,25.0,1995.0,6.2,3,1,0,2,1,1,7,14.3,6,1,0,1,0,3,2,0,Matches,2020-2021,Ligue-1
Bingourou Kamara,sn SEN,GK,Strasbourg,23.0,1996.0,8.0,1,1,1,0,0,1,3,33.3,2,0,0,0,1,2,2,1,Matches,2020-2021,Ligue-1
Boubacar Kamara,fr FRA,MF,Marseille,20.0,1999.0,32.2,88,51,31,49,8,40,74,54.1,34,36,13,23,34,122,51,0,Matches,2020-2021,Ligue-1
Hassane Kamara,ci CIV,"DF,FW",Nice,26.0,1994.0,32.9,65,39,40,16,9,27,49,55.1,22,39,12,27,55,120,61,1,Matches,2020-2021,Ligue-1
Wilfried Kanga,ci CIV,FW,Angers,22.0,1998.0,1.5,0,0,0,0,0,0,1,0.0,1,1,0,1,0,0,2,0,Matches,2020-2021,Ligue-1
Eiji Kawashima,jp JPN,GK,Strasbourg,37.0,1983.0,24.0,1,0,1,0,0,1,1,100.0,0,0,0,0,0,1,4,2,Matches,2020-2021,Ligue-1
Moise Kean,it ITA,FW,Paris S-G,20.0,2000.0,18.9,11,8,2,6,3,3,12,25.0,9,7,1,6,8,19,10,0,Matches,2020-2021,Ligue-1
Thilo Kehrer,de GER,DF,Paris S-G,23.0,1996.0,18.0,31,26,17,11,3,10,26,38.5,16,16,4,12,15,46,37,1,Matches,2020-2021,Ligue-1
Habib Keita,ml MLI,MF,Lyon,18.0,2002.0,0.1,0,0,0,0,0,0,0,,0,0,0,0,0,0,0,0,Matches,2020-2021,Ligue-1
Saîf-Eddine Khaoui,tn TUN,"FW,DF",Marseille,25.0,1995.0,6.7,19,11,7,6,6,7,16,43.8,9,8,0,8,12,31,1,0,Matches,2020-2021,Ligue-1
Wahbi Khazri,tn TUN,FW,Saint-Étienne,29.0,1991.0,13.1,24,15,12,7,5,12,24,50.0,12,10,1,9,4,28,11,0,Matches,2020-2021,Ligue-1
Presnel Kimpembe,fr FRA,DF,Paris S-G,24.0,1995.0,25.6,46,28,23,19,4,24,34,70.6,10,19,11,8,30,76,61,4,Matches,2020-2021,Ligue-1
Randal Kolo Muani,fr FRA,FW,Nantes,21.0,1998.0,33.7,22,14,2,12,8,6,26,23.1,20,15,2,13,8,30,26,0,Matches,2020-2021,Ligue-1
Timothée Kolodziejczak,fr FRA,DF,Saint-Étienne,28.0,1991.0,22.6,28,15,23,5,0,19,27,70.4,8,24,15,9,36,64,80,1,Matches,2020-2021,Ligue-1
Ghislain Konan,ci CIV,DF,Reims,24.0,1995.0,29.0,57,32,35,17,5,32,56,57.1,24,25,11,14,30,87,67,0,Matches,2020-2021,Ligue-1
Moussa Konaté,sn SEN,FW,Dijon,27.0,1993.0,13.3,5,3,1,2,2,2,11,18.2,9,4,1,3,5,10,8,0,Matches,2020-2021,Ligue-1
Lamine Koné,ci CIV,DF,Strasbourg,31.0,1989.0,11.6,9,6,5,4,0,5,8,62.5,3,4,3,1,15,24,36,0,Matches,2020-2021,Ligue-1
Moussa Koné,sn SEN,FW,Nîmes,23.0,1996.0,19.5,13,6,1,8,4,2,9,22.2,7,7,1,6,2,15,7,0,Matches,2020-2021,Ligue-1
Laurent Koscielny,fr FRA,DF,Bordeaux,34.0,1985.0,24.6,29,17,18,11,0,16,24,66.7,8,44,34,10,54,83,115,1,Matches,2020-2021,Ligue-1
Boubakar Kouyaté,ml MLI,DF,Metz,23.0,1997.0,21.8,60,35,45,15,0,32,58,55.2,26,44,27,17,60,120,132,1,Matches,2020-2021,Ligue-1
Jean-Philippe Krasso,ci CIV,FW,Saint-Étienne,23.0,1997.0,2.5,5,3,1,4,0,2,4,50.0,2,5,0,5,1,6,3,0,Matches,2020-2021,Ligue-1
Layvin Kurzawa,fr FRA,DF,Paris S-G,27.0,1992.0,14.2,26,19,10,10,6,9,28,32.1,19,20,5,15,28,54,26,1,Matches,2020-2021,Ligue-1
Dereck Kutesa,ch SUI,"MF,FW",Reims,22.0,1997.0,7.6,15,7,7,3,5,5,14,35.7,9,7,1,6,7,22,3,0,Matches,2020-2021,Ligue-1
Enock Kwateng,fr FRA,DF,Bordeaux,23.0,1997.0,11.5,21,12,15,4,2,14,27,51.9,13,15,3,12,26,47,27,0,Matches,2020-2021,Ligue-1
Gaëtan Laborde,fr FRA,"FW,MF",Montpellier,26.0,1994.0,36.2,43,22,21,17,5,16,60,26.7,44,29,3,26,16,59,25,1,Matches,2020-2021,Ligue-1
Tom Lacoux,fr FRA,MF,Bordeaux,18.0,2002.0,5.8,22,14,10,11,1,9,21,42.9,12,12,3,9,12,34,7,0,Matches,2020-2021,Ligue-1
Alban Lafont,fr FRA,GK,Nantes,21.0,1999.0,38.0,1,0,1,0,0,1,1,100.0,0,1,0,1,0,1,14,0,Matches,2020-2021,Ligue-1
Kenny Lala,mg MAD,DF,Strasbourg,28.0,1991.0,20.4,22,13,13,8,1,11,22,50.0,11,12,6,6,23,45,33,1,Matches,2020-2021,Ligue-1
Loïck Landre,fr FRA,DF,Nîmes,28.0,1992.0,18.1,14,7,9,5,0,13,28,46.4,15,22,19,3,31,45,52,0,Matches,2020-2021,Ligue-1
Julien Laporte,fr FRA,DF,Lorient,26.0,1993.0,29.5,65,39,48,16,1,42,74,56.8,32,34,23,11,65,130,125,0,Matches,2020-2021,Ligue-1
Gautier Larsonneur,fr FRA,GK,Brest,23.0,1997.0,35.0,1,1,1,0,0,1,1,100.0,0,2,0,2,0,1,16,3,Matches,2020-2021,Ligue-1
Paul Lasne,fr FRA,MF,Brest,31.0,1989.0,18.7,46,26,25,19,2,17,40,42.5,23,25,5,20,47,93,17,2,Matches,2020-2021,Ligue-1
Armand Lauriente,fr FRA,"MF,FW",Lorient,21.0,1998.0,18.0,30,10,10,19,1,7,26,26.9,19,21,0,21,15,45,4,0,Matches,2020-2021,Ligue-1
Wesley Lautoa,nc NCL,"MF,DF",Dijon,32.0,1987.0,17.9,36,20,20,13,3,11,37,29.7,26,17,8,9,29,65,33,1,Matches,2020-2021,Ligue-1
Jérémy Le Douaron,fr FRA,"FW,MF",Brest,22.0,1998.0,9.1,15,10,9,4,2,7,21,33.3,14,14,1,13,8,23,11,0,Matches,2020-2021,Ligue-1
Enzo Le Fée,fr FRA,MF,Lorient,20.0,2000.0,20.2,51,28,23,23,5,27,73,37.0,46,30,6,24,25,76,10,0,Matches,2020-2021,Ligue-1
Vincent Le Goff,fr FRA,DF,Lorient,30.0,1989.0,25.6,42,29,16,24,2,18,49,36.7,31,27,5,22,44,86,44,0,Matches,2020-2021,Ligue-1
Damien Le Tallec,fr FRA,"MF,DF",Montpellier,30.0,1990.0,13.6,16,10,10,5,1,10,30,33.3,20,15,8,7,25,41,21,2,Matches,2020-2021,Ligue-1
James Lea Siliki,cm CMR,MF,Rennes,24.0,1996.0,2.8,5,2,1,3,1,2,2,100.0,0,3,0,3,1,6,1,1,Matches,2020-2021,Ligue-1
Jean-Louis Leca,fr FRA,GK,Lens,34.0,1985.0,36.8,3,2,3,0,0,3,5,60.0,2,0,0,0,1,4,14,4,Matches,2020-2021,Ligue-1
Benjamin Lecomte,fr FRA,GK,Monaco,29.0,1991.0,28.0,0,0,0,0,0,0,2,0.0,2,1,0,1,2,2,20,1,Matches,2020-2021,Ligue-1
Pierre Lees-Melou,fr FRA,MF,Nice,27.0,1993.0,22.9,67,39,33,31,3,25,83,30.1,58,50,14,36,29,96,31,1,Matches,2020-2021,Ligue-1
Fabien Lemoine,fr FRA,MF,Lorient,33.0,1987.0,21.5,74,45,39,33,2,36,89,40.4,53,25,1,24,27,101,35,0,Matches,2020-2021,Ligue-1
Aaron Leya Iseka,be BEL,FW,Metz,22.0,1997.0,11.2,6,4,2,3,1,0,4,0.0,4,4,2,2,0,6,6,0,Matches,2020-2021,Ligue-1
Yanis Lhery,fr FRA,MF,Saint-Étienne,17.0,2003.0,0.3,0,0,0,0,0,0,0,,0,0,0,0,0,0,0,0,Matches,2020-2021,Ligue-1
Dimitri Liénard,fr FRA,MF,Strasbourg,32.0,1988.0,20.3,39,27,17,19,3,24,55,43.6,31,23,1,22,18,57,10,0,Matches,2020-2021,Ligue-1
Isaac Lihadji,fr FRA,"MF,FW",Lille,18.0,2002.0,2.2,11,4,2,6,3,4,5,80.0,1,5,1,4,1,12,0,1,Matches,2020-2021,Ligue-1
Pol Lirola,es ESP,"DF,FW",Marseille,22.0,1997.0,17.3,28,16,11,15,2,16,28,57.1,12,18,5,13,25,53,26,0,Matches,2020-2021,Ligue-1
Anthony Lopes,pt POR,GK,Lyon,29.0,1990.0,38.0,1,1,1,0,0,1,2,50.0,1,1,0,1,1,2,20,1,Matches,2020-2021,Ligue-1
Rony Lopes,pt POR,"FW,MF",Nice,24.0,1995.0,19.8,20,14,4,13,3,6,27,22.2,21,14,3,11,8,28,6,0,Matches,2020-2021,Ligue-1
Maxime Lopez,fr FRA,"FW,MF",Marseille,22.0,1997.0,1.5,1,1,1,0,0,0,2,0.0,2,0,0,0,2,3,2,0,Matches,2020-2021,Ligue-1
Dion Lopy,sn SEN,MF,Reims,18.0,2002.0,2.8,1,1,0,1,0,0,0,,0,0,0,0,2,3,1,0,Matches,2020-2021,Ligue-1
Jordan Lotomba,ch SUI,"DF,MF",Nice,21.0,1998.0,23.6,35,25,19,11,5,20,34,58.8,14,19,7,12,33,68,52,1,Matches,2020-2021,Ligue-1
Adrien Louveau,fr FRA,MF,Lens,20.0,2000.0,0.1,0,0,0,0,0,0,0,,0,0,0,0,0,0,1,0,Matches,2020-2021,Ligue-1
Imran Louza,ma MAR,MF,Nantes,21.0,1999.0,26.4,55,28,25,26,4,21,69,30.4,48,20,4,16,34,89,15,2,Matches,2020-2021,Ligue-1
Jean Lucas,br BRA,MF,Lyon,22.0,1998.0,1.9,3,2,2,1,0,1,4,25.0,3,3,1,2,2,5,1,0,Matches,2020-2021,Ligue-1
Jean Lucas,br BRA,"MF,FW",Brest,22.0,1998.0,11.2,19,13,10,9,0,8,29,27.6,21,7,0,7,8,27,10,1,Matches,2020-2021,Ligue-1
Florentino Luís,pt POR,MF,Monaco,20.0,1999.0,2.7,7,2,4,2,1,6,10,60.0,4,1,0,1,6,13,2,1,Matches,2020-2021,Ligue-1
Yann M'Vila,fr FRA,MF,Saint-Étienne,30.0,1990.0,0.2,0,0,0,0,0,0,2,0.0,2,0,0,0,1,1,0,0,Matches,2020-2021,Ligue-1
Yvann Macon,fr FRA,DF,Saint-Étienne,21.0,1998.0,6.0,30,20,20,8,2,7,19,36.8,12,6,2,4,9,39,13,0,Matches,2020-2021,Ligue-1
Hugo Magnetti,fr FRA,MF,Brest,22.0,1998.0,6.7,24,12,10,13,1,20,40,50.0,20,6,1,5,14,38,8,0,Matches,2020-2021,Ligue-1
Hicham Mahou,fr FRA,FW,Nice,21.0,1999.0,0.4,1,1,1,0,0,1,2,50.0,1,2,0,2,1,2,0,0,Matches,2020-2021,Ligue-1
Habib Maïga,ci CIV,MF,Metz,24.0,1996.0,29.9,81,52,36,40,5,42,85,49.4,43,37,6,31,49,130,36,0,Matches,2020-2021,Ligue-1
Mike Maignan,fr FRA,GK,Lille,25.0,1995.0,38.0,0,0,0,0,0,0,0,,0,0,0,0,0,0,7,2,Matches,2020-2021,Ligue-1
Josh Maja,ng NGA,FW,Bordeaux,21.0,1998.0,8.9,8,2,3,3,2,3,14,21.4,11,3,0,3,6,14,9,0,Matches,2020-2021,Ligue-1
Radosław Majecki,pl POL,GK,Monaco,20.0,1999.0,1.0,0,0,0,0,0,0,0,,0,0,0,0,0,0,1,0,Matches,2020-2021,Ligue-1
Abdul Majeed Waris,gh GHA,"FW,MF",Strasbourg,28.0,1991.0,6.1,1,1,1,0,0,1,6,16.7,5,0,0,0,2,3,2,0,Matches,2020-2021,Ligue-1
Marco Majouga,cf CTA,"FW,MF",Nîmes,19.0,2001.0,1.4,1,1,1,0,0,1,3,33.3,2,0,0,0,0,1,0,0,Matches,2020-2021,Ligue-1
Hianga Mananga Mbock,fr FRA,"MF,FW",Brest,20.0,1999.0,5.1,4,3,2,2,0,2,9,22.2,7,2,0,2,3,7,6,0,Matches,2020-2021,Ligue-1
Vincent Manceau,fr FRA,DF,Angers,31.0,1989.0,25.7,42,27,23,17,2,30,63,47.6,33,23,2,21,35,77,61,0,Matches,2020-2021,Ligue-1
Steve Mandanda,fr FRA,GK,Marseille,35.0,1985.0,37.0,0,0,0,0,0,0,1,0.0,1,0,0,0,2,2,8,6,Matches,2020-2021,Ligue-1
Reinildo Mandava,mz MOZ,DF,Lille,26.0,1994.0,24.2,79,43,39,32,8,35,58,60.3,23,26,3,23,45,124,53,0,Matches,2020-2021,Ligue-1
Thomas Mangani,fr FRA,MF,Angers,33.0,1987.0,29.9,54,37,25,26,3,30,90,33.3,60,31,8,23,38,92,39,0,Matches,2020-2021,Ligue-1
Vito Mannone,it ITA,GK,Monaco,32.0,1988.0,9.0,0,0,0,0,0,0,0,,0,0,0,0,0,0,3,1,Matches,2020-2021,Ligue-1
Myziane Maolida,km COM,"FW,MF",Nice,21.0,1999.0,12.0,13,8,4,4,5,4,11,36.4,7,6,1,5,6,19,4,0,Matches,2020-2021,Ligue-1
Faitout Maouassa,fr FRA,DF,Rennes,22.0,1998.0,13.0,20,11,10,8,2,11,19,57.9,8,9,1,8,17,37,36,0,Matches,2020-2021,Ligue-1
Sekou Mara,fr FRA,"FW,MF",Bordeaux,18.0,2002.0,2.5,5,3,1,3,1,2,10,20.0,8,0,0,0,1,6,1,0,Matches,2020-2021,Ligue-1
Fernando Marçal,br BRA,DF,Lyon,31.0,1989.0,0.9,1,0,0,1,0,0,0,,0,0,0,0,2,3,0,0,Matches,2020-2021,Ligue-1
Marcelo,br BRA,DF,Lyon,33.0,1987.0,32.3,43,28,29,12,2,25,36,69.4,11,35,25,10,49,92,122,2,Matches,2020-2021,Ligue-1
Dario Maresic,at AUT,DF,Reims,20.0,1999.0,5.7,12,7,8,4,0,8,14,57.1,6,7,2,5,10,22,17,1,Matches,2020-2021,Ligue-1
Jordan Marié,fr FRA,MF,Dijon,28.0,1991.0,15.9,34,17,9,23,2,23,56,41.1,33,14,5,9,23,57,12,2,Matches,2020-2021,Ligue-1
Guillermo Maripán,cl CHI,DF,Monaco,26.0,1994.0,23.2,26,11,17,9,0,15,27,55.6,12,18,11,7,27,53,66,1,Matches,2020-2021,Ligue-1
Marquinhos,br BRA,DF,Paris S-G,26.0,1994.0,23.6,27,21,14,10,3,15,26,57.7,11,21,9,12,27,54,75,2,Matches,2020-2021,Ligue-1
Jonas Martin,fr FRA,MF,Rennes,30.0,1990.0,5.4,11,9,5,4,2,5,14,35.7,9,11,2,9,13,24,2,1,Matches,2020-2021,Ligue-1
Pablo Martinez,fr FRA,DF,Nîmes,31.0,1989.0,6.0,10,7,7,3,0,7,7,100.0,0,6,4,2,11,21,28,0,Matches,2020-2021,Ligue-1
Gelson Martins,pt POR,"MF,FW",Monaco,25.0,1995.0,17.2,41,26,12,16,13,15,37,40.5,22,20,0,20,13,54,8,0,Matches,2020-2021,Ligue-1
Sylvain Marveaux,fr FRA,"MF,FW",Lorient,34.0,1986.0,2.2,6,3,1,4,1,3,3,100.0,0,2,0,2,1,7,2,0,Matches,2020-2021,Ligue-1
Pape Matar Sarr,sn SEN,MF,Metz,17.0,2002.0,17.7,45,29,19,21,5,20,38,52.6,18,24,4,20,27,72,16,0,Matches,2020-2021,Ligue-1
Eliot Matazo,be BEL,MF,Monaco,18.0,2002.0,3.5,11,5,6,5,0,3,7,42.9,4,1,0,1,1,12,2,0,Matches,2020-2021,Ligue-1
Chrislain Matsima,fr FRA,"DF,FW",Monaco,18.0,2002.0,3.9,5,4,3,2,0,4,7,57.1,3,3,0,3,4,9,12,0,Matches,2020-2021,Ligue-1
Tony Mauricio,fr FRA,MF,Lens,26.0,1994.0,5.6,19,12,7,8,4,11,17,64.7,6,8,1,7,3,22,4,0,Matches,2020-2021,Ligue-1
Stephy Mavididi,eng ENG,"FW,MF",Montpellier,22.0,1998.0,22.6,18,5,7,10,1,8,23,34.8,15,12,0,12,14,32,6,0,Matches,2020-2021,Ligue-1
Youssef Maziz,fr FRA,"MF,FW",Metz,22.0,1998.0,2.9,2,0,1,1,0,1,5,20.0,4,1,0,1,6,8,1,0,Matches,2020-2021,Ligue-1
Kylian Mbappé,fr FRA,FW,Paris S-G,21.0,1998.0,26.4,4,2,0,1,3,2,9,22.2,7,7,1,6,3,7,4,1,Matches,2020-2021,Ligue-1
Nathanael Mbuku,cd COD,"MF,FW",Reims,18.0,2002.0,24.6,33,19,9,13,11,8,28,28.6,20,17,0,17,14,47,10,0,Matches,2020-2021,Ligue-1
Facundo Medina,ar ARG,DF,Lens,21.0,1999.0,22.3,39,22,22,15,2,24,38,63.2,14,25,9,16,39,78,51,3,Matches,2020-2021,Ligue-1
Farid El Melali,dz ALG,"FW,MF",Angers,23.0,1997.0,4.6,9,5,5,4,0,2,13,15.4,11,12,0,12,6,15,2,0,Matches,2020-2021,Ligue-1
Birger Meling,no NOR,DF,Nîmes,25.0,1994.0,25.9,49,31,27,15,7,33,50,66.0,17,43,9,34,36,85,70,0,Matches,2020-2021,Ligue-1
Memphis,nl NED,FW,Lyon,26.0,1994.0,32.5,4,3,0,3,1,1,20,5.0,19,11,1,10,5,9,3,1,Matches,2020-2021,Ligue-1
Houboulang Mendes,gw GNB,DF,Lorient,22.0,1998.0,14.4,28,19,19,5,4,16,28,57.1,12,14,2,12,14,42,35,0,Matches,2020-2021,Ligue-1
Pedro Mendes,pt POR,DF,Montpellier,29.0,1990.0,18.1,21,19,16,5,0,14,21,66.7,7,23,13,10,34,55,58,0,Matches,2020-2021,Ligue-1
Thiago Mendes,br BRA,MF,Lyon,28.0,1992.0,24.9,37,22,13,20,4,18,38,47.4,20,33,7,26,39,76,21,2,Matches,2020-2021,Ligue-1
Batista Mendy,fr FRA,MF,Nantes,20.0,2000.0,0.8,1,1,0,1,0,0,1,0.0,1,3,1,2,1,2,1,0,Matches,2020-2021,Ligue-1
Edouard Mendy,sn SEN,GK,Rennes,28.0,1992.0,1.0,0,0,0,0,0,0,0,,0,0,0,0,0,0,0,0,Matches,2020-2021,Ligue-1
Mexer,mz MOZ,DF,Bordeaux,31.0,1988.0,7.9,9,6,8,0,1,5,10,50.0,5,8,5,3,17,26,22,0,Matches,2020-2021,Ligue-1
Clément Michelin,fr FRA,DF,Lens,23.0,1997.0,12.8,25,19,13,9,3,9,16,56.3,7,13,4,9,25,50,32,0,Matches,2020-2021,Ligue-1
Edouard Michut,fr FRA,MF,Paris S-G,17.0,2003.0,0.0,0,0,0,0,0,0,0,,0,0,0,0,0,0,0,0,Matches,2020-2021,Ligue-1
Florian Miguel,fr FRA,DF,Nîmes,23.0,1996.0,17.1,14,13,12,2,0,9,17,52.9,8,21,13,8,45,59,66,1,Matches,2020-2021,Ligue-1
Arkadiusz Milik,pl POL,FW,Marseille,26.0,1994.0,13.6,14,9,0,7,7,2,12,16.7,10,5,1,4,2,16,9,0,Matches,2020-2021,Ligue-1
Enzo Millot,fr FRA,MF,Monaco,18.0,2002.0,0.5,2,0,0,1,1,1,1,100.0,0,0,0,0,2,4,0,0,Matches,2020-2021,Ligue-1
Stefan Mitrović,rs SRB,DF,Strasbourg,30.0,1990.0,30.9,36,27,29,7,0,24,37,64.9,13,23,13,10,31,67,108,5,Matches,2020-2021,Ligue-1
Anthony Modeste,fr FRA,"FW,MF",Saint-Étienne,32.0,1988.0,3.3,2,1,0,2,0,1,4,25.0,3,3,1,2,0,2,3,0,Matches,2020-2021,Ligue-1
Terem Moffi,ng NGA,FW,Lorient,21.0,1999.0,23.0,13,8,0,8,5,4,19,21.1,15,5,2,3,4,17,8,0,Matches,2020-2021,Ligue-1
Dion Moise Sahi,ci CIV,"FW,MF",Strasbourg,18.0,2001.0,1.0,1,0,0,1,0,1,1,100.0,0,1,0,1,0,1,0,0,Matches,2020-2021,Ligue-1
Florent Mollet,fr FRA,MF,Montpellier,28.0,1991.0,26.2,20,15,7,11,2,12,47,25.5,35,18,4,14,32,52,9,1,Matches,2020-2021,Ligue-1
Thomas Monconduit,fr FRA,MF,Lorient,29.0,1991.0,12.8,28,15,9,16,3,15,41,36.6,26,10,3,7,13,41,21,1,Matches,2020-2021,Ligue-1
Kévin Monnet-Paquet,fr FRA,"MF,FW",Saint-Étienne,31.0,1988.0,6.3,11,7,7,2,2,5,10,50.0,5,5,0,5,6,17,7,0,Matches,2020-2021,Ligue-1
Jérémy Morel,mg MAD,DF,Lorient,36.0,1984.0,27.7,31,19,21,10,0,20,39,51.3,19,26,11,15,44,75,81,1,Matches,2020-2021,Ligue-1
Aimen Moueffek,fr FRA,"DF,MF",Saint-Étienne,19.0,2001.0,8.3,25,15,16,6,3,13,32,40.6,19,17,2,15,9,34,18,0,Matches,2020-2021,Ligue-1
Harold Moukoudi,cm CMR,DF,Saint-Étienne,22.0,1997.0,25.3,46,27,37,8,1,28,38,73.7,10,24,10,14,42,88,78,1,Matches,2020-2021,Ligue-1
Jessy Moulin,fr FRA,GK,Saint-Étienne,34.0,1986.0,29.0,2,1,2,0,0,2,3,66.7,1,0,0,0,2,4,9,2,Matches,2020-2021,Ligue-1
Steve Mounié,bj BEN,FW,Brest,25.0,1994.0,29.8,15,11,3,11,1,3,28,10.7,25,18,3,15,12,27,40,0,Matches,2020-2021,Ligue-1
Samuel Moutoussamy,cd COD,FW,Nantes,23.0,1996.0,0.9,0,0,0,0,0,0,1,0.0,1,1,0,1,0,0,0,0,Matches,2020-2021,Ligue-1
Loris Mouyokolo,fr FRA,DF,Lorient,19.0,2001.0,0.2,1,1,1,0,0,1,1,100.0,0,1,1,0,0,1,1,0,Matches,2020-2021,Ligue-1
Marshall Munetsi,zw ZIM,"MF,DF",Reims,24.0,1996.0,21.4,35,19,19,14,2,21,41,51.2,20,33,25,8,57,92,85,3,Matches,2020-2021,Ligue-1
Kévin N'Doram,fr FRA,MF,Metz,24.0,1996.0,3.4,3,2,0,3,0,1,3,33.3,2,0,0,0,6,9,2,0,Matches,2020-2021,Ligue-1
Stanley N'Soki,fr FRA,DF,Nice,21.0,1999.0,13.8,27,19,15,9,3,13,22,59.1,9,17,4,13,26,53,38,2,Matches,2020-2021,Ligue-1
Yuto Nagatomo,jp JPN,DF,Marseille,33.0,1986.0,17.7,23,16,12,8,3,9,18,50.0,9,14,3,11,29,52,43,0,Matches,2020-2021,Ligue-1
Kenny Nagera,fr FRA,FW,Paris S-G,18.0,2002.0,0.0,0,0,0,0,0,0,0,,0,0,0,0,0,0,0,0,Matches,2020-2021,Ligue-1
Paul Nardi,fr FRA,GK,Lorient,26.0,1994.0,23.0,0,0,0,0,0,0,1,0.0,1,1,0,1,0,0,15,2,Matches,2020-2021,Ligue-1
Keylor Navas,cr CRC,GK,Paris S-G,33.0,1986.0,28.0,0,0,0,0,0,0,0,,0,0,0,0,0,0,10,0,Matches,2020-2021,Ligue-1
Papa Ndiaga Yade,mr MTN,"FW,MF",Metz,20.0,2000.0,11.1,15,8,9,2,4,7,20,35.0,13,9,0,9,4,19,6,0,Matches,2020-2021,Ligue-1
Bridge Ndilu,fr FRA,"FW,MF",Nantes,20.0,2000.0,0.5,0,0,0,0,0,0,2,0.0,2,2,0,2,0,0,0,0,Matches,2020-2021,Ligue-1
Dan Ndoye,ch SUI,"FW,MF",Nice,19.0,2000.0,6.1,7,6,3,4,0,1,8,12.5,7,4,0,4,7,14,4,0,Matches,2020-2021,Ligue-1
Neymar,br BRA,"MF,FW",Paris S-G,28.0,1992.0,15.7,14,11,1,6,7,8,37,21.6,29,8,0,8,9,23,0,0,Matches,2020-2021,Ligue-1
Yvan Neyou,cm CMR,MF,Saint-Étienne,23.0,1997.0,27.1,58,31,24,33,1,25,60,41.7,35,34,5,29,31,89,13,1,Matches,2020-2021,Ligue-1
Muzinga Ngonda,cd COD,DF,Dijon,25.0,1994.0,25.6,59,40,37,21,1,30,50,60.0,20,28,3,25,72,131,58,0,Matches,2020-2021,Ligue-1
Ahmad Ngouyamsa,td CHA,DF,Dijon,19.0,2000.0,1.7,6,4,5,1,0,4,8,50.0,4,2,1,1,2,8,8,0,Matches,2020-2021,Ligue-1
Opa Nguette,sn SEN,"FW,MF",Metz,26.0,1994.0,12.6,15,8,2,8,5,3,10,30.0,7,14,2,12,1,16,1,0,Matches,2020-2021,Ligue-1
Ibrahima Niane,sn SEN,FW,Metz,21.0,1999.0,7.4,1,1,0,0,1,1,2,50.0,1,3,0,3,0,1,8,0,Matches,2020-2021,Ligue-1
M'Baye Niang,sn SEN,FW,Rennes,25.0,1994.0,4.7,3,2,2,1,0,0,0,,0,2,0,2,1,4,2,0,Matches,2020-2021,Ligue-1
Casimir Ninga,td CHA,FW,Angers,27.0,1993.0,0.3,0,0,0,0,0,0,0,,0,0,0,0,0,0,1,0,Matches,2020-2021,Ligue-1
Arnaud Nordin,fr FRA,"MF,FW",Saint-Étienne,22.0,1998.0,19.7,14,8,5,5,4,6,21,28.6,15,13,2,11,9,23,10,0,Matches,2020-2021,Ligue-1
Olivier Ntcham,cm CMR,MF,Marseille,24.0,1996.0,1.3,1,0,0,1,0,1,3,33.3,2,3,1,2,2,3,3,0,Matches,2020-2021,Ligue-1
Gerzino Nyamsi,fr FRA,DF,Rennes,23.0,1997.0,9.7,12,10,2,8,2,4,6,66.7,2,8,5,3,10,22,32,1,Matches,2020-2021,Ligue-1
Steven Nzonzi,fr FRA,MF,Rennes,31.0,1988.0,32.3,34,16,15,16,3,12,31,38.7,19,24,10,14,16,50,26,0,Matches,2020-2021,Ligue-1
Jonas Omlin,ch SUI,GK,Montpellier,26.0,1994.0,29.7,1,1,1,0,0,1,4,25.0,3,0,0,0,0,1,9,1,Matches,2020-2021,Ligue-1
Henry Onyekuru,ng NGA,FW,Monaco,23.0,1997.0,1.6,1,0,1,0,0,1,4,25.0,3,1,0,1,0,1,0,0,Matches,2020-2021,Ligue-1
Otávio,br BRA,MF,Bordeaux,26.0,1994.0,17.3,54,31,33,19,2,26,55,47.3,29,20,5,15,26,80,36,0,Matches,2020-2021,Ligue-1
Remi Oudin,fr FRA,"FW,MF",Bordeaux,23.0,1996.0,26.9,34,16,22,7,5,15,36,41.7,21,22,2,20,51,85,40,1,Matches,2020-2021,Ligue-1
Alexandre Oukidja,dz ALG,GK,Metz,32.0,1988.0,34.0,0,0,0,0,0,0,1,0.0,1,1,0,1,0,0,17,3,Matches,2020-2021,Ligue-1
Zinédine Ould Khaled,fr FRA,MF,Angers,20.0,2000.0,0.4,0,0,0,0,0,0,0,,0,0,0,0,1,1,0,0,Matches,2020-2021,Ligue-1
Ambroise Oyongo,cm CMR,DF,Montpellier,29.0,1991.0,6.2,13,6,10,3,0,9,15,60.0,6,3,2,1,8,21,26,1,Matches,2020-2021,Ligue-1
Pablo,br BRA,DF,Bordeaux,29.0,1991.0,12.0,17,11,13,4,0,8,14,57.1,6,17,12,5,25,42,46,1,Matches,2020-2021,Ligue-1
Vincent Pajot,fr FRA,MF,Metz,29.0,1990.0,10.2,35,20,19,11,5,10,18,55.6,8,9,2,7,42,77,11,0,Matches,2020-2021,Ligue-1
Nicolas Pallois,fr FRA,DF,Nantes,32.0,1987.0,30.8,58,35,41,15,2,38,72,52.8,34,44,20,24,37,95,155,1,Matches,2020-2021,Ligue-1
Jonathan Panzo,eng ENG,DF,Dijon,19.0,2000.0,20.0,17,12,13,4,0,8,11,72.7,3,27,13,14,59,76,91,2,Matches,2020-2021,Ligue-1
Lucas Paquetá,br BRA,MF,Lyon,22.0,1997.0,25.3,70,36,30,28,12,23,66,34.8,43,28,3,25,20,90,16,1,Matches,2020-2021,Ligue-1
Gaëtan Paquiez,fr FRA,DF,Nîmes,26.0,1994.0,11.6,21,12,12,7,2,12,29,41.4,17,10,3,7,16,37,28,0,Matches,2020-2021,Ligue-1
Rubén Pardo,es ESP,MF,Bordeaux,27.0,1992.0,0.3,0,0,0,0,0,0,0,,0,0,0,0,1,1,0,0,Matches,2020-2021,Ligue-1
Leandro Paredes,ar ARG,MF,Paris S-G,26.0,1994.0,14.5,30,18,12,15,3,19,39,48.7,20,17,5,12,17,47,13,1,Matches,2020-2021,Ligue-1
Mateo Pavlović,ba BIH,DF,Angers,30.0,1990.0,12.3,11,6,8,3,0,8,23,34.8,15,13,11,2,21,32,40,0,Matches,2020-2021,Ligue-1
Strahinja Pavlović,rs SRB,DF,Monaco,19.0,2001.0,0.0,0,0,0,0,0,0,0,,0,0,0,0,0,0,0,0,Matches,2020-2021,Ligue-1
Dimitri Payet,fr FRA,"FW,MF",Marseille,33.0,1987.0,26.9,27,17,4,16,7,17,40,42.5,23,19,2,17,8,35,10,0,Matches,2020-2021,Ligue-1
Yohann Pelé,fr FRA,GK,Marseille,37.0,1982.0,1.0,0,0,0,0,0,0,0,,0,0,0,0,0,0,0,0,Matches,2020-2021,Ligue-1
Pietro Pellegri,it ITA,"FW,MF",Monaco,19.0,2001.0,2.6,2,1,0,2,0,0,0,,0,1,0,1,0,2,0,0,Matches,2020-2021,Ligue-1
Andy Pelmard,fr FRA,DF,Nice,20.0,2000.0,13.4,18,12,12,5,1,9,12,75.0,3,11,3,8,20,38,35,0,Matches,2020-2021,Ligue-1
Timothee Pembele,fr FRA,DF,Paris S-G,17.0,2002.0,4.3,8,7,4,4,0,5,14,35.7,9,4,0,4,5,13,8,1,Matches,2020-2021,Ligue-1
Danilo Pereira,pt POR,"MF,DF",Paris S-G,28.0,1991.0,15.9,21,11,6,11,4,6,14,42.9,8,14,6,8,29,50,33,4,Matches,2020-2021,Ligue-1
Mathias Pereira Lage,pt POR,"FW,MF",Angers,23.0,1996.0,16.3,29,17,12,15,2,10,40,25.0,30,21,4,17,15,44,16,0,Matches,2020-2021,Ligue-1
Manuel Perez,fr FRA,"MF,FW",Lens,29.0,1991.0,1.4,1,0,1,0,0,0,8,0.0,8,2,0,2,2,3,2,0,Matches,2020-2021,Ligue-1
Romain Perraud,fr FRA,DF,Brest,22.0,1997.0,34.9,60,34,42,16,2,24,45,53.3,21,36,3,33,45,105,76,0,Matches,2020-2021,Ligue-1
Lucas Perrin,fr FRA,DF,Marseille,21.0,1998.0,3.4,7,4,4,3,0,5,12,41.7,7,5,4,1,8,15,16,0,Matches,2020-2021,Ligue-1
Rayan Philippe,fr FRA,FW,Dijon,19.0,2000.0,1.0,3,1,1,1,1,2,2,100.0,0,0,0,0,0,3,0,0,Matches,2020-2021,Ligue-1
Romain Philippoteaux,fr FRA,"FW,MF",Nîmes,32.0,1988.0,2.4,1,1,1,0,0,1,5,20.0,4,2,0,2,2,3,1,0,Matches,2020-2021,Ligue-1
Romain Philippoteaux,fr FRA,"MF,FW",Brest,32.0,1988.0,6.5,11,6,6,3,2,6,9,66.7,3,4,0,4,10,21,2,0,Matches,2020-2021,Ligue-1
Jérémy Pied,fr FRA,DF,Lille,31.0,1989.0,3.5,7,0,3,3,1,4,9,44.4,5,3,1,2,6,13,8,0,Matches,2020-2021,Ligue-1
Ronaël Pierre-Gabriel,fr FRA,DF,Brest,22.0,1998.0,25.6,60,40,42,16,2,35,52,67.3,17,17,7,10,30,90,57,0,Matches,2020-2021,Ligue-1
Maxime Poundjé,fr FRA,DF,Bordeaux,27.0,1992.0,5.5,10,7,9,1,0,2,6,33.3,4,7,3,4,11,21,5,0,Matches,2020-2021,Ligue-1
Sanjin Prcić,ba BIH,MF,Strasbourg,26.0,1993.0,3.9,3,2,0,3,0,2,5,40.0,3,4,3,1,4,7,2,1,Matches,2020-2021,Ligue-1
Nicolas de Préville,fr FRA,"FW,MF",Bordeaux,29.0,1991.0,17.9,19,14,7,6,6,9,42,21.4,33,15,0,15,13,32,7,0,Matches,2020-2021,Ligue-1
Anthony Racioppi,ch SUI,GK,Dijon,21.0,1998.0,21.0,0,0,0,0,0,0,2,0.0,2,0,0,0,2,2,12,4,Matches,2020-2021,Ligue-1
Nemanja Radonjić,rs SRB,FW,Marseille,24.0,1996.0,4.4,6,5,1,2,3,2,12,16.7,10,8,0,8,3,9,1,0,Matches,2020-2021,Ligue-1
Aleksandar Radovanović,rs SRB,DF,Lens,26.0,1993.0,1.0,1,1,0,1,0,0,0,,0,2,1,1,0,1,2,0,Matches,2020-2021,Ligue-1
Rafinha,br BRA,"MF,FW",Paris S-G,27.0,1993.0,15.1,54,26,18,28,8,28,49,57.1,21,18,3,15,13,67,6,0,Matches,2020-2021,Ligue-1
Predrag Rajković,rs SRB,GK,Reims,24.0,1995.0,36.5,2,1,2,0,0,2,5,40.0,3,1,0,1,2,4,17,3,Matches,2020-2021,Ligue-1
Raphinha,br BRA,"FW,MF",Rennes,23.0,1996.0,4.5,5,2,1,3,1,1,4,25.0,3,5,0,5,3,8,4,0,Matches,2020-2021,Ligue-1
Jeff Reine-Adélaïde,fr FRA,"MF,FW",Nice,22.0,1998.0,11.8,7,4,1,4,2,2,9,22.2,7,10,1,9,4,11,6,0,Matches,2020-2021,Ligue-1
Jeff Reine-Adélaïde,fr FRA,FW,Lyon,22.0,1998.0,0.3,0,0,0,0,0,0,0,,0,0,0,0,0,0,0,0,Matches,2020-2021,Ligue-1
Panagiotis Retsos,gr GRE,DF,Saint-Étienne,21.0,1998.0,3.0,5,3,5,0,0,3,7,42.9,4,1,1,0,3,8,12,0,Matches,2020-2021,Ligue-1
Baptiste Reynet,fr FRA,GK,Nîmes,29.0,1990.0,38.0,2,1,2,0,0,2,4,50.0,2,1,0,1,1,3,9,2,Matches,2020-2021,Ligue-1
Sergio Rico,es ESP,GK,Paris S-G,26.0,1993.0,9.0,0,0,0,0,0,0,0,,0,0,0,0,0,0,1,0,Matches,2020-2021,Ligue-1
Renaud Ripart,fr FRA,"MF,FW",Nîmes,27.0,1993.0,33.9,52,30,25,19,8,26,84,31.0,58,58,12,46,36,88,53,0,Matches,2020-2021,Ligue-1
Mihailo Ristić,rs SRB,DF,Montpellier,24.0,1995.0,24.8,45,22,25,13,7,28,44,63.6,16,30,9,21,26,71,57,0,Matches,2020-2021,Ligue-1
Maxence Rivera,fr FRA,"MF,FW",Saint-Étienne,18.0,2002.0,2.7,12,10,6,4,2,4,10,40.0,6,5,0,5,1,13,0,0,Matches,2020-2021,Ligue-1
Christopher Rocchia,fr FRA,"DF,FW",Marseille,22.0,1998.0,0.2,1,0,1,0,0,0,2,0.0,2,0,0,0,0,1,1,0,Matches,2020-2021,Ligue-1
Valentin Rongier,fr FRA,MF,Marseille,25.0,1994.0,21.0,93,59,31,55,7,43,85,50.6,42,32,2,30,28,121,21,1,Matches,2020-2021,Ligue-1
Nolan Roux,fr FRA,FW,Nîmes,32.0,1988.0,7.2,7,3,1,4,2,3,8,37.5,5,6,0,6,5,12,4,0,Matches,2020-2021,Ligue-1
Daniele Rugani,it ITA,DF,Rennes,26.0,1994.0,1.0,0,0,0,0,0,0,1,0.0,1,1,1,0,1,1,1,0,Matches,2020-2021,Ligue-1
Kays Ruiz,fr FRA,"FW,MF",Paris S-G,17.0,2002.0,2.1,1,1,0,1,0,0,4,0.0,4,1,0,1,3,4,2,0,Matches,2020-2021,Ligue-1
Georginio Rutter,fr FRA,"FW,MF",Rennes,18.0,2002.0,0.5,2,2,0,1,1,1,3,33.3,2,2,0,2,0,2,0,0,Matches,2020-2021,Ligue-1
Roli Pereira de Sa,fr FRA,"FW,MF",Nantes,23.0,1996.0,0.6,4,3,1,3,0,3,4,75.0,1,2,0,2,0,4,0,0,Matches,2020-2021,Ligue-1
Idriss Saadi,dz ALG,"MF,FW",Strasbourg,28.0,1992.0,1.4,0,0,0,0,0,0,2,0.0,2,0,0,0,0,0,0,0,Matches,2020-2021,Ligue-1
Youssouf Sabaly,sn SEN,DF,Bordeaux,27.0,1993.0,32.3,47,33,24,17,6,27,45,60.0,18,31,8,23,49,96,57,2,Matches,2020-2021,Ligue-1
Mathys Saban,fr FRA,FW,Saint-Étienne,18.0,2002.0,0.1,0,0,0,0,0,0,0,,0,0,0,0,0,0,0,0,Matches,2020-2021,Ligue-1
Hiroki Sakai,jp JPN,DF,Marseille,30.0,1990.0,26.5,81,48,34,35,12,39,51,76.5,12,21,5,16,54,135,65,0,Matches,2020-2021,Ligue-1
Moïse Sakava,cm CMR,MF,Reims,19.0,2000.0,0.1,0,0,0,0,0,0,0,,0,0,0,0,0,0,0,0,Matches,2020-2021,Ligue-1
William Saliba,fr FRA,DF,Nice,19.0,2001.0,20.0,15,9,8,5,2,5,6,83.3,1,17,16,1,26,41,80,2,Matches,2020-2021,Ligue-1
Romain Salin,fr FRA,GK,Rennes,36.0,1984.0,15.0,0,0,0,0,0,0,1,0.0,1,0,0,0,1,1,6,3,Matches,2020-2021,Ligue-1
Mama Samba Baldé,gw GNB,FW,Dijon,24.0,1995.0,24.0,23,9,4,13,6,9,22,40.9,13,16,1,15,4,27,26,0,Matches,2020-2021,Ligue-1
Junior Sambia,fr FRA,"DF,MF",Montpellier,23.0,1996.0,27.2,41,29,20,14,7,26,38,68.4,12,27,14,13,39,80,46,0,Matches,2020-2021,Ligue-1
Frédéric Sammaritano,fr FRA,"FW,MF",Dijon,34.0,1986.0,12.6,15,10,9,5,1,9,26,34.6,17,6,0,6,9,24,3,0,Matches,2020-2021,Ligue-1
Renato Sanches,pt POR,MF,Lille,22.0,1997.0,14.1,13,7,4,8,1,5,25,20.0,20,13,2,11,13,26,8,0,Matches,2020-2021,Ligue-1
Morgan Sanson,fr FRA,MF,Marseille,25.0,1994.0,9.2,21,12,6,12,3,9,28,32.1,19,12,0,12,9,30,5,0,Matches,2020-2021,Ligue-1
Baptiste Santamaria,fr FRA,MF,Angers,25.0,1995.0,3.0,9,6,3,5,1,2,7,28.6,5,4,0,4,7,16,8,0,Matches,2020-2021,Ligue-1
Pablo Sarabia,es ESP,"FW,MF",Paris S-G,28.0,1992.0,14.7,15,11,6,6,3,10,38,26.3,28,9,1,8,5,20,8,0,Matches,2020-2021,Ligue-1
Bouna Sarr,sn SEN,DF,Marseille,28.0,1992.0,0.8,1,1,0,0,1,1,1,100.0,0,1,1,0,1,2,1,0,Matches,2020-2021,Ligue-1
Sidy Sarr,sn SEN,MF,Nîmes,24.0,1996.0,5.1,10,6,4,6,0,2,5,40.0,3,1,1,0,7,17,4,0,Matches,2020-2021,Ligue-1
Téji Savanier,fr FRA,MF,Montpellier,28.0,1991.0,24.1,49,33,16,25,8,22,73,30.1,51,28,6,22,38,87,15,0,Matches,2020-2021,Ligue-1
Aurélien Scheidler,fr FRA,FW,Dijon,22.0,1998.0,3.8,2,0,0,2,0,0,2,0.0,2,0,0,0,1,3,5,0,Matches,2020-2021,Ligue-1
Morgan Schneiderlin,fr FRA,MF,Nice,30.0,1989.0,24.4,51,31,21,24,6,20,54,37.0,34,21,11,10,53,104,46,0,Matches,2020-2021,Ligue-1
Malik Sellouki,fr FRA,"FW,MF",Nice,20.0,2000.0,0.7,0,0,0,0,0,0,1,0.0,1,2,0,2,2,2,0,0,Matches,2020-2021,Ligue-1
Matz Sels,be BEL,GK,Strasbourg,28.0,1992.0,6.0,0,0,0,0,0,0,0,,0,0,0,0,0,0,4,0,Matches,2020-2021,Ligue-1
Jean Seri,ci CIV,MF,Bordeaux,29.0,1991.0,7.9,17,9,3,12,2,4,15,26.7,11,8,2,6,12,29,7,0,Matches,2020-2021,Ligue-1
Mahame Siby,ml MLI,MF,Strasbourg,24.0,1996.0,0.2,0,0,0,0,0,0,1,0.0,1,0,0,0,0,0,1,0,Matches,2020-2021,Ligue-1
Abdoulaye Sidibé,fr FRA,MF,Saint-Étienne,18.0,2002.0,0.1,1,1,1,0,0,1,2,50.0,1,0,0,0,0,1,0,0,Matches,2020-2021,Ligue-1
Djibril Sidibé,fr FRA,DF,Monaco,28.0,1992.0,22.0,58,34,26,29,3,37,52,71.2,15,20,5,15,50,108,37,2,Matches,2020-2021,Ligue-1
Kaj Sierhuis,nl NED,"FW,MF",Reims,22.0,1998.0,7.2,7,2,1,2,4,2,9,22.2,7,2,1,1,2,9,5,0,Matches,2020-2021,Ligue-1
Caio Henrique Oliveira Silva,br BRA,DF,Monaco,23.0,1997.0,26.3,50,34,25,20,5,31,51,60.8,20,20,3,17,16,66,37,0,Matches,2020-2021,Ligue-1
Florent da Silva,fr FRA,FW,Lyon,17.0,2003.0,0.0,0,0,0,0,0,0,0,,0,0,0,0,0,0,0,0,Matches,2020-2021,Ligue-1
Gabriel Silva,br BRA,DF,Saint-Étienne,29.0,1991.0,3.9,7,6,7,0,0,1,2,50.0,1,4,1,3,6,13,8,0,Matches,2020-2021,Ligue-1
Mohamed Simakan,fr FRA,DF,Strasbourg,20.0,2000.0,17.9,32,22,21,6,5,9,18,50.0,9,17,11,6,31,63,41,0,Matches,2020-2021,Ligue-1
Moses Simon,ng NGA,"FW,MF",Nantes,25.0,1995.0,25.8,27,14,11,9,7,17,36,47.2,19,24,1,23,15,42,15,1,Matches,2020-2021,Ligue-1
Xavi Simons,nl NED,MF,Paris S-G,17.0,2003.0,0.0,0,0,0,0,0,0,0,,0,0,0,0,0,0,0,0,Matches,2020-2021,Ligue-1
Issouf Sissokho,ml MLI,"MF,DF",Bordeaux,18.0,2002.0,0.9,6,4,4,2,0,3,6,50.0,3,2,0,2,1,7,0,0,Matches,2020-2021,Ligue-1
Ibrahima Sissoko,ml MLI,MF,Strasbourg,22.0,1997.0,28.7,68,48,25,35,8,28,68,41.2,40,22,5,17,48,116,44,0,Matches,2020-2021,Ligue-1
Nelson Sissoko,fr FRA,DF,Saint-Étienne,23.0,1997.0,5.3,12,6,6,3,3,7,12,58.3,5,2,1,1,12,24,16,1,Matches,2020-2021,Ligue-1
Jacques Siwe,fr FRA,FW,Dijon,19.0,2001.0,1.9,4,1,1,1,2,0,1,0.0,1,1,0,1,1,5,1,0,Matches,2020-2021,Ligue-1
Petar Škuletić,rs SRB,"FW,MF",Montpellier,30.0,1990.0,2.6,3,2,1,2,0,0,5,0.0,5,4,2,2,0,3,4,0,Matches,2020-2021,Ligue-1
Islam Slimani,dz ALG,FW,Lyon,32.0,1988.0,6.4,7,5,3,1,3,3,12,25.0,9,4,1,3,1,8,6,0,Matches,2020-2021,Ligue-1
Brandon Soppy,fr FRA,DF,Rennes,18.0,2002.0,6.2,21,15,16,5,0,10,16,62.5,6,3,0,3,6,27,12,0,Matches,2020-2021,Ligue-1
Florian Sotoca,fr FRA,FW,Lens,29.0,1990.0,26.8,31,20,3,20,8,6,22,27.3,16,27,0,27,9,40,24,0,Matches,2020-2021,Ligue-1
Cheick Souaré,fr FRA,MF,Marseille,17.0,2002.0,0.1,0,0,0,0,0,0,0,,0,1,1,0,1,1,0,0,Matches,2020-2021,Ligue-1
Rayan Souici,fr FRA,DF,Saint-Étienne,22.0,1998.0,0.1,0,0,0,0,0,0,0,,0,0,0,0,0,0,0,0,Matches,2020-2021,Ligue-1
Adama Soumaoro,fr FRA,DF,Lille,28.0,1992.0,1.6,1,0,0,0,1,0,0,,0,1,1,0,2,3,2,0,Matches,2020-2021,Ligue-1
Boubakary Soumaré,fr FRA,MF,Lille,21.0,1999.0,21.3,44,29,16,25,3,14,29,48.3,15,14,6,8,39,83,21,0,Matches,2020-2021,Ligue-1
Yaya Soumaré,fr FRA,FW,Lyon,20.0,2000.0,0.0,1,1,1,0,0,1,2,50.0,1,0,0,0,2,3,0,0,Matches,2020-2021,Ligue-1
Arnaud Souquet,fr FRA,DF,Montpellier,28.0,1992.0,13.6,50,33,35,12,3,27,48,56.3,21,15,6,9,17,67,34,0,Matches,2020-2021,Ligue-1
Ansou Sow,sn SEN,MF,Lens,20.0,2000.0,0.1,0,0,0,0,0,0,0,,0,1,0,1,0,0,0,0,Matches,2020-2021,Ligue-1
Saidou Sow,gn GUI,DF,Saint-Étienne,18.0,2002.0,11.1,23,12,17,6,0,13,19,68.4,6,12,8,4,14,37,39,1,Matches,2020-2021,Ligue-1
Kevin Strootman,nl NED,"MF,FW",Marseille,30.0,1990.0,2.6,9,6,5,4,0,4,8,50.0,4,5,2,3,5,14,7,0,Matches,2020-2021,Ligue-1
Abdoulaye Sylla,gn GUI,DF,Nantes,20.0,2000.0,0.1,2,1,2,0,0,1,1,100.0,0,1,0,1,0,2,1,0,Matches,2020-2021,Ligue-1
Issiaga Sylla,gn GUI,"DF,MF",Lens,26.0,1994.0,12.4,28,20,11,17,0,11,21,52.4,10,13,3,10,16,44,21,0,Matches,2020-2021,Ligue-1
Eddy Sylvestre,fr FRA,"FW,MF",Nice,20.0,1999.0,1.1,1,1,1,0,0,0,1,0.0,1,1,0,1,1,2,0,0,Matches,2020-2021,Ligue-1
Waniss Taibi,fr FRA,MF,Angers,18.0,2002.0,0.4,0,0,0,0,0,0,2,0.0,2,1,0,1,0,0,0,0,Matches,2020-2021,Ligue-1
Flavien Tait,fr FRA,"MF,FW",Rennes,27.0,1993.0,15.2,26,11,11,12,3,10,32,31.3,22,17,3,14,13,39,2,0,Matches,2020-2021,Ligue-1
Heriberto Tavares,pt POR,"FW,MF",Brest,23.0,1997.0,0.5,2,0,0,0,2,1,3,33.3,2,0,0,0,1,3,1,0,Matches,2020-2021,Ligue-1
Warren Tchimbembé,cg CGO,"MF,FW",Metz,22.0,1998.0,5.5,7,4,4,3,0,3,9,33.3,6,6,1,5,2,9,3,0,Matches,2020-2021,Ligue-1
Aurélien Tchouaméni,fr FRA,MF,Monaco,20.0,2000.0,34.0,127,68,47,62,18,48,92,52.2,44,39,11,28,60,187,47,0,Matches,2020-2021,Ligue-1
Martin Terrier,fr FRA,"FW,MF",Rennes,23.0,1997.0,27.1,33,15,5,15,13,10,36,27.8,26,23,0,23,16,49,7,0,Matches,2020-2021,Ligue-1
Kenny Tete,nl NED,DF,Lyon,24.0,1995.0,0.2,2,0,1,1,0,0,0,,0,0,0,0,2,4,0,0,Matches,2020-2021,Ligue-1
Florian Thauvin,fr FRA,"FW,MF",Marseille,27.0,1993.0,30.4,40,22,14,21,5,20,54,37.0,34,26,2,24,14,54,11,0,Matches,2020-2021,Ligue-1
Sada Thioub,sn SEN,"FW,MF",Angers,25.0,1995.0,14.0,17,14,7,6,4,7,23,30.4,16,10,0,10,9,26,3,0,Matches,2020-2021,Ligue-1
Romain Thomas,fr FRA,DF,Angers,32.0,1988.0,33.6,47,25,34,11,2,20,35,57.1,15,35,20,15,50,97,138,0,Matches,2020-2021,Ligue-1
Adrien Thomasson,fr FRA,"MF,FW",Strasbourg,26.0,1993.0,29.2,36,17,8,16,12,12,58,20.7,46,44,5,39,22,58,2,0,Matches,2020-2021,Ligue-1
Khéphren Thuram,fr FRA,MF,Nice,19.0,2001.0,16.6,32,16,5,21,6,9,27,33.3,18,21,9,12,18,50,22,1,Matches,2020-2021,Ligue-1
Cheikh Tidiane Sabaly,sn SEN,FW,Metz,21.0,1999.0,0.1,0,0,0,0,0,0,0,,0,0,0,0,0,0,0,0,Matches,2020-2021,Ligue-1
Jean-Clair Todibo,fr FRA,DF,Nice,20.0,1999.0,14.8,25,15,16,9,0,16,31,51.6,15,13,7,6,19,44,48,1,Matches,2020-2021,Ligue-1
Karl Toko Ekambi,cm CMR,FW,Lyon,27.0,1992.0,31.2,16,10,5,3,8,8,32,25.0,24,20,1,19,26,42,8,0,Matches,2020-2021,Ligue-1
Tyron Tormin,fr FRA,"FW,MF",Saint-Étienne,19.0,2001.0,0.2,0,0,0,0,0,0,0,,0,0,0,0,0,0,0,0,Matches,2020-2021,Ligue-1
Abdoulaye Touré,gn GUI,MF,Nantes,26.0,1994.0,18.7,28,12,10,16,2,14,31,45.2,17,17,2,15,22,50,19,0,Matches,2020-2021,Ligue-1
Amadou Traore,fr FRA,"FW,MF",Bordeaux,18.0,2002.0,3.4,6,1,2,2,2,2,9,22.2,7,9,0,9,1,7,2,0,Matches,2020-2021,Ligue-1
Boubacar Traoré,ml MLI,MF,Metz,18.0,2001.0,0.6,3,2,1,2,0,1,1,100.0,0,1,0,1,0,3,0,0,Matches,2020-2021,Ligue-1
Charles Traore,ml MLI,DF,Nantes,28.0,1992.0,18.9,53,34,30,17,6,27,54,50.0,27,26,5,21,36,89,65,0,Matches,2020-2021,Ligue-1
Cheick Traoré,ml MLI,DF,Lens,25.0,1995.0,0.4,2,2,1,1,0,2,4,50.0,2,1,0,1,2,4,1,0,Matches,2020-2021,Ligue-1
Hamari Traoré,ml MLI,DF,Rennes,28.0,1992.0,33.3,56,38,23,27,6,22,59,37.3,37,31,5,26,76,132,50,0,Matches,2020-2021,Ligue-1
Ismaël Traoré,ci CIV,DF,Angers,33.0,1986.0,33.3,32,14,23,9,0,20,37,54.1,17,27,13,14,40,72,107,0,Matches,2020-2021,Ligue-1
Miguel Trauco,pe PER,DF,Saint-Étienne,27.0,1992.0,22.6,47,29,25,14,8,23,43,53.5,20,19,4,15,30,77,34,1,Matches,2020-2021,Ligue-1
Alexis Trouillet,fr FRA,"MF,FW",Nice,19.0,2000.0,1.2,5,4,1,4,0,4,5,80.0,1,0,0,0,3,8,0,0,Matches,2020-2021,Ligue-1
Adrien Truffert,fr FRA,"DF,MF",Rennes,18.0,2001.0,21.7,38,18,18,12,8,13,24,54.2,11,26,5,21,18,56,38,1,Matches,2020-2021,Ligue-1
Marvin Tshibuabua,fr FRA,DF,Saint-Étienne,18.0,2002.0,0.5,1,0,1,0,0,0,0,,0,0,0,0,1,2,1,0,Matches,2020-2021,Ligue-1
Matthieu Udol,fr FRA,DF,Metz,24.0,1996.0,19.2,34,21,18,12,4,17,39,43.6,22,25,5,20,39,73,30,0,Matches,2020-2021,Ligue-1
Naomichi Ueda,jp JPN,DF,Nîmes,25.0,1994.0,7.9,4,2,3,1,0,4,6,66.7,2,5,4,1,6,10,30,1,Matches,2020-2021,Ligue-1
Lesley Ugochukwu,fr FRA,MF,Rennes,16.0,2004.0,0.7,3,1,0,3,0,2,3,66.7,1,1,0,1,0,3,0,0,Matches,2020-2021,Ligue-1
Hwang Ui-jo,kr KOR,"FW,MF",Bordeaux,27.0,1992.0,27.8,14,6,5,8,1,6,25,24.0,19,17,2,15,8,22,14,0,Matches,2020-2021,Ligue-1
Antoine Valerio,fr FRA,MF,Nîmes,20.0,1999.0,0.8,0,0,0,0,0,0,1,0.0,1,1,0,1,2,2,0,0,Matches,2020-2021,Ligue-1
Marco Verratti,it ITA,MF,Paris S-G,27.0,1992.0,16.6,53,30,17,25,11,24,72,33.3,48,22,5,17,26,79,4,1,Matches,2020-2021,Ligue-1
Clément Vidal,fr FRA,DF,Montpellier,20.0,2000.0,1.0,2,1,1,1,0,2,4,50.0,2,4,4,0,1,3,6,1,Matches,2020-2021,Ligue-1
Kevin Volland,de GER,"FW,MF",Monaco,28.0,1992.0,30.8,33,16,11,19,3,8,34,23.5,26,23,0,23,4,37,4,0,Matches,2020-2021,Ligue-1
Franklin Wadja,cm CMR,"MF,FW",Lorient,25.0,1995.0,0.4,4,2,0,2,2,2,2,100.0,0,0,0,0,2,6,1,0,Matches,2020-2021,Ligue-1
Elye Wahi,fr FRA,FW,Montpellier,17.0,2003.0,6.2,4,3,2,1,1,1,6,16.7,5,4,0,4,2,6,4,0,Matches,2020-2021,Ligue-1
Timothy Weah,us USA,"FW,MF",Lille,20.0,2000.0,9.8,15,7,3,9,3,7,14,50.0,7,7,0,7,4,19,5,0,Matches,2020-2021,Ligue-1
Yoane Wissa,cd COD,"MF,FW",Lorient,23.0,1996.0,29.7,35,20,12,14,9,11,34,32.4,23,25,3,22,20,55,14,0,Matches,2020-2021,Ligue-1
Xeka,pt POR,MF,Lille,25.0,1994.0,13.3,33,17,14,15,4,16,43,37.2,27,14,2,12,20,53,18,0,Matches,2020-2021,Ligue-1
Yusuf Yazıcı,tr TUR,"FW,MF",Lille,23.0,1997.0,12.1,12,5,6,2,4,1,24,4.2,23,5,1,4,2,14,2,0,Matches,2020-2021,Ligue-1
Burak Yılmaz,tr TUR,FW,Lille,35.0,1985.0,22.8,13,6,3,7,3,4,30,13.3,26,7,0,7,5,18,22,0,Matches,2020-2021,Ligue-1
Wilitty Younoussa,cm CMR,MF,Dijon,18.0,2001.0,0.9,6,3,3,3,0,3,7,42.9,4,3,0,3,2,8,0,0,Matches,2020-2021,Ligue-1
Zaydou Youssouf,km COM,MF,Saint-Étienne,21.0,1999.0,13.7,30,15,19,10,1,16,40,40.0,24,15,0,15,25,55,12,1,Matches,2020-2021,Ligue-1
Arthur Zagre,fr FRA,"DF,MF",Dijon,18.0,2001.0,1.4,3,1,2,1,0,2,2,100.0,0,1,1,0,3,6,1,0,Matches,2020-2021,Ligue-1
Arber Zeneli,xk KVX,"MF,FW",Reims,25.0,1995.0,14.3,20,10,11,1,8,8,22,36.4,14,12,1,11,3,23,8,0,Matches,2020-2021,Ligue-1
Mehdi Zerkane,dz ALG,"MF,FW",Bordeaux,21.0,1999.0,13.2,23,15,7,10,6,5,18,27.8,13,15,2,13,9,32,5,0,Matches,2020-2021,Ligue-1
Kévin Zohi,ml MLI,"FW,MF",Strasbourg,23.0,1996.0,4.8,9,5,3,4,2,2,6,33.3,4,6,0,6,6,15,3,0,Matches,2020-2021,Ligue-1
Yunis Abdelhamid,ma MAR,DF,Reims,33.0,1987.0,33.1,48,27,34,14,0,16,32,50.0,16,50,25,25,68,116,104,0,Matches,2021-2022,Ligue-1
Salis Abdul Samed,gh GHA,MF,Clermont Foot,21.0,2000.0,27.4,43,23,25,16,2,20,57,35.1,37,18,1,17,42,85,15,0,Matches,2021-2022,Ligue-1
Laurent Abergel,fr FRA,MF,Lorient,28.0,1993.0,32.8,110,60,44,53,13,71,166,42.8,95,58,1,57,55,165,13,0,Matches,2021-2022,Ligue-1
Charles Abi,fr FRA,FW,Saint-Étienne,21.0,2000.0,0.5,0,0,0,0,0,0,1,0.0,1,2,0,2,0,0,0,0,Matches,2021-2022,Ligue-1
Matthis Abline,fr FRA,FW,Rennes,18.0,2003.0,1.1,0,0,0,0,0,0,0,,0,2,0,2,0,0,1,0,Matches,2021-2022,Ligue-1
Mohamed Achi,fr FRA,MF,Nantes,19.0,2002.0,0.1,0,0,0,0,0,0,0,,0,0,0,0,0,0,0,0,Matches,2021-2022,Ligue-1
Martin Adeline,fr FRA,"MF,FW",Reims,17.0,2003.0,3.9,15,11,5,8,2,8,16,50.0,8,0,0,0,11,26,6,0,Matches,2021-2022,Ligue-1
Yacine Adli,fr FRA,"MF,FW",Bordeaux,21.0,2000.0,25.1,43,27,22,14,7,19,68,27.9,49,33,3,30,37,80,11,2,Matches,2021-2022,Ligue-1
Lucien Agoume,fr FRA,MF,Brest,19.0,2002.0,20.8,51,31,24,20,7,23,45,51.1,22,30,9,21,52,103,27,1,Matches,2021-2022,Ligue-1
Nayef Aguerd,ma MAR,DF,Rennes,25.0,1996.0,30.4,27,18,16,11,0,14,24,58.3,10,24,14,10,24,51,127,1,Matches,2021-2022,Ligue-1
Ruben Aguilar,fr FRA,DF,Monaco,28.0,1993.0,23.8,78,53,39,32,7,43,68,63.2,25,19,4,15,44,122,57,0,Matches,2021-2022,Ligue-1
Anel Ahmedhodžić,ba BIH,DF,Bordeaux,22.0,1999.0,15.0,38,26,27,9,2,20,31,64.5,11,16,8,8,22,60,44,0,Matches,2021-2022,Ligue-1
Jean-Eudes Aholou,ci CIV,MF,Strasbourg,27.0,1994.0,11.2,16,9,4,9,3,5,19,26.3,14,8,1,7,19,35,7,0,Matches,2021-2022,Ligue-1
Ludovic Ajorque,fr FRA,FW,Strasbourg,27.0,1994.0,30.4,36,25,5,19,12,7,40,17.5,33,28,3,25,8,44,31,1,Matches,2021-2022,Ligue-1
Maghnes Akliouche,fr FRA,"MF,FW",Monaco,19.0,2002.0,0.6,2,0,0,2,0,0,1,0.0,1,2,0,2,0,2,0,0,Matches,2021-2022,Ligue-1
Sofiane Alakouch,ma MAR,"DF,MF",Metz,23.0,1998.0,1.8,7,4,3,4,0,2,5,40.0,3,4,0,4,1,8,4,0,Matches,2021-2022,Ligue-1
Josué Albert,gf GUF,DF,Clermont Foot,29.0,1992.0,0.2,0,0,0,0,0,0,0,,0,0,0,0,1,1,2,0,Matches,2021-2022,Ligue-1
Doğan Alemdar,tr TUR,GK,Rennes,18.0,2002.0,12.0,0,0,0,0,0,0,0,,0,0,0,0,0,0,9,1,Matches,2021-2022,Ligue-1
Mohamed Ali Cho,fr FRA,FW,Angers,17.0,2004.0,20.4,10,5,1,4,5,5,17,29.4,12,17,1,16,8,18,0,1,Matches,2021-2022,Ligue-1
Jim Allevinah,ga GAB,FW,Clermont Foot,26.0,1995.0,16.5,18,13,8,8,2,5,18,27.8,13,11,0,11,6,24,4,0,Matches,2021-2022,Ligue-1
Ibrahim Amadou,fr FRA,"DF,MF",Metz,28.0,1993.0,9.0,16,8,10,6,0,8,15,53.3,7,4,2,2,14,30,26,0,Matches,2021-2022,Ligue-1
Jordan Amavi,fr FRA,DF,Nice,27.0,1994.0,4.6,16,10,8,7,1,10,17,58.8,7,3,1,2,15,31,7,0,Matches,2021-2022,Ligue-1
Jordan Amavi,fr FRA,"DF,FW",Marseille,27.0,1994.0,1.4,6,5,3,1,2,5,10,50.0,5,1,0,1,1,7,3,0,Matches,2021-2022,Ligue-1
Benjamin André,fr FRA,MF,Lille,30.0,1990.0,30.6,123,69,49,65,9,51,113,45.1,62,49,11,38,50,173,56,0,Matches,2021-2022,Ligue-1
Houssem Aouar,dz ALG,"MF,FW",Lyon,23.0,1998.0,27.8,46,30,9,25,12,27,54,50.0,27,26,1,25,20,66,5,0,Matches,2021-2022,Ligue-1
Adil Aouchiche,fr FRA,"MF,FW",Saint-Étienne,19.0,2002.0,12.0,13,6,5,5,3,5,33,15.2,28,18,1,17,17,30,4,0,Matches,2021-2022,Ligue-1
Dennis Appiah,fr FRA,DF,Nantes,29.0,1992.0,23.3,55,34,35,18,2,28,48,58.3,20,30,13,17,27,82,74,0,Matches,2021-2022,Ligue-1
Lorenz Assignon,tg TOG,DF,Rennes,21.0,2000.0,6.8,15,10,11,3,1,5,9,55.6,4,3,1,2,11,26,19,0,Matches,2021-2022,Ligue-1
Youcef Atal,dz ALG,DF,Nice,25.0,1996.0,12.7,29,19,17,10,2,14,25,56.0,11,13,2,11,32,61,21,0,Matches,2021-2022,Ligue-1
Jean-Kévin Augustin,fr FRA,"FW,MF",Nantes,24.0,1997.0,0.9,1,0,0,0,1,0,3,0.0,3,1,0,1,0,1,0,0,Matches,2021-2022,Ligue-1
Karim Azamoum,fr FRA,DF,Troyes,31.0,1990.0,4.3,6,5,4,2,0,3,5,60.0,2,4,2,2,1,7,10,0,Matches,2021-2022,Ligue-1
Loïc Bade,fr FRA,DF,Rennes,21.0,2000.0,10.9,6,5,4,2,0,3,5,60.0,2,12,10,2,12,18,48,0,Matches,2021-2022,Ligue-1
Benoît Badiashile,fr FRA,DF,Monaco,20.0,2001.0,20.4,36,19,21,15,0,14,23,60.9,9,18,12,6,28,64,68,1,Matches,2021-2022,Ligue-1
Youssouph Badji,sn SEN,"FW,MF",Brest,19.0,2001.0,1.5,1,0,0,1,0,0,1,0.0,1,0,0,0,0,1,0,0,Matches,2021-2022,Ligue-1
Stéphane Bahoken,cm CMR,FW,Angers,29.0,1992.0,12.2,13,8,2,7,4,1,9,11.1,8,15,0,15,3,16,3,0,Matches,2021-2022,Ligue-1
Dénys Bain,fr FRA,DF,Brest,28.0,1993.0,2.0,3,3,1,2,0,1,1,100.0,0,3,1,2,3,6,5,0,Matches,2021-2022,Ligue-1
Stefan Bajic,fr FRA,GK,Saint-Étienne,19.0,2001.0,5.7,0,0,0,0,0,0,0,,0,0,0,0,0,0,4,0,Matches,2021-2022,Ligue-1
Cédric Bakambu,cd COD,FW,Marseille,30.0,1991.0,4.0,2,0,1,0,1,0,3,0.0,3,2,0,2,0,2,1,0,Matches,2021-2022,Ligue-1
Abdoulaye Bakayoko,fr FRA,DF,Saint-Étienne,18.0,2002.0,3.4,15,9,13,2,0,8,12,66.7,4,5,4,1,12,27,15,0,Matches,2021-2022,Ligue-1
Dilane Bakwa,fr FRA,"FW,MF",Bordeaux,18.0,2002.0,0.5,1,1,0,1,0,1,2,50.0,1,0,0,0,0,1,1,0,Matches,2021-2022,Ligue-1
Ibrahima Baldé,fr FRA,"FW,MF",Lens,18.0,2003.0,0.6,0,0,0,0,0,0,0,,0,0,0,0,0,0,0,0,Matches,2021-2022,Ligue-1
Leonardo Balerdi,ar ARG,DF,Marseille,22.0,1999.0,10.6,9,6,9,0,0,5,14,35.7,9,11,4,7,19,28,30,0,Matches,2021-2022,Ligue-1
Abdoulaye Bamba,ci CIV,"DF,FW",Angers,31.0,1990.0,5.1,6,5,6,0,0,4,11,36.4,7,5,1,4,9,15,13,0,Matches,2021-2022,Ligue-1
Jonathan Bamba,ci CIV,"MF,FW",Lille,25.0,1996.0,27.0,30,12,13,9,8,13,36,36.1,23,24,1,23,21,51,10,0,Matches,2021-2022,Ligue-1
Simon Banza,cd COD,FW,Lens,24.0,1996.0,1.4,2,1,0,0,2,0,2,0.0,2,1,0,1,1,3,2,0,Matches,2021-2022,Ligue-1
Danilo Barbosa,br BRA,DF,Nice,25.0,1996.0,1.0,0,0,0,0,0,0,0,,0,1,1,0,2,2,10,0,Matches,2021-2022,Ligue-1
Bradley Barcola,fr FRA,"FW,MF",Lyon,18.0,2002.0,2.9,7,4,2,3,2,1,8,12.5,7,7,1,6,2,9,1,0,Matches,2021-2022,Ligue-1
Melvin Bard,fr FRA,DF,Nice,20.0,2000.0,28.8,59,37,38,17,4,41,63,65.1,22,33,10,23,51,110,56,0,Matches,2021-2022,Ligue-1
Toma Bašić,hr CRO,MF,Bordeaux,24.0,1996.0,2.3,2,2,1,0,1,0,4,0.0,4,4,1,3,2,4,0,0,Matches,2021-2022,Ligue-1
Amine Bassi,fr FRA,"MF,FW",Metz,23.0,1997.0,2.0,6,3,2,3,1,1,3,33.3,2,5,0,5,0,6,0,0,Matches,2021-2022,Ligue-1
Paul Baysse,fr FRA,"MF,DF",Bordeaux,33.0,1988.0,0.1,1,1,0,1,0,0,0,,0,0,0,0,0,1,1,0,Matches,2021-2022,Ligue-1
Youcef Belaïli,dz ALG,"MF,FW",Brest,29.0,1992.0,9.2,2,1,0,0,2,2,9,22.2,7,5,1,4,7,9,4,0,Matches,2021-2022,Ligue-1
Haris Belkebla,dz ALG,MF,Brest,27.0,1994.0,25.7,46,23,21,21,4,18,39,46.2,21,26,6,20,48,94,30,1,Matches,2021-2022,Ligue-1
Jean-Ricner Bellegarde,fr FRA,MF,Strasbourg,23.0,1998.0,25.9,51,32,21,21,9,17,41,41.5,24,29,4,25,27,78,19,0,Matches,2021-2022,Ligue-1
Jeanuël Belocian,fr FRA,DF,Rennes,16.0,2005.0,0.1,0,0,0,0,0,0,0,,0,0,0,0,0,0,0,0,Matches,2021-2022,Ligue-1
Hatem Ben Arfa,fr FRA,"FW,MF",Lille,34.0,1987.0,3.5,4,2,2,1,1,2,4,50.0,2,3,0,3,0,4,1,0,Matches,2021-2022,Ligue-1
Salim Ben Seghir,fr FRA,MF,Marseille,18.0,2003.0,0.0,0,0,0,0,0,0,0,,0,0,0,0,0,0,0,0,Matches,2021-2022,Ligue-1
Wissam Ben Yedder,fr FRA,FW,Monaco,30.0,1990.0,28.1,18,8,1,11,6,6,15,40.0,9,12,1,11,0,18,1,0,Matches,2021-2022,Ligue-1
Darío Benedetto,ar ARG,"FW,MF",Marseille,31.0,1990.0,0.6,0,0,0,0,0,0,0,,0,2,0,2,0,0,0,0,Matches,2021-2022,Ligue-1
Walter Benítez,ar ARG,GK,Nice,28.0,1993.0,37.0,0,0,0,0,0,0,2,0.0,2,1,0,1,0,0,12,2,Matches,2021-2022,Ligue-1
Loris Benito,ch SUI,DF,Bordeaux,29.0,1992.0,0.7,0,0,0,0,0,0,0,,0,0,0,0,1,1,3,1,Matches,2021-2022,Ligue-1
Nabil Bentaleb,dz ALG,MF,Angers,26.0,1994.0,16.8,42,24,15,20,7,16,29,55.2,13,24,9,15,28,70,13,0,Matches,2021-2022,Ligue-1
Patrick Berg,no NOR,MF,Lens,23.0,1997.0,3.4,14,6,6,8,0,0,4,0.0,4,2,1,1,4,18,3,0,Matches,2021-2022,Ligue-1
Mitchell van Bergen,nl NED,"FW,MF",Reims,21.0,1999.0,10.9,8,5,7,0,1,6,15,40.0,9,9,0,9,4,12,7,0,Matches,2021-2022,Ligue-1
Valon Berisha,xk KVX,"MF,FW",Reims,28.0,1993.0,5.1,10,7,2,5,3,2,10,20.0,8,9,0,9,4,14,3,0,Matches,2021-2022,Ligue-1
Paul Bernardoni,fr FRA,GK,Angers,24.0,1997.0,13.0,3,2,3,0,0,3,4,75.0,1,0,0,0,0,3,8,1,Matches,2021-2022,Ligue-1
Paul Bernardoni,fr FRA,GK,Saint-Étienne,24.0,1997.0,19.0,0,0,0,0,0,0,0,,0,0,0,0,0,0,14,2,Matches,2021-2022,Ligue-1
Juan Bernat,es ESP,"DF,MF",Paris S-G,28.0,1993.0,10.6,24,14,10,10,4,13,18,72.2,5,8,0,8,8,32,16,0,Matches,2021-2022,Ligue-1
Dimitry Bertaud,cd COD,GK,Montpellier,23.0,1998.0,9.3,0,0,0,0,0,0,1,0.0,1,0,0,0,0,0,5,1,Matches,2021-2022,Ligue-1
Jason Berthomier,fr FRA,MF,Clermont Foot,31.0,1990.0,19.2,29,14,5,17,7,12,34,35.3,22,14,2,12,8,37,4,1,Matches,2021-2022,Ligue-1
Giulian Biancone,fr FRA,"DF,MF",Troyes,21.0,2000.0,25.5,70,42,44,22,4,40,69,58.0,29,23,8,15,53,123,71,1,Matches,2021-2022,Ligue-1
El Bilal Touré,ml MLI,FW,Reims,19.0,2001.0,13.3,13,6,4,6,3,2,7,28.6,5,10,3,7,6,19,19,0,Matches,2021-2022,Ligue-1
Jean-Claude Billong,cm CMR,DF,Clermont Foot,27.0,1993.0,10.9,17,8,14,1,2,8,11,72.7,3,9,1,8,10,27,35,0,Matches,2021-2022,Ligue-1
Nathan Bitumazala,fr FRA,DF,Paris S-G,18.0,2002.0,0.1,0,0,0,0,0,0,0,,0,1,0,1,0,0,0,0,Matches,2021-2022,Ligue-1
Marco Bizot,nl NED,GK,Brest,30.0,1991.0,38.0,3,1,3,0,0,3,5,60.0,2,1,0,1,0,3,24,1,Matches,2021-2022,Ligue-1
Ludovic Blas,fr FRA,"MF,FW",Nantes,23.0,1997.0,32.9,33,18,7,20,6,15,44,34.1,29,33,3,30,31,64,6,1,Matches,2021-2022,Ligue-1
Myron Boadu,nl NED,FW,Monaco,20.0,2001.0,10.7,9,7,2,3,4,1,5,20.0,4,6,0,6,2,11,1,0,Matches,2021-2022,Ligue-1
Jérôme Boateng,de GER,DF,Lyon,32.0,1988.0,18.0,20,15,11,9,0,9,17,52.9,8,20,10,10,20,40,73,0,Matches,2021-2022,Ligue-1
Antonin Bobichon,fr FRA,"MF,FW",Angers,25.0,1995.0,0.4,1,0,0,1,0,0,0,,0,0,0,0,1,2,0,0,Matches,2021-2022,Ligue-1
Quentin Boisgard,fr FRA,"MF,FW",Lorient,24.0,1997.0,10.6,19,11,6,10,3,8,17,47.1,9,15,0,15,6,25,5,0,Matches,2021-2022,Ligue-1
Charles Boli,fr FRA,"MF,DF",Lens,22.0,1998.0,0.4,2,1,0,2,0,0,0,,0,0,0,0,0,2,0,0,Matches,2021-2022,Ligue-1
Sven Botman,nl NED,DF,Lille,21.0,2000.0,25.0,24,11,13,11,0,12,18,66.7,6,32,21,11,26,50,116,0,Matches,2021-2022,Ligue-1
Denis Bouanga,ga GAB,"FW,MF",Saint-Étienne,26.0,1994.0,27.1,46,25,14,13,19,22,63,34.9,41,30,0,30,8,54,34,1,Matches,2021-2022,Ligue-1
Hicham Boudaoui,dz ALG,MF,Nice,21.0,1999.0,18.0,31,18,15,10,6,13,36,36.1,23,17,4,13,18,49,15,0,Matches,2021-2022,Ligue-1
Ryad Boudebouz,dz ALG,"MF,FW",Saint-Étienne,31.0,1990.0,25.0,27,15,11,12,4,12,29,41.4,17,17,2,15,10,37,5,0,Matches,2021-2022,Ligue-1
Sofiane Boufal,ma MAR,"FW,MF",Angers,27.0,1993.0,25.9,44,29,19,16,9,18,38,47.4,20,19,2,17,7,51,1,0,Matches,2021-2022,Ligue-1
Farid Boulaya,dz ALG,"MF,FW",Metz,28.0,1993.0,17.0,18,10,7,9,2,14,38,36.8,24,8,2,6,12,30,5,0,Matches,2021-2022,Ligue-1
Ismaël Boura,km COM,DF,Lens,20.0,2000.0,1.1,2,2,1,1,0,0,0,,0,1,1,0,2,4,5,0,Matches,2021-2022,Ligue-1
Benjamin Bourigeaud,fr FRA,"FW,MF",Rennes,27.0,1994.0,35.5,46,24,16,18,12,24,67,35.8,43,33,3,30,30,76,44,0,Matches,2021-2022,Ligue-1
Redwan Bourles,fr FRA,"MF,FW",Lorient,18.0,2003.0,0.2,0,0,0,0,0,0,0,,0,0,0,0,0,0,0,0,Matches,2021-2022,Ligue-1
Domagoj Bradarić,hr CRO,DF,Lille,21.0,1999.0,4.6,11,9,8,2,1,7,12,58.3,5,5,2,3,10,21,7,1,Matches,2021-2022,Ligue-1
Bilal Brahimi,dz ALG,MF,Nice,21.0,2000.0,4.2,1,1,0,1,0,0,2,0.0,2,1,0,1,2,3,1,0,Matches,2021-2022,Ligue-1
Bilal Brahimi,dz ALG,FW,Angers,21.0,2000.0,3.8,1,1,0,1,0,0,3,0.0,3,0,0,0,1,2,1,0,Matches,2021-2022,Ligue-1
Lilian Brassier,fr FRA,DF,Brest,21.0,1999.0,25.1,40,24,23,13,4,10,21,47.6,11,31,21,10,32,72,86,0,Matches,2021-2022,Ligue-1
Jimmy Briand,fr FRA,"FW,MF",Bordeaux,35.0,1985.0,2.5,2,0,2,0,0,0,2,0.0,2,0,0,0,1,3,2,0,Matches,2021-2022,Ligue-1
Dylan Bronn,tn TUN,DF,Metz,26.0,1995.0,28.3,47,29,33,13,1,20,31,64.5,11,32,19,13,40,87,78,1,Matches,2021-2022,Ligue-1
Osman Bukari,gh GHA,"FW,MF",Nantes,22.0,1998.0,11.2,18,8,7,6,5,8,22,36.4,14,8,0,8,8,26,1,0,Matches,2021-2022,Ligue-1
Maxime Busi,be BEL,DF,Reims,21.0,1999.0,14.4,26,15,20,5,1,19,36,52.8,17,19,5,14,17,43,28,0,Matches,2021-2022,Ligue-1
Oriol Busquets,es ESP,MF,Clermont Foot,22.0,1999.0,2.2,3,3,0,3,0,2,6,33.3,4,7,4,3,1,4,2,0,Matches,2021-2022,Ligue-1
Marcin Bułka,pl POL,GK,Nice,21.0,1999.0,1.0,0,0,0,0,0,0,0,,0,0,0,0,0,0,0,0,Matches,2021-2022,Ligue-1
Rémy Cabella,fr FRA,"MF,FW",Montpellier,31.0,1990.0,3.5,15,7,4,8,3,5,15,33.3,10,7,0,7,5,20,1,0,Matches,2021-2022,Ligue-1
Jimmy Cabot,fr FRA,DF,Angers,27.0,1994.0,22.3,81,44,59,15,7,47,83,56.6,36,29,0,29,32,113,30,0,Matches,2021-2022,Ligue-1
Anthony Caci,fr FRA,DF,Strasbourg,24.0,1997.0,26.6,65,34,35,24,6,33,55,60.0,22,22,3,19,33,98,49,1,Matches,2021-2022,Ligue-1
Mathieu Cafaro,fr FRA,"MF,FW",Reims,24.0,1997.0,2.1,4,2,3,1,0,0,7,0.0,7,2,0,2,3,7,1,0,Matches,2021-2022,Ligue-1
Yannick Cahuzac,fr FRA,MF,Lens,36.0,1985.0,6.9,5,2,2,3,0,0,5,0.0,5,8,2,6,9,14,12,0,Matches,2021-2022,Ligue-1
Marc-Aurèle Caillard,fr FRA,GK,Metz,27.0,1994.0,17.1,0,0,0,0,0,0,2,0.0,2,0,0,0,2,2,9,1,Matches,2021-2022,Ligue-1
Jens Cajuste,se SWE,"MF,FW",Reims,21.0,1999.0,4.0,10,6,6,2,2,6,17,35.3,11,7,2,5,5,15,6,0,Matches,2021-2022,Ligue-1
Duje Ćaleta-Car,hr CRO,DF,Marseille,24.0,1996.0,22.9,21,8,15,6,0,11,14,78.6,3,11,7,4,24,45,55,2,Matches,2021-2022,Ligue-1
Lucas Calodat,fr FRA,DF,Saint-Étienne,19.0,2002.0,0.0,0,0,0,0,0,0,0,,0,0,0,0,0,0,0,0,Matches,2021-2022,Ligue-1
Mahdi Camara,fr FRA,"MF,DF",Saint-Étienne,23.0,1998.0,34.1,101,57,39,50,12,39,70,55.7,31,44,8,36,57,158,35,1,Matches,2021-2022,Ligue-1
Mamadou Camara,ml MLI,FW,Troyes,20.0,2001.0,0.4,1,1,1,0,0,0,0,,0,0,0,0,0,1,0,0,Matches,2021-2022,Ligue-1
Eduardo Camavinga,fr FRA,MF,Rennes,18.0,2002.0,1.6,4,1,2,1,1,2,5,40.0,3,1,1,0,1,5,3,0,Matches,2021-2022,Ligue-1
Fali Candé,gw GNB,DF,Metz,23.0,1998.0,10.8,30,18,13,15,2,13,31,41.9,18,11,2,9,6,36,21,0,Matches,2021-2022,Ligue-1
Pierrick Capelle,fr FRA,"MF,DF",Angers,34.0,1987.0,13.3,36,24,16,17,3,18,52,34.6,34,12,1,11,16,52,20,0,Matches,2021-2022,Ligue-1
Maxence Caqueret,fr FRA,MF,Lyon,21.0,2000.0,25.9,73,40,29,36,8,30,80,37.5,50,38,10,28,43,116,26,2,Matches,2021-2022,Ligue-1
Irvin Cardona,fr FRA,"FW,MF",Brest,23.0,1997.0,14.8,13,7,5,4,4,3,16,18.8,13,10,0,10,5,18,17,0,Matches,2021-2022,Ligue-1
Igor Carioca,br BRA,DF,Lorient,24.0,1996.0,17.5,27,16,16,8,3,15,43,34.9,28,17,2,15,25,52,28,0,Matches,2021-2022,Ligue-1
Moreto Cassamã,gw GNB,MF,Reims,23.0,1998.0,8.9,12,6,7,4,1,3,19,15.8,16,10,5,5,9,21,5,0,Matches,2021-2022,Ligue-1
Jean-Charles Castelletto,cm CMR,DF,Nantes,26.0,1995.0,27.9,45,24,27,17,1,25,35,71.4,10,38,27,11,30,75,73,0,Matches,2021-2022,Ligue-1
Zeki Çelik,tr TUR,DF,Lille,24.0,1997.0,30.0,64,37,43,17,4,36,63,57.1,27,32,9,23,43,107,62,2,Matches,2021-2022,Ligue-1
Fabien Centonze,fr FRA,DF,Metz,25.0,1996.0,17.6,33,21,22,9,2,13,32,40.6,19,37,8,29,32,65,51,0,Matches,2021-2022,Ligue-1
El Chadaille Bitshiabu,fr FRA,DF,Paris S-G,16.0,2005.0,0.1,0,0,0,0,0,0,0,,0,0,0,0,0,0,2,0,Matches,2021-2022,Ligue-1
Nassim Chadli,fr FRA,"MF,DF",Troyes,20.0,2001.0,1.1,5,3,3,0,2,2,4,50.0,2,1,0,1,0,5,0,0,Matches,2021-2022,Ligue-1
Mehdi Chahiri,ma MAR,DF,Strasbourg,25.0,1996.0,0.2,1,1,1,0,0,1,1,100.0,0,0,0,0,0,1,0,0,Matches,2021-2022,Ligue-1
Dylan Chambost,fr FRA,"MF,FW",Troyes,23.0,1997.0,8.4,16,11,6,9,1,4,25,16.0,21,9,2,7,8,24,4,0,Matches,2021-2022,Ligue-1
Brendan Chardonnet,fr FRA,DF,Brest,26.0,1994.0,29.8,44,25,32,11,1,29,40,72.5,11,42,29,13,55,99,141,0,Matches,2021-2022,Ligue-1
Xavier Chavalerin,fr FRA,MF,Troyes,30.0,1991.0,30.2,49,26,19,25,5,12,55,21.8,43,32,5,27,39,88,36,0,Matches,2021-2022,Ligue-1
Xavier Chavalerin,fr FRA,MF,Reims,30.0,1991.0,2.4,4,4,2,1,1,1,3,33.3,2,2,0,2,5,9,2,1,Matches,2021-2022,Ligue-1
Rayan Cherki,fr FRA,"FW,MF",Lyon,17.0,2003.0,4.9,6,2,1,3,2,4,9,44.4,5,2,0,2,1,7,0,0,Matches,2021-2022,Ligue-1
Pedro Chirivella,es ESP,MF,Nantes,24.0,1997.0,29.3,49,31,14,26,9,25,70,35.7,45,23,2,21,37,86,11,0,Matches,2021-2022,Ligue-1
Joris Chotard,fr FRA,MF,Montpellier,19.0,2001.0,32.6,59,30,33,23,3,36,78,46.2,42,27,15,12,42,101,56,0,Matches,2021-2022,Ligue-1
Alexis Claude-Maurice,fr FRA,MF,Nice,23.0,1998.0,2.3,2,0,1,0,1,1,4,25.0,3,7,0,7,3,5,1,0,Matches,2021-2022,Ligue-1
Jonathan Clauss,fr FRA,DF,Lens,28.0,1992.0,33.8,63,34,33,20,10,22,55,40.0,33,43,1,42,73,136,51,0,Matches,2021-2022,Ligue-1
Marcus Coco,fr FRA,"MF,FW",Nantes,25.0,1996.0,10.3,34,14,17,11,6,8,18,44.4,10,11,1,10,10,44,15,0,Matches,2021-2022,Ligue-1
Abdu Conté,pt POR,DF,Troyes,23.0,1998.0,15.0,22,12,16,5,1,12,24,50.0,12,12,2,10,4,26,10,0,Matches,2021-2022,Ligue-1
Sébastien Corchia,fr FRA,DF,Nantes,30.0,1990.0,14.7,33,20,17,11,5,24,42,57.1,18,24,3,21,13,46,36,0,Matches,2021-2022,Ligue-1
Maxwel Cornet,ci CIV,DF,Lyon,24.0,1996.0,0.7,3,1,1,0,2,3,4,75.0,1,0,0,0,1,4,1,0,Matches,2021-2022,Ligue-1
David Costa,pt POR,"MF,FW",Lens,20.0,2001.0,16.3,22,12,9,6,7,11,26,42.3,15,12,0,12,13,35,5,0,Matches,2021-2022,Ligue-1
Benoît Costil,fr FRA,GK,Bordeaux,34.0,1987.0,25.0,1,0,1,0,0,1,2,50.0,1,0,0,0,0,1,6,3,Matches,2021-2022,Ligue-1
Kalifa Coulibaly,ml MLI,FW,Nantes,29.0,1991.0,9.4,5,1,1,1,3,0,4,0.0,4,2,2,0,0,5,11,0,Matches,2021-2022,Ligue-1
Nicolas Cozza,fr FRA,DF,Montpellier,22.0,1999.0,30.8,80,47,50,23,7,35,65,53.8,30,35,19,16,38,118,82,1,Matches,2021-2022,Ligue-1
Enzo Crivelli,fr FRA,"FW,MF",Saint-Étienne,26.0,1995.0,1.1,1,0,0,0,1,0,0,,0,0,0,0,0,1,1,0,Matches,2021-2022,Ligue-1
Wylan Cyprien,fr FRA,MF,Nantes,26.0,1995.0,16.6,33,17,12,18,3,13,32,40.6,19,16,6,10,10,43,14,2,Matches,2021-2022,Ligue-1
Lucas Da Cunha,fr FRA,MF,Nice,20.0,2001.0,4.4,13,7,2,7,4,6,11,54.5,5,2,0,2,1,14,2,0,Matches,2021-2022,Ligue-1
Lucas Da Cunha,fr FRA,"FW,MF",Clermont Foot,20.0,2001.0,9.3,17,11,5,8,4,9,18,50.0,9,13,0,13,1,18,3,0,Matches,2021-2022,Ligue-1
Damien Da Silva,fr FRA,DF,Lyon,33.0,1988.0,12.5,13,9,7,5,1,5,9,55.6,4,15,10,5,22,35,53,1,Matches,2021-2022,Ligue-1
Colin Dagba,fr FRA,DF,Paris S-G,22.0,1998.0,1.8,4,2,2,2,0,3,6,50.0,3,4,2,2,2,6,1,0,Matches,2021-2022,Ligue-1
Flavius Daniliuc,at AUT,DF,Nice,20.0,2001.0,14.4,46,31,26,17,3,34,43,79.1,9,13,7,6,14,60,34,1,Matches,2021-2022,Ligue-1
Kevin Danso,at AUT,DF,Lens,22.0,1998.0,31.0,41,29,29,12,0,23,34,67.6,11,38,25,13,40,81,111,0,Matches,2021-2022,Ligue-1
Dante,br BRA,DF,Nice,37.0,1983.0,31.9,42,29,30,12,0,23,33,69.7,10,43,27,16,49,91,96,1,Matches,2021-2022,Ligue-1
Jonathan David,ca CAN,FW,Lille,21.0,2000.0,31.2,24,9,7,11,6,9,30,30.0,21,14,4,10,5,29,15,0,Matches,2021-2022,Ligue-1
Konrad De La Fuente,us USA,"FW,MF",Marseille,20.0,2001.0,8.7,11,7,8,2,1,7,11,63.6,4,5,0,5,2,13,4,0,Matches,2021-2022,Ligue-1
Romain Del Castillo,fr FRA,"MF,FW",Rennes,25.0,1996.0,0.3,2,1,0,1,1,2,2,100.0,0,0,0,0,1,3,0,0,Matches,2021-2022,Ligue-1
Romain Del Castillo,fr FRA,"MF,FW",Brest,25.0,1996.0,10.8,27,16,3,17,7,12,31,38.7,19,12,0,12,7,34,3,0,Matches,2021-2022,Ligue-1
Thomas Delaine,fr FRA,DF,Metz,29.0,1992.0,25.7,48,35,34,12,2,22,42,52.4,20,20,7,13,27,75,31,0,Matches,2021-2022,Ligue-1
Sacha Delaye,fr FRA,"MF,FW",Montpellier,19.0,2002.0,2.8,8,6,3,2,3,2,8,25.0,6,1,0,1,1,9,1,1,Matches,2021-2022,Ligue-1
Andy Delort,dz ALG,FW,Nice,29.0,1991.0,27.2,15,9,3,5,7,7,12,58.3,5,13,4,9,9,24,14,0,Matches,2021-2022,Ligue-1
Andy Delort,dz ALG,FW,Montpellier,29.0,1991.0,3.0,2,0,0,1,1,0,1,0.0,1,1,0,1,0,2,4,0,Matches,2021-2022,Ligue-1
Moussa Dembélé,fr FRA,FW,Lyon,25.0,1996.0,24.5,18,9,5,5,8,6,15,40.0,9,13,0,13,8,26,30,1,Matches,2021-2022,Ligue-1
Jason Denayer,be BEL,DF,Lyon,26.0,1995.0,11.1,11,4,8,3,0,6,7,85.7,1,8,7,1,16,27,52,0,Matches,2021-2022,Ligue-1
Arthur Desmas,fr FRA,GK,Clermont Foot,27.0,1994.0,14.5,0,0,0,0,0,0,3,0.0,3,0,0,0,0,0,1,3,Matches,2021-2022,Ligue-1
Ángel Di María,ar ARG,FW,Paris S-G,33.0,1988.0,18.3,29,18,6,13,10,14,37,37.8,23,17,0,17,6,35,3,0,Matches,2021-2022,Ligue-1
Yadaly Diaby,gn GUI,"FW,MF",Clermont Foot,20.0,2000.0,0.7,0,0,0,0,0,0,1,0.0,1,0,0,0,2,2,2,0,Matches,2021-2022,Ligue-1
Ibrahim Diakité,gn GUI,MF,Reims,17.0,2003.0,0.0,0,0,0,0,0,0,1,0.0,1,0,0,0,0,0,0,0,Matches,2021-2022,Ligue-1
Abdou Diallo,sn SEN,DF,Paris S-G,25.0,1996.0,9.7,22,14,10,9,3,8,14,57.1,6,6,2,4,10,32,19,1,Matches,2021-2022,Ligue-1
Habib Diallo,sn SEN,FW,Strasbourg,26.0,1995.0,17.1,9,5,0,8,1,0,8,0.0,8,13,4,9,4,13,11,0,Matches,2021-2022,Ligue-1
Habib Diarra,sn SEN,MF,Strasbourg,17.0,2004.0,1.2,2,1,1,1,0,1,1,100.0,0,0,0,0,0,2,0,0,Matches,2021-2022,Ligue-1
Stéphane Diarra,fr FRA,"MF,FW",Lorient,22.0,1998.0,5.8,11,9,7,3,1,5,10,50.0,5,4,0,4,7,18,1,0,Matches,2021-2022,Ligue-1
Krépin Diatta,sn SEN,"MF,DF",Monaco,22.0,1999.0,3.2,3,2,1,0,2,1,3,33.3,2,2,0,2,1,4,0,0,Matches,2021-2022,Ligue-1
Bamba Dieng,sn SEN,FW,Marseille,21.0,2000.0,10.8,17,11,5,5,7,4,14,28.6,10,7,0,7,5,22,8,0,Matches,2021-2022,Ligue-1
Elhadji Dieye,sn SEN,"FW,MF",Saint-Étienne,19.0,2002.0,0.4,3,2,2,1,0,0,1,0.0,1,2,0,2,1,4,0,0,Matches,2021-2022,Ligue-1
Javairô Dilrosun,nl NED,"MF,FW",Bordeaux,23.0,1998.0,19.2,13,4,2,8,3,7,24,29.2,17,14,1,13,11,24,5,0,Matches,2021-2022,Ligue-1
Junior Dina Ebimbe,fr FRA,MF,Paris S-G,20.0,2000.0,3.5,9,4,3,4,2,2,3,66.7,1,5,3,2,2,11,1,0,Matches,2021-2022,Ligue-1
Tristan Dingomé,cm CMR,"MF,FW",Troyes,30.0,1991.0,12.0,23,11,10,12,1,10,18,55.6,8,7,1,6,9,32,3,0,Matches,2021-2022,Ligue-1
Sinaly Diomande,ci CIV,DF,Lyon,20.0,2001.0,6.4,6,3,4,2,0,5,6,83.3,1,6,6,0,12,18,26,0,Matches,2021-2022,Ligue-1
Sofiane Diop,fr FRA,"MF,FW",Monaco,21.0,2000.0,21.6,38,20,12,19,7,15,47,31.9,32,10,0,10,23,61,4,0,Matches,2021-2022,Ligue-1
Andy Diouf,fr FRA,MF,Rennes,18.0,2003.0,0.2,1,1,1,0,0,1,1,100.0,0,1,0,1,0,1,0,0,Matches,2021-2022,Ligue-1
Assane Dioussé,sn SEN,MF,Saint-Étienne,23.0,1997.0,0.3,1,1,1,0,0,1,1,100.0,0,0,0,0,0,1,0,0,Matches,2021-2022,Ligue-1
Axel Disasi,fr FRA,DF,Monaco,23.0,1998.0,30.2,42,27,20,21,1,23,39,59.0,16,40,30,10,26,68,75,0,Matches,2021-2022,Ligue-1
Tiago Djaló,pt POR,DF,Lille,21.0,2000.0,25.9,60,39,39,19,2,26,39,66.7,13,26,10,16,24,84,71,0,Matches,2021-2022,Ligue-1
Alexander Djiku,gh GHA,DF,Strasbourg,26.0,1994.0,29.9,50,37,33,13,4,18,35,51.4,17,30,13,17,61,111,90,2,Matches,2021-2022,Ligue-1
Bryan Djile Nokoué,cm CMR,"DF,MF",Saint-Étienne,19.0,2002.0,0.6,3,3,1,2,0,2,2,100.0,0,1,0,1,1,4,2,0,Matches,2021-2022,Ligue-1
Ouparine Djoco,gw GNB,GK,Clermont Foot,23.0,1998.0,23.5,0,0,0,0,0,0,0,,0,0,0,0,1,1,14,2,Matches,2021-2022,Ligue-1
Jeremy Doku,be BEL,"FW,MF",Rennes,19.0,2002.0,5.2,10,5,3,5,2,3,6,50.0,3,4,0,4,3,13,0,0,Matches,2021-2022,Ligue-1
Kasper Dolberg,dk DEN,FW,Nice,23.0,1997.0,16.6,9,4,4,3,2,3,9,33.3,6,15,1,14,6,15,17,0,Matches,2021-2022,Ligue-1
Brandon Domingues,fr FRA,"MF,FW",Troyes,21.0,2000.0,2.6,6,2,2,4,0,2,3,66.7,1,3,0,3,3,9,0,0,Matches,2021-2022,Ligue-1
Anastasios Donis,gr GRE,"FW,MF",Reims,24.0,1996.0,4.1,8,7,4,2,2,2,6,33.3,4,3,0,3,0,8,1,0,Matches,2021-2022,Ligue-1
Gianluigi Donnarumma,it ITA,GK,Paris S-G,22.0,1999.0,17.0,0,0,0,0,0,0,0,,0,0,0,0,0,0,9,2,Matches,2021-2022,Ligue-1
Jodel Dossou,bj BEN,FW,Clermont Foot,29.0,1992.0,22.3,36,17,15,14,7,15,43,34.9,28,14,0,14,5,41,7,0,Matches,2021-2022,Ligue-1
Lohann Doucet,fr FRA,"MF,DF",Nantes,18.0,2002.0,0.1,0,0,0,0,0,0,0,,0,0,0,0,1,1,0,0,Matches,2021-2022,Ligue-1
Cheick Doucouré,ml MLI,MF,Lens,21.0,2000.0,32.7,75,43,34,34,7,35,79,44.3,44,30,7,23,68,143,24,0,Matches,2021-2022,Ligue-1
Fodé Doucouré,ml MLI,"DF,FW",Reims,20.0,2001.0,1.7,12,9,9,3,0,9,11,81.8,2,1,0,1,4,16,6,0,Matches,2021-2022,Ligue-1
Ismaël Doukouré,fr FRA,DF,Strasbourg,18.0,2003.0,0.2,0,0,0,0,0,0,0,,0,0,0,0,0,0,1,0,Matches,2021-2022,Ligue-1
Kamory Doumbia,ml MLI,"MF,FW",Reims,18.0,2003.0,3.9,8,2,2,5,1,5,13,38.5,8,9,3,6,3,11,3,0,Matches,2021-2022,Ligue-1
Moussa Doumbia,ml MLI,FW,Reims,26.0,1994.0,1.0,0,0,0,0,0,0,1,0.0,1,0,0,0,0,0,0,0,Matches,2021-2022,Ligue-1
Souleyman Doumbia,ci CIV,"DF,FW",Angers,24.0,1996.0,24.7,30,20,16,9,5,13,27,48.1,14,25,4,21,39,69,51,0,Matches,2021-2022,Ligue-1
Julian Draxler,de GER,"FW,MF",Paris S-G,27.0,1993.0,6.1,3,2,0,3,0,0,4,0.0,4,3,0,3,5,8,3,0,Matches,2021-2022,Ligue-1
Matthieu Dreyer,fr FRA,GK,Lorient,32.0,1989.0,16.0,1,1,1,0,0,1,1,100.0,0,0,0,0,0,1,9,0,Matches,2021-2022,Ligue-1
Leo Dubois,fr FRA,DF,Lyon,26.0,1994.0,19.4,43,27,22,14,7,27,46,58.7,19,27,3,24,22,65,35,1,Matches,2021-2022,Ligue-1
Jean-Kevin Duverne,ht HAI,DF,Brest,24.0,1997.0,33.4,71,44,43,21,7,42,90,46.7,48,40,5,35,53,124,92,0,Matches,2021-2022,Ligue-1
Enzo Ebosse,cm CMR,DF,Angers,22.0,1999.0,21.0,25,14,19,6,0,11,19,57.9,8,19,9,10,15,40,42,0,Matches,2021-2022,Ligue-1
Hugo Ekitike,fr FRA,FW,Reims,19.0,2002.0,14.1,18,10,8,6,4,4,11,36.4,7,9,2,7,6,24,15,0,Matches,2021-2022,Ligue-1
Alberth Elis,hn HON,"FW,MF",Bordeaux,25.0,1996.0,15.7,19,10,5,5,9,11,25,44.0,14,9,0,9,7,26,10,0,Matches,2021-2022,Ligue-1
Renaud Emond,be BEL,"FW,MF",Nantes,29.0,1991.0,2.1,1,0,0,1,0,0,4,0.0,4,2,1,1,0,1,1,0,Matches,2021-2022,Ligue-1
Maxime Estève,fr FRA,DF,Montpellier,19.0,2002.0,20.6,27,18,22,4,1,15,27,55.6,12,31,24,7,22,49,69,1,Matches,2021-2022,Ligue-1
Fábio,br BRA,DF,Nantes,31.0,1990.0,18.5,61,40,31,23,7,36,74,48.6,38,29,7,22,35,96,31,1,Matches,2021-2022,Ligue-1
Cesc Fàbregas,es ESP,MF,Monaco,34.0,1987.0,0.4,1,0,0,1,0,1,1,100.0,0,0,0,0,1,2,0,0,Matches,2021-2022,Ligue-1
Wout Faes,be BEL,DF,Reims,23.0,1998.0,37.0,40,24,30,9,1,25,33,75.8,8,47,37,10,53,93,169,2,Matches,2021-2022,Ligue-1
Romain Faivre,fr FRA,"FW,MF",Lyon,23.0,1998.0,9.9,10,4,2,6,2,4,13,30.8,9,4,0,4,3,13,2,0,Matches,2021-2022,Ligue-1
Romain Faivre,fr FRA,MF,Brest,23.0,1998.0,19.9,30,18,12,13,5,12,30,40.0,18,11,0,11,13,43,10,0,Matches,2021-2022,Ligue-1
Wuilker Faríñez,ve VEN,GK,Lens,23.0,1998.0,12.3,0,0,0,0,0,0,0,,0,0,0,0,0,0,4,0,Matches,2021-2022,Ligue-1
Noah Fatar,fr FRA,"DF,MF",Angers,19.0,2002.0,0.1,1,0,0,0,1,0,1,0.0,1,0,0,0,1,2,0,0,Matches,2021-2022,Ligue-1
Julien Faussurier,fr FRA,"MF,DF",Brest,34.0,1987.0,5.4,10,6,3,3,4,6,13,46.2,7,12,1,11,5,15,6,0,Matches,2021-2022,Ligue-1
Jordan Ferri,fr FRA,MF,Montpellier,29.0,1992.0,32.3,55,35,28,23,4,29,87,33.3,58,21,5,16,30,85,35,0,Matches,2021-2022,Ligue-1
Karol Fila,pl POL,DF,Strasbourg,23.0,1998.0,6.2,10,8,5,4,1,4,8,50.0,4,7,2,5,4,14,6,0,Matches,2021-2022,Ligue-1
Alexis Flips,fr FRA,"MF,DF",Reims,21.0,2000.0,11.7,37,21,21,9,7,22,45,48.9,23,21,0,21,24,61,17,0,Matches,2021-2022,Ligue-1
Mamadou Fofana,ml MLI,DF,Metz,23.0,1998.0,0.4,1,1,0,1,0,1,2,50.0,1,2,1,1,1,2,2,0,Matches,2021-2022,Ligue-1
Seko Fofana,ci CIV,MF,Lens,26.0,1995.0,37.3,27,19,11,13,3,12,58,20.7,46,24,2,22,26,53,17,1,Matches,2021-2022,Ligue-1
Youssouf Fofana,fr FRA,MF,Monaco,22.0,1999.0,24.3,69,43,19,41,9,29,56,51.8,27,29,7,22,32,101,22,2,Matches,2021-2022,Ligue-1
Thomas Foket,be BEL,"DF,FW",Reims,26.0,1994.0,24.8,28,19,12,13,3,18,40,45.0,22,26,4,22,33,61,35,0,Matches,2021-2022,Ligue-1
Thomas Fontaine,mg MAD,DF,Lorient,30.0,1991.0,1.9,2,0,1,0,1,0,1,0.0,1,3,3,0,2,4,4,0,Matches,2021-2022,Ligue-1
José Fonte,pt POR,DF,Lille,37.0,1983.0,38.0,23,12,14,7,2,11,25,44.0,14,39,32,7,44,67,159,1,Matches,2021-2022,Ligue-1
Steven Fortes,cv CPV,DF,Lens,29.0,1992.0,1.0,2,0,2,0,0,1,2,50.0,1,2,1,1,0,2,4,0,Matches,2021-2022,Ligue-1
Przemysław Frankowski,pl POL,DF,Lens,26.0,1995.0,27.2,57,39,22,27,8,36,74,48.6,38,27,0,27,28,85,52,0,Matches,2021-2022,Ligue-1
Fransérgio,br BRA,MF,Bordeaux,30.0,1990.0,14.0,24,10,8,12,4,12,43,27.9,31,18,6,12,23,47,23,0,Matches,2021-2022,Ligue-1
Angelo Fulgini,fr FRA,"MF,FW",Angers,24.0,1996.0,32.5,35,25,8,18,9,14,44,31.8,30,21,5,16,22,57,5,1,Matches,2021-2022,Ligue-1
Gauthier Gallon,fr FRA,GK,Troyes,28.0,1993.0,31.0,3,0,3,0,0,1,1,100.0,0,0,0,0,2,5,12,1,Matches,2021-2022,Ligue-1
Kévin Gameiro,fr FRA,FW,Strasbourg,34.0,1987.0,26.5,19,10,5,9,5,6,18,33.3,12,22,1,21,6,25,1,0,Matches,2021-2022,Ligue-1
Idrissa Gana Gueye,sn SEN,MF,Paris S-G,31.0,1989.0,18.2,60,36,24,24,12,18,44,40.9,26,23,4,19,24,84,13,0,Matches,2021-2022,Ligue-1
Ignatius Ganago,cm CMR,FW,Lens,22.0,1999.0,11.4,3,2,1,2,0,2,6,33.3,4,4,0,4,2,5,3,0,Matches,2021-2022,Ligue-1
Djeidi Gassama,fr FRA,FW,Paris S-G,17.0,2003.0,0.0,0,0,0,0,0,0,0,,0,1,1,0,0,0,0,0,Matches,2021-2022,Ligue-1
Johan Gastien,fr FRA,MF,Clermont Foot,33.0,1988.0,30.5,56,34,26,25,5,27,74,36.5,47,45,11,34,53,109,49,1,Matches,2021-2022,Ligue-1
Valère Germain,fr FRA,FW,Montpellier,31.0,1990.0,21.9,23,14,6,11,6,8,31,25.8,23,13,1,12,9,32,27,0,Matches,2021-2022,Ligue-1
Gerson,br BRA,"MF,FW",Marseille,24.0,1997.0,28.3,42,17,16,20,6,8,35,22.9,27,26,4,22,16,58,16,2,Matches,2021-2022,Ligue-1
Willem Geubbels,fr FRA,"FW,MF",Nantes,19.0,2001.0,6.0,8,5,4,2,2,5,12,41.7,7,5,0,5,6,14,5,0,Matches,2021-2022,Ligue-1
Ismaël Gharbi,es ESP,FW,Paris S-G,17.0,2004.0,0.0,0,0,0,0,0,0,0,,0,0,0,0,0,0,0,0,Matches,2021-2022,Ligue-1
Lamine Ghezali,fr FRA,DF,Saint-Étienne,22.0,1999.0,0.0,0,0,0,0,0,0,0,,0,1,0,1,0,0,0,0,Matches,2021-2022,Ligue-1
Nicholas Gioacchini,us USA,"FW,MF",Montpellier,21.0,2000.0,5.5,7,5,3,2,2,4,10,40.0,6,8,0,8,4,11,5,0,Matches,2021-2022,Ligue-1
Jimmy Giraudon,fr FRA,DF,Troyes,29.0,1992.0,18.0,14,6,10,4,0,7,22,31.8,15,24,14,10,37,51,68,1,Matches,2021-2022,Ligue-1
Andrei Girotto,br BRA,"DF,MF",Nantes,29.0,1992.0,35.0,85,52,49,32,4,52,103,50.5,51,67,33,34,69,154,143,0,Matches,2021-2022,Ligue-1
Aleksandr Golovin,ru RUS,"FW,MF",Monaco,25.0,1996.0,16.7,40,22,10,18,12,18,41,43.9,23,26,1,25,12,52,8,0,Matches,2021-2022,Ligue-1
Angel Gomes,eng ENG,"MF,FW",Lille,20.0,2000.0,10.6,23,13,6,12,5,10,15,66.7,5,4,0,4,3,26,4,0,Matches,2021-2022,Ligue-1
Alfred Gomis,sn SEN,GK,Rennes,27.0,1993.0,25.0,1,0,1,0,0,1,2,50.0,1,0,0,0,1,2,8,2,Matches,2021-2022,Ligue-1
Vagner Gonçalves,cv CPV,FW,Metz,25.0,1996.0,1.0,2,1,0,2,0,1,1,100.0,0,0,0,0,1,3,0,0,Matches,2021-2022,Ligue-1
Álvaro González,es ESP,DF,Marseille,31.0,1990.0,5.0,1,1,1,0,0,1,1,100.0,0,0,0,0,1,2,9,0,Matches,2021-2022,Ligue-1
Amine Gouiri,dz ALG,"FW,MF",Nice,21.0,2000.0,30.6,22,13,2,13,7,10,32,31.3,22,22,5,17,11,33,17,1,Matches,2021-2022,Ligue-1
Lucas Gourna-Douath,fr FRA,MF,Saint-Étienne,17.0,2003.0,20.0,45,26,22,18,5,21,36,58.3,15,22,3,19,13,58,9,2,Matches,2021-2022,Ligue-1
Jonathan Gradit,fr FRA,DF,Lens,28.0,1992.0,34.1,60,28,24,28,8,25,45,55.6,20,39,27,12,65,125,106,0,Matches,2021-2022,Ligue-1
Andrew Gravillon,gp GLP,DF,Reims,23.0,1998.0,23.7,32,24,19,13,0,17,27,63.0,10,25,15,10,33,65,83,1,Matches,2021-2022,Ligue-1
Adrian Grbić,at AUT,"FW,MF",Lorient,24.0,1996.0,5.8,2,1,0,2,0,2,6,33.3,4,3,1,2,0,2,7,0,Matches,2021-2022,Ligue-1
Ivo Grbić,hr CRO,GK,Lille,25.0,1996.0,21.0,0,0,0,0,0,0,0,,0,0,0,0,0,0,14,1,Matches,2021-2022,Ligue-1
Etienne Green,eng ENG,GK,Saint-Étienne,21.0,2000.0,13.3,1,1,1,0,0,0,0,,0,0,0,0,1,2,9,0,Matches,2021-2022,Ligue-1
Gabriel Gudmundsson,se SWE,"DF,MF",Lille,22.0,1999.0,14.9,43,31,24,16,3,17,35,48.6,18,15,3,12,20,63,13,0,Matches,2021-2022,Ligue-1
Noah Guede-Nadje,fr FRA,MF,Angers,17.0,2003.0,0.0,0,0,0,0,0,0,0,,0,0,0,0,0,0,0,0,Matches,2021-2022,Ligue-1
Mattéo Guendouzi,fr FRA,MF,Marseille,22.0,1999.0,35.0,45,30,10,26,9,13,47,27.7,34,15,1,14,16,61,18,0,Matches,2021-2022,Ligue-1
Yanis Guermouche,fr FRA,"MF,FW",Montpellier,20.0,2001.0,0.1,2,1,0,1,1,1,1,100.0,0,0,0,0,0,2,0,0,Matches,2021-2022,Ligue-1
Evann Guessand,ci CIV,FW,Nice,20.0,2001.0,4.9,9,8,2,5,2,3,8,37.5,5,4,0,4,0,9,1,0,Matches,2021-2022,Ligue-1
Lamine Gueye,sn SEN,"FW,MF",Metz,23.0,1998.0,6.2,5,5,1,1,3,3,7,42.9,4,4,0,4,6,11,1,0,Matches,2021-2022,Ligue-1
Pape Gueye,sn SEN,MF,Marseille,22.0,1999.0,17.0,38,19,15,22,1,16,31,51.6,15,15,3,12,24,62,16,0,Matches,2021-2022,Ligue-1
Josuha Guilavogui,fr FRA,"MF,DF",Bordeaux,30.0,1990.0,14.8,39,16,18,17,4,14,29,48.3,15,16,8,8,36,75,23,0,Matches,2021-2022,Ligue-1
Frederic Guilbert,fr FRA,DF,Strasbourg,26.0,1994.0,28.0,69,39,33,24,12,32,62,51.6,30,37,11,26,55,124,39,0,Matches,2021-2022,Ligue-1
Bruno Guimarães,br BRA,MF,Lyon,23.0,1997.0,18.2,50,31,20,25,5,23,59,39.0,36,21,4,17,21,71,11,1,Matches,2021-2022,Ligue-1
Serhou Guirassy,gn GUI,FW,Rennes,25.0,1996.0,11.3,4,2,1,2,1,1,7,14.3,6,4,0,4,1,5,8,0,Matches,2021-2022,Ligue-1
Malo Gusto,fr FRA,DF,Lyon,18.0,2003.0,20.9,55,35,29,21,5,24,40,60.0,16,21,6,15,33,88,41,1,Matches,2021-2022,Ligue-1
Massadio Haïdara,ml MLI,DF,Lens,28.0,1992.0,12.0,28,21,18,7,3,15,24,62.5,9,18,4,14,22,50,31,0,Matches,2021-2022,Ligue-1
Oualid El Hajjam,ma MAR,DF,Troyes,30.0,1991.0,11.9,22,11,12,6,4,15,23,65.2,8,12,6,6,22,44,28,0,Matches,2021-2022,Ligue-1
Achraf Hakimi,ma MAR,DF,Paris S-G,22.0,1998.0,27.5,74,51,38,27,9,40,72,55.6,32,26,5,21,28,102,23,2,Matches,2021-2022,Ligue-1
Pierre-Yves Hamel,fr FRA,"FW,MF",Lorient,27.0,1994.0,0.3,0,0,0,0,0,0,1,0.0,1,0,0,0,2,2,0,0,Matches,2021-2022,Ligue-1
Pierre-Yves Hamel,fr FRA,FW,Clermont Foot,27.0,1994.0,5.8,11,6,0,5,6,5,6,83.3,1,2,1,1,0,11,0,0,Matches,2021-2022,Ligue-1
Romain Hamouma,fr FRA,"FW,MF",Saint-Étienne,34.0,1987.0,9.8,10,7,1,5,4,2,13,15.4,11,8,0,8,4,14,1,0,Matches,2021-2022,Ligue-1
Amine Harit,ma MAR,"FW,MF",Marseille,24.0,1997.0,12.9,18,11,9,9,0,9,17,52.9,8,10,0,10,4,22,2,0,Matches,2021-2022,Ligue-1
Henrique,br BRA,DF,Lyon,27.0,1994.0,12.3,13,7,10,1,2,5,16,31.3,11,13,1,12,22,35,14,0,Matches,2021-2022,Ligue-1
Luis Henrique,br BRA,"FW,MF",Marseille,19.0,2001.0,7.8,4,3,2,1,1,2,5,40.0,3,2,0,2,5,9,1,0,Matches,2021-2022,Ligue-1
Christophe Hérelle,mq MTQ,DF,Brest,28.0,1992.0,21.5,48,28,30,16,2,17,26,65.4,9,20,15,5,44,92,84,1,Matches,2021-2022,Ligue-1
Jérôme Hergault,fr FRA,DF,Lorient,35.0,1986.0,3.9,3,1,1,2,0,2,5,40.0,3,4,1,3,4,7,7,0,Matches,2021-2022,Ligue-1
Ander Herrera,es ESP,MF,Paris S-G,31.0,1989.0,12.1,29,17,7,16,6,14,39,35.9,25,22,8,14,14,43,8,0,Matches,2021-2022,Ligue-1
Franck Honorat,fr FRA,"FW,MF",Brest,24.0,1996.0,32.2,54,38,25,13,16,27,47,57.4,20,24,2,22,15,69,25,0,Matches,2021-2022,Ligue-1
Fraser Hornby,sct SCO,"FW,MF",Reims,21.0,1999.0,3.9,3,1,1,2,0,0,2,0.0,2,3,0,3,4,7,5,0,Matches,2021-2022,Ligue-1
Cédric Hountondji,bj BEN,DF,Clermont Foot,27.0,1994.0,22.6,33,17,20,12,1,16,24,66.7,8,23,12,11,34,67,76,0,Matches,2021-2022,Ligue-1
Suk Hyun-jun,kr KOR,"FW,MF",Troyes,30.0,1991.0,1.7,0,0,0,0,0,0,0,,0,2,0,2,0,0,2,0,Matches,2021-2022,Ligue-1
Mauro Icardi,ar ARG,FW,Paris S-G,28.0,1993.0,11.4,5,3,1,3,1,3,7,42.9,4,3,0,3,5,10,12,0,Matches,2021-2022,Ligue-1
Jonathan Iglesias,uy URU,MF,Clermont Foot,32.0,1988.0,6.4,18,11,6,10,2,10,18,55.6,8,8,2,6,5,23,2,1,Matches,2021-2022,Ligue-1
Juan Ignacio Ramírez,uy URU,FW,Saint-Étienne,24.0,1997.0,1.4,2,1,0,1,1,0,0,,0,0,0,0,0,2,0,0,Matches,2021-2022,Ligue-1
Danylo Ihnatenko,ua UKR,MF,Bordeaux,24.0,1997.0,7.7,17,9,8,7,2,10,24,41.7,14,9,2,7,6,23,17,1,Matches,2021-2022,Ligue-1
Jonathan Ikone,fr FRA,"MF,FW",Lille,23.0,1998.0,11.8,11,3,6,4,1,4,11,36.4,7,13,1,12,5,16,4,0,Matches,2021-2022,Ligue-1
Bonke Innocent,ng NGA,MF,Lorient,25.0,1996.0,9.7,27,16,10,16,1,11,26,42.3,15,11,3,8,16,43,14,0,Matches,2021-2022,Ligue-1
Wilson Isidor,fr FRA,"FW,MF",Monaco,20.0,2000.0,0.6,0,0,0,0,0,0,4,0.0,4,1,0,1,0,0,0,0,Matches,2021-2022,Ligue-1
Ismail Jakobs,sn SEN,"DF,FW",Monaco,21.0,1999.0,13.4,32,16,14,15,3,16,35,45.7,19,16,1,15,17,49,31,0,Matches,2021-2022,Ligue-1
Marin Jakoliš,hr CRO,FW,Angers,24.0,1996.0,2.5,2,1,0,1,1,0,6,0.0,6,0,0,0,1,3,0,0,Matches,2021-2022,Ligue-1
Abdel Jalil Medioub,dz ALG,DF,Bordeaux,23.0,1997.0,6.9,9,5,5,3,1,3,4,75.0,1,8,4,4,12,21,34,0,Matches,2021-2022,Ligue-1
Léo Jardim,br BRA,GK,Lille,26.0,1995.0,17.0,0,0,0,0,0,0,0,,0,0,0,0,1,1,10,0,Matches,2021-2022,Ligue-1
Corentin Jean,fr FRA,"FW,MF",Lens,26.0,1995.0,2.8,9,6,4,4,1,3,6,50.0,3,5,0,5,1,10,0,0,Matches,2021-2022,Ligue-1
Jemerson,br BRA,DF,Metz,28.0,1992.0,13.4,37,25,30,7,0,18,26,69.2,8,23,8,15,25,62,33,1,Matches,2021-2022,Ligue-1
Moritz Jenz,de GER,DF,Lorient,22.0,1999.0,15.3,26,12,18,6,2,11,24,45.8,13,19,11,8,28,54,55,0,Matches,2021-2022,Ligue-1
Lenny Joseph,fr FRA,"FW,MF",Metz,20.0,2000.0,1.7,2,1,1,1,0,0,0,,0,3,0,3,0,2,0,0,Matches,2021-2022,Ligue-1
Issa Kaboré,bf BFA,"DF,MF",Troyes,20.0,2001.0,25.0,45,22,22,14,9,20,38,52.6,18,27,2,25,20,65,38,1,Matches,2021-2022,Ligue-1
Tino Kadewere,zw ZIM,FW,Lyon,25.0,1996.0,5.6,7,5,2,2,3,4,13,30.8,9,7,0,7,4,11,1,1,Matches,2021-2022,Ligue-1
Gaël Kakuta,cd COD,"MF,FW",Lens,30.0,1991.0,18.6,22,14,2,13,7,4,20,20.0,16,10,0,10,4,26,3,0,Matches,2021-2022,Ligue-1
Arnaud Kalimuendo,fr FRA,FW,Lens,19.0,2002.0,23.9,9,8,1,3,5,2,7,28.6,5,6,1,5,8,17,0,0,Matches,2021-2022,Ligue-1
Arnaud Kalimuendo,fr FRA,FW,Paris S-G,19.0,2002.0,0.1,0,0,0,0,0,0,0,,0,0,0,0,0,0,0,0,Matches,2021-2022,Ligue-1
Samuel Kalu,ng NGA,"FW,MF",Bordeaux,23.0,1997.0,3.6,8,5,3,4,1,2,5,40.0,3,2,0,2,3,11,1,0,Matches,2021-2022,Ligue-1
Boubacar Kamara,fr FRA,"MF,DF",Marseille,21.0,1999.0,30.9,68,38,27,36,5,26,47,55.3,21,29,10,19,46,114,44,1,Matches,2021-2022,Ligue-1
Hassane Kamara,ci CIV,"MF,DF",Nice,27.0,1994.0,6.0,13,10,4,6,3,5,8,62.5,3,10,2,8,9,22,4,0,Matches,2021-2022,Ligue-1
Jean-Armel Kana-Biyik,cm CMR,DF,Metz,32.0,1989.0,7.4,10,6,8,2,0,4,9,44.4,5,11,4,7,16,26,22,1,Matches,2021-2022,Ligue-1
Nordine Kandil,fr FRA,"MF,FW",Strasbourg,19.0,2001.0,1.0,2,1,2,0,0,1,1,100.0,0,1,1,0,0,2,0,0,Matches,2021-2022,Ligue-1
Eiji Kawashima,jp JPN,GK,Strasbourg,38.0,1983.0,1.0,0,0,0,0,0,0,0,,0,0,0,0,0,0,0,0,Matches,2021-2022,Ligue-1
Ilan Kebbal,dz ALG,"MF,FW",Reims,23.0,1998.0,19.7,31,15,13,10,8,12,44,27.3,32,16,0,16,13,44,3,0,Matches,2021-2022,Ligue-1
Thilo Kehrer,de GER,DF,Paris S-G,24.0,1996.0,16.8,21,14,9,11,1,9,21,42.9,12,19,11,8,24,45,29,0,Matches,2021-2022,Ligue-1
Habib Keita,ml MLI,"MF,FW",Lyon,19.0,2002.0,0.1,0,0,0,0,0,0,0,,0,0,0,0,0,0,0,0,Matches,2021-2022,Ligue-1
Saîf-Eddine Khaoui,tn TUN,"MF,FW",Clermont Foot,26.0,1995.0,10.3,19,10,5,10,4,9,18,50.0,9,9,0,9,14,33,5,0,Matches,2021-2022,Ligue-1
Wahbi Khazri,tn TUN,"FW,MF",Saint-Étienne,30.0,1991.0,24.7,33,18,7,17,9,9,34,26.5,25,21,0,21,12,45,7,0,Matches,2021-2022,Ligue-1
Presnel Kimpembe,fr FRA,DF,Paris S-G,25.0,1995.0,28.6,34,19,18,15,1,14,23,60.9,9,20,14,6,38,72,73,1,Matches,2021-2022,Ligue-1
Thibault Klidje,tg TOG,"MF,FW",Bordeaux,20.0,2001.0,1.0,0,0,0,0,0,0,1,0.0,1,1,1,0,2,2,0,0,Matches,2021-2022,Ligue-1
Justin Kluivert,nl NED,MF,Nice,22.0,1999.0,20.8,19,9,6,12,1,5,21,23.8,16,13,1,12,14,33,6,0,Matches,2021-2022,Ligue-1
Samuel Koeberlé,fr FRA,FW,Reims,16.0,2004.0,0.0,0,0,0,0,0,0,0,,0,0,0,0,0,0,0,0,Matches,2021-2022,Ligue-1
Philippe Koffi,ci CIV,FW,Reims,19.0,2002.0,4.2,4,0,0,3,1,0,2,0.0,2,2,1,1,3,7,3,0,Matches,2021-2022,Ligue-1
Sead Kolašinac,ba BIH,DF,Marseille,28.0,1993.0,4.9,7,6,2,3,2,5,8,62.5,3,4,0,4,0,7,7,1,Matches,2021-2022,Ligue-1
Randal Kolo Muani,fr FRA,"FW,MF",Nantes,22.0,1998.0,32.8,28,14,7,10,11,10,25,40.0,15,14,3,11,6,34,31,0,Matches,2021-2022,Ligue-1
Timothée Kolodziejczak,fr FRA,DF,Saint-Étienne,29.0,1991.0,28.5,43,24,22,14,7,20,36,55.6,16,29,7,22,60,103,72,1,Matches,2021-2022,Ligue-1
Ghislain Konan,ci CIV,DF,Reims,25.0,1995.0,26.9,35,19,19,15,1,16,30,53.3,14,35,8,27,28,63,45,0,Matches,2021-2022,Ligue-1
Ibrahima Koné,ml MLI,FW,Lorient,22.0,1999.0,8.1,7,4,0,3,4,2,3,66.7,1,8,3,5,1,8,3,0,Matches,2021-2022,Ligue-1
Youssouf Koné,ml MLI,DF,Troyes,26.0,1995.0,10.9,30,18,21,8,1,19,30,63.3,11,8,3,5,10,40,25,0,Matches,2021-2022,Ligue-1
Laurent Koscielny,fr FRA,DF,Bordeaux,35.0,1985.0,10.4,14,9,10,3,1,8,13,61.5,5,17,12,5,12,26,39,0,Matches,2021-2022,Ligue-1
Rominigue Kouamé,ml MLI,MF,Troyes,24.0,1996.0,33.0,47,22,24,20,3,19,58,32.8,39,33,5,28,46,93,22,2,Matches,2021-2022,Ligue-1
Boubakar Kouyaté,ml MLI,DF,Metz,24.0,1997.0,29.6,84,50,56,28,0,48,77,62.3,29,63,33,30,79,163,217,3,Matches,2021-2022,Ligue-1
Jean-Philippe Krasso,ci CIV,FW,Saint-Étienne,24.0,1997.0,5.0,7,5,0,5,2,2,10,20.0,8,7,1,6,0,7,1,0,Matches,2021-2022,Ligue-1
Mykola Kukharevych,ua UKR,FW,Troyes,20.0,2001.0,0.2,0,0,0,0,0,0,0,,0,0,0,0,0,0,0,0,Matches,2021-2022,Ligue-1
Enock Kwateng,fr FRA,DF,Bordeaux,24.0,1997.0,22.2,54,35,31,19,4,33,72,45.8,39,17,4,13,43,97,48,1,Matches,2021-2022,Ligue-1
Grejohn Kyei,fr FRA,FW,Clermont Foot,25.0,1995.0,4.4,3,2,1,1,1,0,6,0.0,6,6,0,6,0,3,1,0,Matches,2021-2022,Ligue-1
Gaëtan Laborde,fr FRA,FW,Montpellier,27.0,1994.0,3.8,2,2,1,1,0,2,4,50.0,2,3,0,3,5,7,5,0,Matches,2021-2022,Ligue-1
Gaëtan Laborde,fr FRA,FW,Rennes,27.0,1994.0,30.3,19,7,5,8,6,3,22,13.6,19,29,3,26,8,27,16,0,Matches,2021-2022,Ligue-1
Tom Lacoux,fr FRA,"DF,MF",Bordeaux,19.0,2002.0,10.1,18,13,11,5,2,9,24,37.5,15,14,4,10,9,27,20,1,Matches,2021-2022,Ligue-1
Lenny Lacroix,fr FRA,DF,Metz,18.0,2003.0,2.2,9,7,8,1,0,5,8,62.5,3,5,1,4,10,19,5,0,Matches,2021-2022,Ligue-1
Alban Lafont,fr FRA,GK,Nantes,22.0,1999.0,38.0,3,3,3,0,0,3,8,37.5,5,1,0,1,1,4,25,2,Matches,2021-2022,Ligue-1
Mohamed Lamine Bayo,gn GUI,FW,Clermont Foot,23.0,1998.0,26.8,12,5,4,3,5,3,24,12.5,21,7,1,6,7,19,14,0,Matches,2021-2022,Ligue-1
Didier Lamkel Zé,cm CMR,FW,Metz,24.0,1996.0,6.7,3,1,1,0,2,1,3,33.3,2,3,1,2,1,4,7,0,Matches,2021-2022,Ligue-1
Julien Laporte,fr FRA,DF,Lorient,27.0,1993.0,32.1,63,45,35,26,2,32,64,50.0,32,37,22,15,54,117,174,0,Matches,2021-2022,Ligue-1
Yasser Larouci,dz ALG,DF,Troyes,20.0,2001.0,3.8,6,5,2,4,0,3,3,100.0,0,1,0,1,7,13,5,0,Matches,2021-2022,Ligue-1
Paul Lasne,fr FRA,MF,Brest,32.0,1989.0,9.4,26,12,6,16,4,8,18,44.4,10,11,2,9,24,50,10,0,Matches,2021-2022,Ligue-1
Armand Lauriente,fr FRA,"FW,MF",Lorient,22.0,1998.0,27.5,33,18,9,16,8,11,30,36.7,19,27,2,25,15,48,3,0,Matches,2021-2022,Ligue-1
Théo Le Bris,fr FRA,MF,Lorient,18.0,2002.0,0.7,2,1,1,1,0,1,2,50.0,1,2,0,2,0,2,1,0,Matches,2021-2022,Ligue-1
Jérémy Le Douaron,fr FRA,"FW,MF",Brest,23.0,1998.0,16.1,11,5,4,4,3,1,17,5.9,16,15,0,15,4,15,14,0,Matches,2021-2022,Ligue-1
Enzo Le Fée,fr FRA,"MF,FW",Lorient,21.0,2000.0,24.4,70,44,25,36,9,41,90,45.6,49,25,1,24,29,99,18,0,Matches,2021-2022,Ligue-1
Vincent Le Goff,fr FRA,DF,Lorient,31.0,1989.0,34.0,61,38,38,19,4,37,62,59.7,25,18,3,15,37,98,50,0,Matches,2021-2022,Ligue-1
Maxime Le Marchand,fr FRA,DF,Strasbourg,31.0,1989.0,9.6,17,8,16,1,0,8,10,80.0,2,9,5,4,14,31,32,0,Matches,2021-2022,Ligue-1
Jean-Louis Leca,fr FRA,GK,Lens,35.0,1985.0,25.7,0,0,0,0,0,0,0,,0,1,0,1,1,1,11,1,Matches,2021-2022,Ligue-1
Félix Lemaréchal,fr FRA,MF,Monaco,17.0,2003.0,0.1,0,0,0,0,0,0,1,0.0,1,0,0,0,0,0,0,0,Matches,2021-2022,Ligue-1
Mario Lemina,ga GAB,MF,Nice,27.0,1993.0,21.9,62,35,25,33,4,28,38,73.7,10,32,9,23,48,110,37,0,Matches,2021-2022,Ligue-1
Fabien Lemoine,fr FRA,MF,Lorient,34.0,1987.0,12.4,35,22,20,14,1,17,41,41.5,24,21,4,17,14,49,24,1,Matches,2021-2022,Ligue-1
Léo Leroy,fr FRA,MF,Montpellier,21.0,2000.0,7.0,31,21,17,11,3,12,34,35.3,22,20,4,16,8,39,8,0,Matches,2021-2022,Ligue-1
Alexandre Letellier,fr FRA,GK,Paris S-G,30.0,1990.0,0.1,0,0,0,0,0,0,0,,0,0,0,0,0,0,0,0,Matches,2021-2022,Ligue-1
Yanis Lhery,fr FRA,"FW,MF",Saint-Étienne,18.0,2003.0,0.8,0,0,0,0,0,0,0,,0,4,0,4,0,0,0,0,Matches,2021-2022,Ligue-1
Dimitri Liénard,fr FRA,"DF,MF",Strasbourg,33.0,1988.0,22.7,71,43,40,21,10,46,77,59.7,31,12,0,12,21,92,28,0,Matches,2021-2022,Ligue-1
Isaac Lihadji,fr FRA,"MF,FW",Lille,19.0,2002.0,2.6,3,3,1,1,1,1,5,20.0,4,1,0,1,2,5,0,0,Matches,2021-2022,Ligue-1
Pol Lirola,es ESP,"DF,FW",Marseille,23.0,1997.0,19.7,28,16,15,9,4,13,28,46.4,15,15,0,15,13,41,22,0,Matches,2021-2022,Ligue-1
Bradley Locko,fr FRA,"MF,DF",Reims,19.0,2002.0,11.2,28,19,13,11,4,14,24,58.3,10,20,8,12,14,42,15,0,Matches,2021-2022,Ligue-1
Anthony Lopes,pt POR,GK,Lyon,30.0,1990.0,33.1,0,0,0,0,0,0,0,,0,0,0,0,3,3,12,3,Matches,2021-2022,Ligue-1
Pau López,es ESP,GK,Marseille,26.0,1994.0,29.0,0,0,0,0,0,0,1,0.0,1,0,0,0,0,0,12,1,Matches,2021-2022,Ligue-1
Dion Lopy,sn SEN,MF,Reims,19.0,2002.0,18.2,53,29,22,24,7,21,53,39.6,32,20,4,16,22,75,17,0,Matches,2021-2022,Ligue-1
Samuel Loric,fr FRA,DF,Lorient,21.0,2000.0,3.0,7,5,2,3,2,5,8,62.5,3,2,0,2,5,12,9,0,Matches,2021-2022,Ligue-1
Jordan Lotomba,ch SUI,DF,Nice,22.0,1998.0,19.8,33,17,21,9,3,16,30,53.3,14,17,4,13,12,45,28,0,Matches,2021-2022,Ligue-1
Johaneko Louisjean,fr FRA,DF,Bordeaux,17.0,2004.0,0.1,0,0,0,0,0,0,0,,0,0,0,0,0,0,0,0,Matches,2021-2022,Ligue-1
Jean Lucas,br BRA,MF,Monaco,23.0,1998.0,16.1,43,25,14,24,5,17,40,42.5,23,15,5,10,13,56,4,1,Matches,2021-2022,Ligue-1
Castello Lukeba,fr FRA,DF,Lyon,18.0,2002.0,23.3,34,19,27,7,0,15,23,65.2,8,18,9,9,38,72,64,2,Matches,2021-2022,Ligue-1
Levi Lumeka,eng ENG,"DF,FW",Troyes,22.0,1998.0,0.7,0,0,0,0,0,0,2,0.0,2,0,0,0,0,0,2,0,Matches,2021-2022,Ligue-1
Yannis M'Bemba,ga GAB,"DF,FW",Nantes,20.0,2001.0,0.1,0,0,0,0,0,0,0,,0,0,0,0,0,0,1,0,Matches,2021-2022,Ligue-1
Deiver Machado,co COL,"DF,MF",Lens,27.0,1993.0,5.8,16,14,11,1,4,12,14,85.7,2,9,1,8,3,19,12,1,Matches,2021-2022,Ligue-1
Yvann Macon,fr FRA,DF,Saint-Étienne,22.0,1998.0,17.0,41,22,24,14,3,16,42,38.1,26,18,4,14,18,59,27,0,Matches,2021-2022,Ligue-1
Louis Mafouta,cf CTA,FW,Metz,27.0,1994.0,5.8,0,0,0,0,0,0,5,0.0,5,1,0,1,0,0,4,0,Matches,2021-2022,Ligue-1
Hugo Magnetti,fr FRA,MF,Brest,23.0,1998.0,16.3,50,34,27,20,3,22,50,44.0,28,14,3,11,25,75,13,0,Matches,2021-2022,Ligue-1
Yohann Magnin,fr FRA,"MF,DF",Clermont Foot,24.0,1997.0,19.1,53,31,22,26,5,24,42,57.1,18,17,7,10,20,73,36,0,Matches,2021-2022,Ligue-1
Habib Maïga,ci CIV,MF,Metz,25.0,1996.0,14.1,47,28,29,13,5,24,48,50.0,24,20,7,13,14,61,18,0,Matches,2021-2022,Ligue-1
Josh Maja,ng NGA,FW,Bordeaux,22.0,1998.0,0.1,0,0,0,0,0,0,0,,0,1,0,1,0,0,0,0,Matches,2021-2022,Ligue-1
Abdul Majeed Waris,gh GHA,"FW,MF",Strasbourg,29.0,1991.0,3.6,5,3,2,3,0,5,10,50.0,5,2,0,2,0,5,1,0,Matches,2021-2022,Ligue-1
Lovro Majer,hr CRO,"MF,FW",Rennes,23.0,1998.0,20.4,32,21,9,14,9,11,42,26.2,31,26,2,24,11,43,9,0,Matches,2021-2022,Ligue-1
Béni Makouana,cg CGO,"FW,MF",Montpellier,18.0,2002.0,3.6,2,2,0,0,2,0,1,0.0,1,1,0,1,3,5,2,0,Matches,2021-2022,Ligue-1
Hianga Mananga Mbock,fr FRA,MF,Brest,21.0,1999.0,8.9,18,12,8,7,3,9,21,42.9,12,5,2,3,5,23,6,0,Matches,2021-2022,Ligue-1
Vincent Manceau,fr FRA,DF,Angers,32.0,1989.0,26.2,32,19,18,13,1,14,37,37.8,23,23,6,17,32,64,72,0,Matches,2021-2022,Ligue-1
Steve Mandanda,fr FRA,GK,Marseille,36.0,1985.0,9.0,0,0,0,0,0,0,1,0.0,1,1,0,1,1,1,4,1,Matches,2021-2022,Ligue-1
Reinildo Mandava,mz MOZ,DF,Lille,27.0,1994.0,16.9,43,23,29,11,3,32,51,62.7,19,13,4,9,37,80,55,0,Matches,2021-2022,Ligue-1
Anthony Mandrea,dz ALG,GK,Angers,24.0,1996.0,10.0,0,0,0,0,0,0,0,,0,0,0,0,0,0,9,0,Matches,2021-2022,Ligue-1
Eliaquim Mangala,fr FRA,DF,Saint-Étienne,30.0,1991.0,13.1,17,12,12,5,0,8,12,66.7,4,11,8,3,17,34,61,1,Matches,2021-2022,Ligue-1
Thomas Mangani,fr FRA,MF,Angers,34.0,1987.0,24.4,58,30,23,34,1,31,68,45.6,37,38,11,27,36,94,29,0,Matches,2021-2022,Ligue-1
Ricardo Mangas,pt POR,DF,Bordeaux,23.0,1998.0,26.1,35,22,22,8,5,26,41,63.4,15,18,4,14,25,60,47,3,Matches,2021-2022,Ligue-1
Myziane Maolida,km COM,MF,Nice,22.0,1999.0,0.4,1,0,0,1,0,0,0,,0,1,0,1,0,1,0,0,Matches,2021-2022,Ligue-1
Sekou Mara,fr FRA,"FW,MF",Bordeaux,19.0,2002.0,10.1,8,4,1,1,6,1,8,12.5,7,7,0,7,2,10,6,0,Matches,2021-2022,Ligue-1
Marcelo,br BRA,DF,Bordeaux,34.0,1987.0,10.0,9,5,7,2,0,4,6,66.7,2,4,3,1,13,22,46,1,Matches,2021-2022,Ligue-1
Marcelo,br BRA,DF,Lyon,34.0,1987.0,2.0,4,3,0,4,0,4,6,66.7,2,3,2,1,4,8,10,0,Matches,2021-2022,Ligue-1
Guillermo Maripán,cl CHI,DF,Monaco,27.0,1994.0,20.4,36,24,27,9,0,20,40,50.0,20,21,14,7,25,61,66,1,Matches,2021-2022,Ligue-1
Marquinhos,br BRA,DF,Paris S-G,27.0,1994.0,31.8,37,14,25,11,1,20,35,57.1,15,35,19,16,16,53,102,0,Matches,2021-2022,Ligue-1
Jonas Martin,fr FRA,MF,Rennes,31.0,1990.0,23.4,35,20,12,21,2,19,53,35.8,34,17,3,14,22,57,28,1,Matches,2021-2022,Ligue-1
Gelson Martins,pt POR,"MF,FW",Monaco,26.0,1995.0,21.2,42,27,10,26,6,21,59,35.6,38,26,1,25,17,59,4,0,Matches,2021-2022,Ligue-1
Pape Matar Sarr,sn SEN,MF,Metz,18.0,2002.0,23.7,45,26,21,23,1,18,39,46.2,21,33,3,30,29,74,22,0,Matches,2021-2022,Ligue-1
Eliot Matazo,be BEL,MF,Monaco,19.0,2002.0,8.8,8,7,4,4,0,2,11,18.2,9,11,3,8,13,21,9,0,Matches,2021-2022,Ligue-1
Chrislain Matsima,fr FRA,DF,Monaco,19.0,2002.0,1.5,3,2,1,2,0,2,7,28.6,5,3,3,0,1,4,6,1,Matches,2021-2022,Ligue-1
Azor Matusiwa,nl NED,MF,Reims,23.0,1998.0,27.4,58,32,28,26,4,26,55,47.3,29,49,19,30,62,120,43,0,Matches,2021-2022,Ligue-1
Stephy Mavididi,eng ENG,"FW,MF",Montpellier,23.0,1998.0,25.5,24,13,11,7,6,14,39,35.9,25,23,2,21,8,32,11,0,Matches,2021-2022,Ligue-1
Derek Mazou-Sacko,fr FRA,"FW,DF",Troyes,16.0,2004.0,0.0,1,0,0,0,1,1,1,100.0,0,0,0,0,0,1,1,0,Matches,2021-2022,Ligue-1
Kylian Mbappé,fr FRA,FW,Paris S-G,22.0,1998.0,33.6,11,8,1,4,6,7,13,53.8,6,6,0,6,5,16,13,0,Matches,2021-2022,Ligue-1
Amadou Mbengue,sn SEN,"DF,MF",Metz,19.0,2002.0,6.8,19,10,10,9,0,11,22,50.0,11,7,2,5,10,29,19,0,Matches,2021-2022,Ligue-1
Jason Mbock,fr FRA,FW,Angers,21.0,1999.0,0.2,0,0,0,0,0,0,0,,0,0,0,0,0,0,0,0,Matches,2021-2022,Ligue-1
Moustapha Mbow,sn SEN,DF,Reims,21.0,2000.0,1.0,6,6,3,2,1,3,3,100.0,0,0,0,0,1,7,6,0,Matches,2021-2022,Ligue-1
Nathanael Mbuku,cd COD,"FW,MF",Reims,19.0,2002.0,15.8,14,13,4,7,3,2,8,25.0,6,14,0,14,11,25,4,0,Matches,2021-2022,Ligue-1
Facundo Medina,ar ARG,DF,Lens,22.0,1999.0,28.8,61,42,34,23,4,38,62,61.3,24,24,8,16,37,98,78,3,Matches,2021-2022,Ligue-1
Farid El Melali,dz ALG,FW,Angers,24.0,1997.0,0.2,0,0,0,0,0,0,1,0.0,1,1,0,1,0,0,1,0,Matches,2021-2022,Ligue-1
Birger Meling,no NOR,DF,Rennes,26.0,1994.0,20.3,43,27,25,11,7,23,31,74.2,8,23,7,16,22,65,40,0,Matches,2021-2022,Ligue-1
Houboulang Mendes,gw GNB,DF,Lorient,23.0,1998.0,35.8,58,28,37,18,3,40,57,70.2,17,41,21,20,41,99,128,4,Matches,2021-2022,Ligue-1
Nuno Mendes,pt POR,DF,Paris S-G,19.0,2002.0,18.4,48,29,23,18,7,25,47,53.2,22,27,5,22,21,69,17,1,Matches,2021-2022,Ligue-1
Pedro Mendes,pt POR,DF,Montpellier,30.0,1990.0,0.2,1,1,1,0,0,0,0,,0,1,1,0,0,1,2,0,Matches,2021-2022,Ligue-1
Thiago Mendes,br BRA,"MF,DF",Lyon,29.0,1992.0,20.7,36,22,18,16,2,12,30,40.0,18,24,5,19,34,70,56,1,Matches,2021-2022,Ligue-1
Arial Mendy,sn SEN,"DF,FW",Clermont Foot,26.0,1994.0,8.8,6,4,4,2,0,2,11,18.2,9,6,1,5,7,13,17,0,Matches,2021-2022,Ligue-1
Batista Mendy,fr FRA,"MF,DF",Angers,21.0,2000.0,26.8,49,28,21,22,6,23,45,51.1,22,37,6,31,34,83,40,0,Matches,2021-2022,Ligue-1
Gideon Mensah,gh GHA,DF,Bordeaux,23.0,1998.0,13.4,37,24,19,12,6,18,38,47.4,20,11,2,9,16,53,21,0,Matches,2021-2022,Ligue-1
Quentin Merlin,fr FRA,"DF,MF",Nantes,19.0,2002.0,21.4,45,28,19,20,6,26,49,53.1,23,25,4,21,27,72,29,2,Matches,2021-2022,Ligue-1
Lionel Messi,ar ARG,"FW,MF",Paris S-G,34.0,1987.0,23.9,10,3,1,5,4,3,13,23.1,10,5,0,5,4,14,0,0,Matches,2021-2022,Ligue-1
Mexer,mz MOZ,DF,Bordeaux,32.0,1988.0,13.6,14,10,11,3,0,11,17,64.7,6,12,7,5,21,35,60,2,Matches,2021-2022,Ligue-1
Edouard Michut,fr FRA,MF,Paris S-G,18.0,2003.0,0.8,0,0,0,0,0,0,2,0.0,2,2,0,2,1,1,2,0,Matches,2021-2022,Ligue-1
Georges Mikautadze,ge GEO,FW,Metz,20.0,2000.0,0.0,0,0,0,0,0,0,0,,0,0,0,0,0,0,0,0,Matches,2021-2022,Ligue-1
William Mikelbrencis,fr FRA,DF,Metz,17.0,2004.0,6.8,11,5,6,4,1,6,9,66.7,3,6,3,3,5,16,9,0,Matches,2021-2022,Ligue-1
Arkadiusz Milik,pl POL,FW,Marseille,27.0,1994.0,15.7,9,2,0,5,4,4,18,22.2,14,9,1,8,3,12,10,1,Matches,2021-2022,Ligue-1
Terem Moffi,ng NGA,FW,Lorient,22.0,1999.0,30.1,17,10,3,12,2,9,32,28.1,23,11,2,9,4,21,22,0,Matches,2021-2022,Ligue-1
Dion Moise Sahi,ci CIV,"FW,MF",Strasbourg,19.0,2001.0,1.4,0,0,0,0,0,0,0,,0,1,0,1,1,1,1,0,Matches,2021-2022,Ligue-1
Florent Mollet,fr FRA,"FW,MF",Montpellier,29.0,1991.0,29.2,31,22,14,12,5,14,57,24.6,43,27,4,23,24,55,13,0,Matches,2021-2022,Ligue-1
Thomas Monconduit,fr FRA,MF,Lorient,30.0,1991.0,25.0,41,25,19,17,5,20,57,35.1,37,21,10,11,22,63,51,1,Matches,2021-2022,Ligue-1
Jérémy Morel,mg MAD,DF,Lorient,37.0,1984.0,6.7,13,9,8,4,1,6,6,100.0,0,9,7,2,7,20,31,0,Matches,2021-2022,Ligue-1
Lebo Mothiba,za RSA,"FW,MF",Troyes,25.0,1996.0,5.8,8,4,4,3,1,2,5,40.0,3,3,0,3,2,10,0,0,Matches,2021-2022,Ligue-1
Lebo Mothiba,za RSA,FW,Strasbourg,25.0,1996.0,0.0,0,0,0,0,0,0,0,,0,0,0,0,0,0,0,0,Matches,2021-2022,Ligue-1
Baptiste Mouazan,fr FRA,MF,Lorient,19.0,2001.0,1.1,4,3,2,2,0,1,3,33.3,2,3,0,3,1,5,1,0,Matches,2021-2022,Ligue-1
Aimen Moueffek,fr FRA,MF,Saint-Étienne,20.0,2001.0,4.8,7,4,2,3,2,2,8,25.0,6,3,0,3,2,9,4,0,Matches,2021-2022,Ligue-1
Harold Moukoudi,cm CMR,DF,Saint-Étienne,23.0,1997.0,18.5,25,12,17,8,0,14,25,56.0,11,27,14,13,35,60,48,0,Matches,2021-2022,Ligue-1
Jessy Moulin,fr FRA,GK,Troyes,35.0,1986.0,7.0,0,0,0,0,0,0,0,,0,0,0,0,1,1,7,0,Matches,2021-2022,Ligue-1
Steve Mounié,bj BEN,FW,Brest,26.0,1994.0,25.7,17,6,3,12,2,4,27,14.8,23,13,1,12,6,23,12,0,Matches,2021-2022,Ligue-1
Samuel Moutoussamy,cd COD,MF,Nantes,24.0,1996.0,16.8,48,32,20,20,8,23,62,37.1,39,14,2,12,17,65,16,0,Matches,2021-2022,Ligue-1
Marshall Munetsi,zw ZIM,"MF,DF",Reims,25.0,1996.0,20.9,34,17,21,11,2,17,39,43.6,22,39,13,26,43,77,72,2,Matches,2021-2022,Ligue-1
Junior Mwanga,fr FRA,DF,Bordeaux,18.0,2003.0,1.0,5,2,4,1,0,3,3,100.0,0,1,0,1,0,5,1,0,Matches,2021-2022,Ligue-1
Kévin N'Doram,fr FRA,MF,Metz,25.0,1996.0,13.7,10,8,3,5,2,3,20,15.0,17,24,5,19,19,29,21,0,Matches,2021-2022,Ligue-1
Eric N'Jo,fr FRA,DF,Troyes,17.0,2004.0,1.1,0,0,0,0,0,0,1,0.0,1,1,1,0,2,2,1,0,Matches,2021-2022,Ligue-1
Vital N'Simba,cd COD,DF,Clermont Foot,28.0,1993.0,31.0,66,45,38,23,5,36,63,57.1,27,28,7,21,29,95,30,0,Matches,2021-2022,Ligue-1
Mickael Nade,fr FRA,DF,Saint-Étienne,22.0,1999.0,28.5,57,35,37,18,2,23,38,60.5,15,29,15,14,60,117,84,0,Matches,2021-2022,Ligue-1
Paul Nardi,fr FRA,GK,Lorient,27.0,1994.0,22.0,1,0,1,0,0,1,2,50.0,1,0,0,0,0,1,10,2,Matches,2021-2022,Ligue-1
Keylor Navas,cr CRC,GK,Paris S-G,34.0,1986.0,20.6,0,0,0,0,0,0,0,,0,0,0,0,0,0,5,1,Matches,2021-2022,Ligue-1
Papa Ndiaga Yade,mr MTN,"DF,FW",Metz,21.0,2000.0,7.7,15,10,8,7,0,8,18,44.4,10,4,1,3,10,25,9,0,Matches,2021-2022,Ligue-1
Tanguy Ndombele,fr FRA,MF,Lyon,24.0,1996.0,7.8,25,14,5,17,3,12,19,63.2,7,8,3,5,3,28,6,2,Matches,2021-2022,Ligue-1
Dan Ndoye,ch SUI,"FW,MF",Nice,20.0,2000.0,2.3,0,0,0,0,0,0,2,0.0,2,4,0,4,0,0,0,0,Matches,2021-2022,Ligue-1
Neymar,br BRA,"FW,MF",Paris S-G,29.0,1992.0,20.6,29,19,5,12,12,12,36,33.3,24,9,1,8,4,33,2,1,Matches,2021-2022,Ligue-1
Yvan Neyou,cm CMR,MF,Saint-Étienne,24.0,1997.0,10.4,29,13,14,12,3,9,27,33.3,18,8,3,5,23,52,13,0,Matches,2021-2022,Ligue-1
Opa Nguette,sn SEN,"FW,MF",Metz,27.0,1994.0,11.6,21,14,9,6,6,5,14,35.7,9,13,3,10,2,23,9,0,Matches,2021-2022,Ligue-1
Sikou Niakaté,ml MLI,DF,Metz,22.0,1999.0,7.3,8,7,8,0,0,4,11,36.4,7,5,3,2,27,35,34,0,Matches,2021-2022,Ligue-1
Ibrahima Niane,sn SEN,FW,Metz,22.0,1999.0,17.6,1,1,0,1,0,0,5,0.0,5,6,1,5,3,4,16,0,Matches,2021-2022,Ligue-1
M'Baye Niang,sn SEN,FW,Bordeaux,26.0,1994.0,8.6,4,0,0,2,2,0,4,0.0,4,9,1,8,1,5,4,0,Matches,2021-2022,Ligue-1
Casimir Ninga,td CHA,FW,Angers,28.0,1993.0,4.5,5,1,1,4,0,2,5,40.0,3,2,0,2,1,6,0,0,Matches,2021-2022,Ligue-1
Arnaud Nordin,fr FRA,"FW,MF",Saint-Étienne,23.0,1998.0,20.8,21,11,8,8,5,8,22,36.4,14,19,0,19,6,27,8,0,Matches,2021-2022,Ligue-1
Alexander Nübel,de GER,GK,Monaco,24.0,1996.0,38.0,0,0,0,0,0,0,1,0.0,1,0,0,0,0,0,11,1,Matches,2021-2022,Ligue-1
Gerzino Nyamsi,fr FRA,DF,Strasbourg,24.0,1997.0,33.2,35,21,24,9,2,20,27,74.1,7,25,16,9,25,60,90,1,Matches,2021-2022,Ligue-1
Florent Ogier,fr FRA,DF,Clermont Foot,32.0,1989.0,27.0,31,17,18,12,1,17,31,54.8,14,41,27,14,37,68,89,0,Matches,2021-2022,Ligue-1
Warmed Omari,km COM,DF,Rennes,21.0,2000.0,31.1,33,17,22,10,1,15,23,65.2,8,20,13,7,31,64,94,5,Matches,2021-2022,Ligue-1
Jonas Omlin,ch SUI,GK,Montpellier,27.0,1994.0,28.7,2,1,2,0,0,2,3,66.7,1,0,0,0,0,2,12,3,Matches,2021-2022,Ligue-1
Amadou Onana,be BEL,MF,Lille,19.0,2001.0,15.1,48,31,17,27,4,18,25,72.0,7,10,3,7,30,78,19,0,Matches,2021-2022,Ligue-1
Jean Onana,cm CMR,MF,Bordeaux,21.0,2000.0,20.4,70,49,33,33,4,35,86,40.7,51,37,5,32,36,106,23,1,Matches,2021-2022,Ligue-1
Otávio,br BRA,MF,Bordeaux,27.0,1994.0,12.7,36,23,13,21,2,16,39,41.0,23,9,3,6,18,54,11,0,Matches,2021-2022,Ligue-1
Dango Ouattara,bf BFA,"MF,FW",Lorient,19.0,2002.0,9.0,21,15,9,11,1,11,23,47.8,12,10,1,9,14,35,15,1,Matches,2021-2022,Ligue-1
Remi Oudin,fr FRA,"MF,FW",Bordeaux,24.0,1996.0,19.3,34,18,19,13,2,18,32,56.3,14,14,3,11,27,61,21,0,Matches,2021-2022,Ligue-1
Alexandre Oukidja,dz ALG,GK,Metz,33.0,1988.0,20.8,0,0,0,0,0,0,1,0.0,1,1,0,1,1,1,17,2,Matches,2021-2022,Ligue-1
Azzedine Ounahi,ma MAR,MF,Angers,21.0,2000.0,18.1,39,22,16,22,1,11,40,27.5,29,19,1,18,26,65,13,0,Matches,2021-2022,Ligue-1
Ambroise Oyongo,cm CMR,DF,Montpellier,30.0,1991.0,7.3,13,4,7,4,2,9,15,60.0,6,5,1,4,6,19,17,0,Matches,2021-2022,Ligue-1
Vincent Pajot,fr FRA,MF,Metz,30.0,1990.0,25.7,86,56,35,47,4,20,46,43.5,26,33,6,27,51,137,38,0,Matches,2021-2022,Ligue-1
Nicolas Pallois,fr FRA,DF,Nantes,33.0,1987.0,27.2,51,33,40,11,0,34,59,57.6,25,40,19,21,53,104,116,1,Matches,2021-2022,Ligue-1
Erik Palmer-Brown,us USA,DF,Troyes,24.0,1997.0,19.3,37,22,29,8,0,20,26,76.9,6,26,18,8,34,71,87,1,Matches,2021-2022,Ligue-1
Emerson Palmieri,it ITA,DF,Lyon,26.0,1994.0,25.2,46,25,16,22,8,22,34,64.7,12,23,8,15,27,73,66,0,Matches,2021-2022,Ligue-1
Lucas Paquetá,br BRA,"MF,FW",Lyon,23.0,1997.0,30.0,68,38,24,26,18,17,51,33.3,34,43,5,38,9,77,22,0,Matches,2021-2022,Ligue-1
Rubén Pardo,es ESP,MF,Bordeaux,28.0,1992.0,0.1,0,0,0,0,0,0,0,,0,0,0,0,0,0,0,0,Matches,2021-2022,Ligue-1
Leandro Paredes,ar ARG,MF,Paris S-G,27.0,1994.0,9.3,23,13,9,11,3,12,24,50.0,12,10,6,4,10,33,5,2,Matches,2021-2022,Ligue-1
Strahinja Pavlović,rs SRB,DF,Monaco,20.0,2001.0,5.0,23,16,8,13,2,8,12,66.7,4,5,3,2,9,32,15,0,Matches,2021-2022,Ligue-1
Dimitri Payet,fr FRA,"FW,MF",Marseille,34.0,1987.0,28.8,16,8,4,10,2,7,31,22.6,24,9,0,9,9,25,3,0,Matches,2021-2022,Ligue-1
Timothee Pembele,fr FRA,DF,Bordeaux,18.0,2002.0,15.7,20,8,8,10,2,10,29,34.5,19,12,3,9,16,36,24,0,Matches,2021-2022,Ligue-1
Brayann Pereira,fr FRA,"DF,MF",Lens,18.0,2003.0,0.2,1,1,1,0,0,1,1,100.0,0,0,0,0,0,1,1,0,Matches,2021-2022,Ligue-1
Danilo Pereira,pt POR,MF,Paris S-G,29.0,1991.0,22.6,33,17,10,20,3,14,28,50.0,14,19,10,9,37,70,29,1,Matches,2021-2022,Ligue-1
Mathias Pereira Lage,pt POR,DF,Angers,24.0,1996.0,11.6,21,7,10,7,4,8,30,26.7,22,18,7,11,21,42,22,0,Matches,2021-2022,Ligue-1
Luan Peres Petroni,br BRA,DF,Marseille,27.0,1994.0,29.8,65,35,33,25,7,36,52,69.2,16,26,12,14,43,108,64,1,Matches,2021-2022,Ligue-1
Lucas Perrin,fr FRA,DF,Strasbourg,22.0,1998.0,27.8,43,32,24,17,2,26,45,57.8,19,28,11,17,42,85,67,0,Matches,2021-2022,Ligue-1
Danijel Petković,me MNE,GK,Angers,28.0,1993.0,15.0,0,0,0,0,0,0,1,0.0,1,0,0,0,1,1,9,5,Matches,2021-2022,Ligue-1
Léo Pétrot,fr FRA,DF,Lorient,24.0,1997.0,20.2,31,17,23,8,0,21,29,72.4,8,33,17,16,22,53,86,0,Matches,2021-2022,Ligue-1
Romain Philippoteaux,fr FRA,MF,Brest,33.0,1988.0,0.3,1,1,0,1,0,0,0,,0,0,0,0,0,1,0,0,Matches,2021-2022,Ligue-1
Jérôme Phojo,fr FRA,DF,Clermont Foot,28.0,1993.0,0.1,0,0,0,0,0,0,0,,0,0,0,0,0,0,1,0,Matches,2021-2022,Ligue-1
Jérémy Pied,fr FRA,"DF,FW",Lille,32.0,1989.0,0.1,0,0,0,0,0,0,0,,0,0,0,0,1,1,0,0,Matches,2021-2022,Ligue-1
Ronaël Pierre-Gabriel,fr FRA,DF,Brest,23.0,1998.0,28.3,79,45,52,21,6,42,73,57.5,31,22,7,15,48,127,74,0,Matches,2021-2022,Ligue-1
Julian Pollersbeck,de GER,GK,Lyon,26.0,1994.0,4.8,0,0,0,0,0,0,0,,0,0,0,0,1,1,1,0,Matches,2021-2022,Ligue-1
Gaëtan Poussin,fr FRA,GK,Bordeaux,22.0,1999.0,13.0,1,1,1,0,0,1,1,100.0,0,0,0,0,0,1,15,1,Matches,2021-2022,Ligue-1
Sanjin Prcić,ba BIH,MF,Strasbourg,27.0,1993.0,24.3,47,28,14,27,6,14,29,48.3,15,18,3,15,47,94,19,0,Matches,2021-2022,Ligue-1
Nicolas de Préville,fr FRA,"FW,MF",Metz,30.0,1991.0,21.9,17,8,7,8,2,3,19,15.8,16,12,4,8,5,22,11,0,Matches,2021-2022,Ligue-1
Nemanja Radonjić,rs SRB,FW,Marseille,25.0,1996.0,0.2,0,0,0,0,0,0,0,,0,0,0,0,0,0,0,0,Matches,2021-2022,Ligue-1
Rafinha,br BRA,"FW,MF",Paris S-G,28.0,1993.0,2.4,14,8,3,9,2,7,11,63.6,4,3,0,3,4,18,0,0,Matches,2021-2022,Ligue-1
Predrag Rajković,rs SRB,GK,Reims,25.0,1995.0,38.0,2,2,2,0,0,2,3,66.7,1,1,0,1,1,3,21,1,Matches,2021-2022,Ligue-1
Adil Rami,fr FRA,DF,Troyes,35.0,1985.0,13.0,10,9,6,4,0,7,8,87.5,1,17,9,8,16,26,43,0,Matches,2021-2022,Ligue-1
Sergio Ramos,es ESP,DF,Paris S-G,35.0,1986.0,8.9,12,5,6,6,0,8,15,53.3,7,4,2,2,8,20,27,0,Matches,2021-2022,Ligue-1
Elba Rashani,xk KVX,"FW,MF",Clermont Foot,28.0,1993.0,19.5,40,21,15,21,4,17,55,30.9,38,34,3,31,11,51,20,0,Matches,2021-2022,Ligue-1
Jeff Reine-Adélaïde,fr FRA,"MF,DF",Lyon,23.0,1998.0,2.2,5,3,4,1,0,4,5,80.0,1,2,0,2,0,5,0,1,Matches,2021-2022,Ligue-1
Tiago Ribeiro,pt POR,FW,Monaco,19.0,2002.0,0.0,0,0,0,0,0,0,0,,0,0,0,0,0,0,0,0,Matches,2021-2022,Ligue-1
Sergio Rico,es ESP,GK,Paris S-G,27.0,1993.0,0.3,0,0,0,0,0,0,0,,0,0,0,0,0,0,1,0,Matches,2021-2022,Ligue-1
Renaud Ripart,fr FRA,"MF,FW",Troyes,28.0,1993.0,21.0,38,21,18,15,5,18,50,36.0,32,21,1,20,19,57,21,1,Matches,2021-2022,Ligue-1
Mihailo Ristić,rs SRB,DF,Montpellier,25.0,1995.0,20.0,44,32,26,16,2,25,43,58.1,18,16,6,10,17,61,48,0,Matches,2021-2022,Ligue-1
Maxence Rivera,fr FRA,FW,Saint-Étienne,19.0,2002.0,0.1,0,0,0,0,0,0,0,,0,0,0,0,0,0,0,0,Matches,2021-2022,Ligue-1
Patrick Roberts,eng ENG,MF,Troyes,24.0,1997.0,0.2,0,0,0,0,0,0,0,,0,0,0,0,0,0,0,0,Matches,2021-2022,Ligue-1
Stian Rode Gregersen,no NOR,DF,Bordeaux,26.0,1995.0,21.7,39,26,23,12,4,18,33,54.5,15,26,16,10,38,77,103,2,Matches,2021-2022,Ligue-1
Gerson Rodrigues,lu LUX,"FW,MF",Troyes,26.0,1995.0,9.4,12,9,2,6,4,1,17,5.9,16,8,1,7,0,12,2,0,Matches,2021-2022,Ligue-1
Valentin Rongier,fr FRA,"MF,DF",Marseille,26.0,1994.0,24.4,77,51,36,36,5,28,60,46.7,32,26,5,21,33,110,14,0,Matches,2021-2022,Ligue-1
Pablo Rosario,nl NED,MF,Nice,24.0,1997.0,30.3,59,37,18,32,9,26,66,39.4,40,33,7,26,38,97,43,0,Matches,2021-2022,Ligue-1
Roli Pereira de Sa,fr FRA,MF,Nantes,24.0,1996.0,6.4,12,4,3,5,4,3,20,15.0,17,6,0,6,6,18,3,0,Matches,2021-2022,Ligue-1
Mathys Saban,fr FRA,"FW,MF",Saint-Étienne,19.0,2002.0,0.8,4,2,2,2,0,1,1,100.0,0,1,0,1,0,4,0,0,Matches,2021-2022,Ligue-1
Falaye Sacko,ml MLI,DF,Saint-Étienne,26.0,1995.0,7.4,15,10,14,1,0,13,16,81.3,3,11,7,4,4,19,18,2,Matches,2021-2022,Ligue-1
Rafiki Said,km COM,"MF,FW",Brest,21.0,2000.0,1.4,4,3,1,2,1,3,4,75.0,1,2,0,2,0,4,0,0,Matches,2021-2022,Ligue-1
Wesley Saïd,fr FRA,"FW,MF",Lens,26.0,1995.0,7.3,10,5,1,8,1,1,9,11.1,8,4,0,4,2,12,0,0,Matches,2021-2022,Ligue-1
Mamadou Sakho,fr FRA,DF,Montpellier,31.0,1990.0,28.6,34,22,26,8,0,16,26,61.5,10,41,34,7,41,75,134,4,Matches,2021-2022,Ligue-1
Bakary Sako,ml MLI,"FW,MF",Saint-Étienne,33.0,1988.0,1.7,0,0,0,0,0,0,1,0.0,1,3,1,2,0,0,0,0,Matches,2021-2022,Ligue-1
William Saliba,fr FRA,DF,Marseille,20.0,2001.0,36.0,54,32,36,16,2,27,35,77.1,8,24,16,8,48,102,85,0,Matches,2021-2022,Ligue-1
Romain Salin,fr FRA,GK,Rennes,37.0,1984.0,1.0,0,0,0,0,0,0,0,,0,0,0,0,0,0,0,0,Matches,2021-2022,Ligue-1
Yoann Salmier,gf GUF,DF,Troyes,28.0,1992.0,29.6,58,33,44,11,3,26,34,76.5,8,30,14,16,40,98,94,0,Matches,2021-2022,Ligue-1
Mama Samba Baldé,gw GNB,"MF,FW",Troyes,25.0,1995.0,19.1,40,28,16,14,10,8,26,30.8,18,32,1,31,5,45,9,0,Matches,2021-2022,Ligue-1
Junior Sambia,fr FRA,"DF,FW",Montpellier,24.0,1996.0,17.0,22,13,12,7,3,13,22,59.1,9,22,3,19,21,43,31,0,Matches,2021-2022,Ligue-1
Renato Sanches,pt POR,"MF,FW",Lille,23.0,1997.0,18.3,19,7,8,10,1,9,26,34.6,17,14,3,11,14,33,7,0,Matches,2021-2022,Ligue-1
Philippe Sandler,nl NED,DF,Troyes,24.0,1997.0,0.8,0,0,0,0,0,0,0,,0,1,1,0,3,3,6,0,Matches,2021-2022,Ligue-1
Baptiste Santamaria,fr FRA,"MF,DF",Rennes,26.0,1995.0,28.0,52,27,15,31,6,24,44,54.5,20,33,12,21,33,85,42,0,Matches,2021-2022,Ligue-1
Pablo Sarabia,es ESP,FW,Paris S-G,29.0,1992.0,0.2,0,0,0,0,0,0,1,0.0,1,0,0,0,0,0,0,0,Matches,2021-2022,Ligue-1
Martin Satriano,uy URU,FW,Brest,20.0,2001.0,10.4,5,2,1,1,3,2,7,28.6,5,8,0,8,2,7,3,0,Matches,2021-2022,Ligue-1
Téji Savanier,fr FRA,MF,Montpellier,29.0,1991.0,26.8,46,27,18,19,9,21,59,35.6,38,23,1,22,25,71,12,1,Matches,2021-2022,Ligue-1
Morgan Schneiderlin,fr FRA,MF,Nice,31.0,1989.0,7.2,21,12,9,11,1,6,13,46.2,7,8,2,6,20,41,18,0,Matches,2021-2022,Ligue-1
Alidu Seidu,gh GHA,DF,Clermont Foot,21.0,2000.0,15.7,34,20,20,13,1,16,27,59.3,11,25,11,14,34,68,49,1,Matches,2021-2022,Ligue-1
Matz Sels,be BEL,GK,Strasbourg,29.0,1992.0,37.0,1,1,1,0,0,0,0,,0,0,0,0,1,2,22,0,Matches,2021-2022,Ligue-1
Xherdan Shaqiri,ch SUI,"FW,MF",Lyon,29.0,1991.0,7.5,7,3,0,5,2,2,10,20.0,8,2,0,2,2,9,2,0,Matches,2021-2022,Ligue-1
Mahame Siby,ml MLI,DF,Strasbourg,25.0,1996.0,0.2,0,0,0,0,0,0,0,,0,0,0,0,1,1,2,0,Matches,2021-2022,Ligue-1
Aboubakar Sidibé,fr FRA,DF,Clermont Foot,25.0,1996.0,0.1,0,0,0,0,0,0,0,,0,0,0,0,0,0,0,0,Matches,2021-2022,Ligue-1
Djibril Sidibé,fr FRA,DF,Monaco,29.0,1992.0,10.5,24,13,13,8,3,9,24,37.5,15,10,1,9,16,40,13,0,Matches,2021-2022,Ligue-1
Kaj Sierhuis,nl NED,FW,Reims,23.0,1998.0,0.9,1,1,1,0,0,1,3,33.3,2,0,0,0,0,1,1,0,Matches,2021-2022,Ligue-1
Caio Henrique Oliveira Silva,br BRA,DF,Monaco,24.0,1997.0,29.6,53,30,31,18,4,28,59,47.5,31,30,6,24,27,80,37,3,Matches,2021-2022,Ligue-1
Gabriel Silva,br BRA,"DF,MF",Saint-Étienne,30.0,1991.0,7.9,12,7,7,2,3,9,13,69.2,4,9,3,6,18,30,13,0,Matches,2021-2022,Ligue-1
Moses Simon,ng NGA,"FW,MF",Nantes,26.0,1995.0,25.9,17,11,6,5,6,11,23,47.8,12,14,3,11,12,29,5,0,Matches,2021-2022,Ligue-1
Xavi Simons,nl NED,"MF,FW",Paris S-G,18.0,2003.0,1.5,1,1,0,1,0,1,2,50.0,1,3,0,3,0,1,0,0,Matches,2021-2022,Ligue-1
Issouf Sissokho,ml MLI,MF,Bordeaux,19.0,2002.0,4.8,17,8,2,13,2,8,17,47.1,9,8,1,7,7,24,0,0,Matches,2021-2022,Ligue-1
Ibrahima Sissoko,ml MLI,"MF,DF",Strasbourg,23.0,1997.0,25.6,47,23,18,20,9,19,46,41.3,27,32,11,21,35,82,31,0,Matches,2021-2022,Ligue-1
Nelson Sissoko,fr FRA,DF,Saint-Étienne,24.0,1997.0,0.5,2,0,2,0,0,1,1,100.0,0,0,0,0,0,2,2,0,Matches,2021-2022,Ligue-1
Sambou Sissoko,fr FRA,"MF,DF",Reims,22.0,1999.0,2.0,12,6,6,4,2,6,8,75.0,2,2,0,2,2,14,7,0,Matches,2021-2022,Ligue-1
Islam Slimani,dz ALG,FW,Lyon,33.0,1988.0,6.4,3,2,0,1,2,1,6,16.7,5,4,0,4,2,5,5,0,Matches,2021-2022,Ligue-1
Florian Sotoca,fr FRA,"FW,MF",Lens,30.0,1990.0,27.6,31,19,7,20,4,12,51,23.5,39,31,4,27,25,56,41,0,Matches,2021-2022,Ligue-1
Sambou Soumano,sn SEN,"FW,MF",Lorient,20.0,2001.0,5.0,4,1,1,2,1,2,2,100.0,0,3,0,3,1,5,7,0,Matches,2021-2022,Ligue-1
Arnaud Souquet,fr FRA,DF,Montpellier,29.0,1992.0,25.9,56,35,30,17,9,32,65,49.2,33,21,7,14,34,90,60,1,Matches,2021-2022,Ligue-1
Saidou Sow,gn GUI,DF,Saint-Étienne,19.0,2002.0,11.0,28,17,21,6,1,16,21,76.2,5,15,5,10,23,51,34,0,Matches,2021-2022,Ligue-1
Calvin Stengs,nl NED,MF,Nice,22.0,1998.0,11.9,16,7,6,9,1,7,20,35.0,13,10,0,10,8,24,6,0,Matches,2021-2022,Ligue-1
Kamaldeen Sulemana,gh GHA,"MF,FW",Rennes,19.0,2002.0,11.3,23,12,7,9,7,10,17,58.8,7,10,1,9,4,27,5,0,Matches,2021-2022,Ligue-1
Abdoulaye Sylla,gn GUI,DF,Nantes,21.0,2000.0,1.7,4,4,2,1,1,2,4,50.0,2,5,3,2,1,5,3,0,Matches,2021-2022,Ligue-1
Waniss Taibi,fr FRA,"MF,FW",Angers,19.0,2002.0,1.5,8,7,4,4,0,2,4,50.0,2,0,0,0,1,9,1,0,Matches,2021-2022,Ligue-1
Flavien Tait,fr FRA,MF,Rennes,28.0,1993.0,23.6,28,19,13,9,6,13,40,32.5,27,15,4,11,19,47,13,1,Matches,2021-2022,Ligue-1
Florian Tardieu,fr FRA,MF,Troyes,29.0,1992.0,29.2,58,25,31,21,6,31,71,43.7,40,31,9,22,42,100,38,0,Matches,2021-2022,Ligue-1
Oussama Targhalline,ma MAR,FW,Marseille,19.0,2002.0,0.1,0,0,0,0,0,0,0,,0,0,0,0,0,0,0,0,Matches,2021-2022,Ligue-1
Loum Tchaouna,fr FRA,"FW,MF",Rennes,17.0,2003.0,1.0,3,1,1,2,0,1,5,20.0,4,0,0,0,2,5,0,0,Matches,2021-2022,Ligue-1
Enzo Tchato,cm CMR,FW,Montpellier,18.0,2002.0,0.1,0,0,0,0,0,0,0,,0,0,0,0,0,0,1,0,Matches,2021-2022,Ligue-1
Warren Tchimbembé,cg CGO,MF,Metz,23.0,1998.0,2.3,1,1,0,1,0,0,1,0.0,1,2,1,1,2,3,2,0,Matches,2021-2022,Ligue-1
Aurélien Tchouaméni,fr FRA,MF,Monaco,21.0,2000.0,32.5,86,45,33,49,4,29,55,52.7,26,39,7,32,101,187,34,0,Matches,2021-2022,Ligue-1
Mathys Tel,fr FRA,"FW,MF",Rennes,16.0,2005.0,0.6,2,1,1,1,0,0,0,,0,0,0,0,1,3,2,0,Matches,2021-2022,Ligue-1
Jordan Tell,gp GLP,FW,Clermont Foot,24.0,1997.0,3.2,5,5,0,3,2,1,4,25.0,3,3,0,3,0,5,1,0,Matches,2021-2022,Ligue-1
Martin Terrier,fr FRA,"FW,MF",Rennes,24.0,1997.0,30.9,55,33,22,16,17,25,43,58.1,18,29,3,26,18,73,17,0,Matches,2021-2022,Ligue-1
Tetê,br BRA,"FW,MF",Lyon,21.0,2000.0,6.5,10,5,4,5,1,3,13,23.1,10,4,0,4,3,13,1,0,Matches,2021-2022,Ligue-1
Sada Thioub,sn SEN,FW,Angers,26.0,1995.0,0.0,0,0,0,0,0,0,0,,0,0,0,0,0,0,0,0,Matches,2021-2022,Ligue-1
Sada Thioub,sn SEN,"DF,MF",Saint-Étienne,26.0,1995.0,10.6,13,8,5,8,0,6,14,42.9,8,9,0,9,10,23,8,0,Matches,2021-2022,Ligue-1
Romain Thomas,fr FRA,DF,Angers,33.0,1988.0,28.5,49,37,28,21,0,30,57,52.6,27,35,19,16,44,93,126,0,Matches,2021-2022,Ligue-1
Adrien Thomasson,fr FRA,MF,Strasbourg,27.0,1993.0,26.5,64,31,18,27,19,30,93,32.3,63,56,4,52,29,93,16,1,Matches,2021-2022,Ligue-1
Matheus Thuler,br BRA,DF,Montpellier,22.0,1999.0,9.5,21,12,17,4,0,8,15,53.3,7,9,7,2,9,30,30,0,Matches,2021-2022,Ligue-1
Khéphren Thuram,fr FRA,MF,Nice,20.0,2001.0,21.1,33,19,11,18,4,17,35,48.6,18,31,11,20,28,61,19,0,Matches,2021-2022,Ligue-1
Cheikh Tidiane Niasse,sn SEN,"FW,MF",Lille,21.0,2000.0,0.5,2,2,0,2,0,2,3,66.7,1,1,1,0,1,3,2,0,Matches,2021-2022,Ligue-1
Cheikh Tidiane Sabaly,sn SEN,"FW,MF",Metz,22.0,1999.0,1.7,6,3,1,4,1,2,2,100.0,0,1,0,1,0,6,1,0,Matches,2021-2022,Ligue-1
Jean-Clair Todibo,fr FRA,DF,Nice,21.0,1999.0,34.6,59,37,43,15,1,39,60,65.0,21,45,21,24,51,110,130,2,Matches,2021-2022,Ligue-1
Karl Toko Ekambi,cm CMR,FW,Lyon,28.0,1992.0,25.5,13,7,4,6,3,4,21,19.0,17,26,0,26,20,33,5,0,Matches,2021-2022,Ligue-1
Yoann Touzghar,tn TUN,FW,Troyes,34.0,1986.0,16.2,5,2,1,3,1,1,3,33.3,2,3,1,2,3,8,8,0,Matches,2021-2022,Ligue-1
Amadou Traore,fr FRA,FW,Bordeaux,19.0,2002.0,0.2,0,0,0,0,0,0,0,,0,0,0,0,0,0,0,0,Matches,2021-2022,Ligue-1
Boubacar Traoré,ml MLI,MF,Metz,19.0,2001.0,19.2,43,26,18,23,2,10,39,25.6,29,29,5,24,25,68,11,1,Matches,2021-2022,Ligue-1
Charles Traore,ml MLI,DF,Nantes,29.0,1992.0,8.0,16,12,10,4,2,2,13,15.4,11,11,4,7,15,31,30,0,Matches,2021-2022,Ligue-1
Hamari Traoré,ml MLI,DF,Rennes,29.0,1992.0,32.1,63,36,25,26,12,41,59,69.5,18,29,8,21,37,100,81,1,Matches,2021-2022,Ligue-1
Ismaël Traoré,ci CIV,DF,Angers,34.0,1986.0,35.7,28,17,16,11,1,13,28,46.4,15,25,17,8,44,72,122,1,Matches,2021-2022,Ligue-1
Miguel Trauco,pe PER,"DF,MF",Saint-Étienne,28.0,1992.0,12.4,25,18,16,8,1,12,22,54.5,10,13,4,9,23,48,17,0,Matches,2021-2022,Ligue-1
Adrien Truffert,fr FRA,DF,Rennes,19.0,2001.0,18.2,29,21,17,9,3,11,24,45.8,13,25,5,20,19,48,30,0,Matches,2021-2022,Ligue-1
Matthieu Udol,fr FRA,DF,Metz,25.0,1996.0,11.2,23,14,11,10,2,12,18,66.7,6,20,7,13,31,54,29,1,Matches,2021-2022,Ligue-1
Ike Ugbo,ca CAN,FW,Troyes,22.0,1998.0,9.0,3,1,0,1,2,0,1,0.0,1,4,1,3,2,5,1,0,Matches,2021-2022,Ligue-1
Lesley Ugochukwu,fr FRA,MF,Rennes,17.0,2004.0,4.5,13,9,5,5,3,9,19,47.4,10,7,2,5,4,17,2,0,Matches,2021-2022,Ligue-1
Hwang Ui-jo,kr KOR,FW,Bordeaux,28.0,1992.0,27.9,10,4,4,4,2,4,13,30.8,9,9,1,8,5,15,18,0,Matches,2021-2022,Ligue-1
Cengiz Ünder,tr TUR,"FW,MF",Marseille,24.0,1997.0,24.4,18,13,5,6,7,5,18,27.8,13,13,2,11,14,32,9,0,Matches,2021-2022,Ligue-1
Jere Uronen,fi FIN,DF,Brest,27.0,1994.0,9.8,28,15,15,10,3,14,24,58.3,10,12,3,9,16,44,21,0,Matches,2021-2022,Ligue-1
Vanderson,br BRA,"FW,DF",Monaco,20.0,2001.0,12.4,35,19,10,19,6,15,23,65.2,8,17,4,13,13,48,12,0,Matches,2021-2022,Ligue-1
Jonathan Varane,mq MTQ,MF,Lens,19.0,2001.0,0.0,0,0,0,0,0,0,0,,0,0,0,0,0,0,0,0,Matches,2021-2022,Ligue-1
Marco Verratti,it ITA,MF,Paris S-G,28.0,1992.0,21.5,60,40,16,30,14,32,64,50.0,32,36,10,26,18,78,14,2,Matches,2021-2022,Ligue-1
Kevin Volland,de GER,"MF,FW",Monaco,29.0,1992.0,27.1,24,10,2,18,4,6,31,19.4,25,20,0,20,3,27,9,0,Matches,2021-2022,Ligue-1
Elye Wahi,fr FRA,FW,Montpellier,18.0,2003.0,19.8,18,10,9,6,3,6,16,37.5,10,7,0,7,4,22,4,0,Matches,2021-2022,Ligue-1
Timothy Weah,us USA,"MF,FW",Lille,21.0,2000.0,18.0,19,7,8,8,3,10,20,50.0,10,16,1,15,10,29,7,0,Matches,2021-2022,Ligue-1
Georginio Wijnaldum,nl NED,MF,Paris S-G,30.0,1990.0,18.4,15,9,2,12,1,11,19,57.9,8,13,3,10,9,24,7,0,Matches,2021-2022,Ligue-1
Christopher Wooh,cm CMR,DF,Lens,19.0,2001.0,11.7,29,11,20,8,1,11,18,61.1,7,21,14,7,21,50,40,1,Matches,2021-2022,Ligue-1
Xeka,pt POR,MF,Lille,26.0,1994.0,18.0,47,27,18,24,5,27,56,48.2,29,23,3,20,24,71,26,1,Matches,2021-2022,Ligue-1
Sekou Yansané,gn GUI,FW,Paris S-G,18.0,2003.0,0.2,0,0,0,0,0,0,1,0.0,1,0,0,0,0,0,1,0,Matches,2021-2022,Ligue-1
Yusuf Yazıcı,tr TUR,"MF,FW",Lille,24.0,1997.0,5.7,10,5,3,6,1,1,9,11.1,8,4,0,4,2,12,1,0,Matches,2021-2022,Ligue-1
Burak Yılmaz,tr TUR,FW,Lille,36.0,1985.0,24.6,7,2,0,2,5,2,17,11.8,15,8,1,7,2,9,11,0,Matches,2021-2022,Ligue-1
Leny Yoro,fr FRA,MF,Lille,15.0,2005.0,0.1,1,0,0,1,0,0,0,,0,1,0,1,0,1,0,0,Matches,2021-2022,Ligue-1
Zaydou Youssouf,km COM,MF,Saint-Étienne,22.0,1999.0,17.3,48,26,21,25,2,14,34,41.2,20,11,3,8,17,65,13,0,Matches,2021-2022,Ligue-1
Akim Zedadka,dz ALG,DF,Clermont Foot,26.0,1995.0,37.1,72,44,34,29,9,37,71,52.1,34,32,8,24,58,130,48,0,Matches,2021-2022,Ligue-1
Arber Zeneli,xk KVX,FW,Reims,26.0,1995.0,4.5,1,0,0,0,1,1,5,20.0,4,0,0,0,1,2,1,0,Matches,2021-2022,Ligue-1
Mehdi Zerkane,dz ALG,"MF,DF",Bordeaux,22.0,1999.0,0.9,0,0,0,0,0,0,1,0.0,1,1,1,0,2,2,0,0,Matches,2021-2022,Ligue-1
Edon Zhegrova,xk KVX,"MF,FW",Lille,22.0,1999.0,5.3,14,5,2,8,4,5,6,83.3,1,4,1,3,2,16,2,0,Matches,2021-2022,Ligue-1
Tanguy Zoukrou,fr FRA,DF,Troyes,18.0,2003.0,0.9,1,0,1,0,0,1,2,50.0,1,0,0,0,0,1,2,0,Matches,2021-2022,Ligue-1
Yunis Abdelhamid,ma MAR,DF,Reims,34.0,1987.0,37.0,82,50,47,33,2,39,52,75.0,13,65,27,38,64,146,116,1,Matches,2022-2023,Ligue-1
Himad Abdelli,dz ALG,"MF,FW",Angers,22.0,1999.0,23.7,64,38,22,32,10,31,67,46.3,36,30,1,29,28,92,15,0,Matches,2022-2023,Ligue-1
Salis Abdul Samed,gh GHA,MF,Lens,22.0,2000.0,32.2,46,26,18,23,5,29,52,55.8,23,38,9,29,36,82,26,0,Matches,2022-2023,Ligue-1
Laurent Abergel,fr FRA,MF,Lorient,29.0,1993.0,26.0,92,52,59,30,3,39,92,42.4,53,47,8,39,34,126,39,0,Matches,2022-2023,Ligue-1
Matthis Abline,fr FRA,"FW,MF",Auxerre,19.0,2003.0,9.0,4,2,0,3,1,0,5,0.0,5,6,1,5,1,5,1,0,Matches,2022-2023,Ligue-1
Matthis Abline,fr FRA,"FW,MF",Rennes,19.0,2003.0,1.2,1,1,0,0,1,1,1,100.0,0,1,0,1,2,3,1,0,Matches,2022-2023,Ligue-1
Zakaria Aboukhlal,ma MAR,"FW,MF",Toulouse,22.0,2000.0,27.5,33,23,13,9,11,14,45,31.1,31,18,1,17,22,55,23,0,Matches,2022-2023,Ligue-1
Mohamed Achi,fr FRA,FW,Nantes,20.0,2002.0,0.4,1,1,1,0,0,1,1,100.0,0,0,0,0,0,1,0,0,Matches,2022-2023,Ligue-1
Martin Adeline,fr FRA,"MF,FW",Reims,18.0,2003.0,1.2,3,3,2,1,0,3,4,75.0,1,3,1,2,3,6,3,0,Matches,2022-2023,Ligue-1
Emmanuel Agbadou,ci CIV,DF,Reims,25.0,1997.0,26.5,71,49,53,16,2,42,65,64.6,23,30,14,16,32,103,107,3,Matches,2022-2023,Ligue-1
Lucien Agoume,fr FRA,MF,Troyes,20.0,2002.0,12.2,42,25,18,15,9,17,33,51.5,16,14,5,9,27,69,24,0,Matches,2022-2023,Ligue-1
Ruben Aguilar,fr FRA,DF,Monaco,29.0,1993.0,13.0,19,9,7,7,5,8,22,36.4,14,13,1,12,18,37,28,1,Matches,2022-2023,Ligue-1
Amar Ahmed,se SWE,FW,Troyes,18.0,2004.0,0.2,1,1,0,1,0,0,1,0.0,1,0,0,0,1,2,0,0,Matches,2022-2023,Ligue-1
Jean-Eudes Aholou,ci CIV,MF,Strasbourg,28.0,1994.0,14.4,34,20,10,20,4,12,31,38.7,19,25,0,25,24,58,15,0,Matches,2022-2023,Ligue-1
Ludovic Ajorque,fr FRA,FW,Strasbourg,28.0,1994.0,8.6,5,4,1,4,0,3,9,33.3,6,3,1,2,2,7,7,0,Matches,2022-2023,Ligue-1
Maghnes Akliouche,fr FRA,"MF,FW",Monaco,20.0,2002.0,4.5,7,4,4,3,0,2,8,25.0,6,2,0,2,3,10,2,0,Matches,2022-2023,Ligue-1
Doğan Alemdar,tr TUR,GK,Rennes,19.0,2002.0,4.5,0,0,0,0,0,0,0,,0,0,0,0,0,0,1,1,Matches,2022-2023,Ligue-1
Jim Allevinah,ga GAB,"DF,FW",Clermont Foot,27.0,1995.0,24.9,39,24,24,11,4,19,62,30.6,43,24,2,22,24,63,26,1,Matches,2022-2023,Ligue-1
Mickaël Alphonse,gp GLP,DF,Ajaccio,33.0,1989.0,15.1,35,23,20,11,4,20,33,60.6,13,17,5,12,35,70,44,1,Matches,2022-2023,Ligue-1
Ibrahim Amadou,fr FRA,"DF,MF",Angers,29.0,1993.0,4.7,10,7,6,3,1,7,11,63.6,4,7,3,4,10,20,20,0,Matches,2022-2023,Ligue-1
Ayoub Amraoui,ma MAR,"DF,FW",Nice,18.0,2004.0,3.3,6,5,3,3,0,2,5,40.0,3,1,0,1,4,10,4,0,Matches,2022-2023,Ligue-1
Benjamin André,fr FRA,MF,Lille,31.0,1990.0,32.4,128,74,51,60,17,65,121,53.7,56,50,8,42,47,175,60,0,Matches,2022-2023,Ligue-1
Komnen Andrić,rs SRB,FW,Clermont Foot,27.0,1995.0,16.1,13,5,2,7,4,2,15,13.3,13,8,1,7,8,21,13,0,Matches,2022-2023,Ligue-1
Houssem Aouar,dz ALG,MF,Lyon,24.0,1998.0,5.8,12,5,5,5,2,3,9,33.3,6,12,2,10,8,20,3,0,Matches,2022-2023,Ligue-1
Adil Aouchiche,fr FRA,MF,Lorient,20.0,2002.0,2.8,5,2,3,1,1,1,9,11.1,8,1,0,1,4,9,1,0,Matches,2022-2023,Ligue-1
Dennis Appiah,fr FRA,"DF,MF",Nantes,30.0,1992.0,8.8,21,11,14,7,0,10,27,37.0,17,13,5,8,10,31,16,0,Matches,2022-2023,Ligue-1
Stredair Appuah,fr FRA,"DF,MF",Nantes,18.0,2004.0,0.7,2,1,0,2,0,0,0,,0,2,0,2,1,3,0,0,Matches,2022-2023,Ligue-1
Taïryk Arconte,fr FRA,FW,Brest,18.0,2003.0,1.4,1,1,0,0,1,0,3,0.0,3,1,0,1,0,1,2,0,Matches,2022-2023,Ligue-1
Mohamed El Arouch,fr FRA,MF,Lyon,18.0,2004.0,0.0,1,1,1,0,0,0,0,,0,0,0,0,0,1,0,0,Matches,2022-2023,Ligue-1
Lorenz Assignon,tg TOG,DF,Rennes,22.0,2000.0,2.9,6,2,4,2,0,2,4,50.0,2,6,0,6,2,8,9,0,Matches,2022-2023,Ligue-1
Youcef Atal,dz ALG,"DF,MF",Nice,26.0,1996.0,8.7,38,22,18,15,5,23,32,71.9,9,9,0,9,14,52,13,0,Matches,2022-2023,Ligue-1
Valentin Atangana Edoa,fr FRA,MF,Reims,16.0,2005.0,1.9,8,3,4,2,2,3,6,50.0,3,2,1,1,0,8,1,0,Matches,2022-2023,Ligue-1
Mathias Autret,fr FRA,"MF,FW",Auxerre,31.0,1991.0,14.3,22,10,10,10,2,7,16,43.8,9,14,2,12,12,34,13,0,Matches,2022-2023,Ligue-1
Cédric Avinel,gp GLP,DF,Ajaccio,35.0,1986.0,19.9,13,7,8,5,0,8,12,66.7,4,20,13,7,15,28,91,1,Matches,2022-2023,Ligue-1
Loïc Bade,fr FRA,DF,Rennes,22.0,2000.0,1.0,1,1,1,0,0,0,0,,0,0,0,0,1,2,3,0,Matches,2022-2023,Ligue-1
Benoît Badiashile,fr FRA,DF,Monaco,21.0,2001.0,9.3,10,8,6,4,0,5,10,50.0,5,9,6,3,17,27,40,1,Matches,2022-2023,Ligue-1
Eric Bailly,ci CIV,DF,Marseille,28.0,1994.0,6.0,13,10,6,6,1,7,7,100.0,0,15,12,3,12,25,18,1,Matches,2022-2023,Ligue-1
Dénys Bain,fr FRA,DF,Auxerre,29.0,1993.0,1.4,4,3,3,1,0,1,2,50.0,1,2,1,1,2,6,4,0,Matches,2022-2023,Ligue-1
Brandon Baiye,be BEL,MF,Clermont Foot,21.0,2000.0,0.6,3,2,2,1,0,2,3,66.7,1,1,0,1,1,4,3,0,Matches,2022-2023,Ligue-1
Cédric Bakambu,cd COD,MF,Marseille,31.0,1991.0,0.7,2,1,2,0,0,2,2,100.0,0,0,0,0,0,2,0,0,Matches,2022-2023,Ligue-1
Thierno Balde,fr FRA,"DF,MF",Troyes,20.0,2002.0,23.9,27,14,19,4,4,18,30,60.0,12,15,3,12,23,50,39,0,Matches,2022-2023,Ligue-1
Carlos Baleba,cm CMR,MF,Lille,18.0,2004.0,5.3,13,11,2,9,2,9,14,64.3,5,13,3,10,1,14,3,2,Matches,2022-2023,Ligue-1
Leonardo Balerdi,ar ARG,DF,Marseille,23.0,1999.0,29.3,57,37,43,12,2,32,45,71.1,13,48,29,19,63,120,91,1,Matches,2022-2023,Ligue-1
Folarin Balogun,us USA,FW,Reims,21.0,2001.0,33.3,9,5,1,5,3,2,20,10.0,18,20,1,19,3,12,15,0,Matches,2022-2023,Ligue-1
Abdoulaye Bamba,ci CIV,DF,Angers,32.0,1990.0,15.2,22,12,15,5,2,16,19,84.2,3,7,3,4,18,40,38,0,Matches,2022-2023,Ligue-1
Jonathan Bamba,ci CIV,FW,Lille,26.0,1996.0,30.9,37,17,12,14,11,14,45,31.1,31,36,1,35,22,59,14,0,Matches,2022-2023,Ligue-1
Bradley Barcola,fr FRA,"FW,MF",Lyon,19.0,2002.0,16.0,25,16,8,10,7,8,39,20.5,31,29,0,29,19,44,10,0,Matches,2022-2023,Ligue-1
Melvin Bard,fr FRA,DF,Nice,21.0,2000.0,27.3,96,60,61,29,6,59,89,66.3,30,35,4,31,64,160,40,1,Matches,2022-2023,Ligue-1
Ross Barkley,eng ENG,"MF,FW",Nice,28.0,1993.0,10.7,16,9,7,4,5,7,13,53.8,6,7,2,5,8,24,6,0,Matches,2022-2023,Ligue-1
Mickaël Barreto,fr FRA,MF,Ajaccio,31.0,1991.0,14.7,32,20,12,17,3,8,45,17.8,37,17,0,17,18,50,11,0,Matches,2022-2023,Ligue-1
Cyrille Bayala,bf BFA,MF,Ajaccio,26.0,1996.0,22.3,53,37,16,20,17,23,48,47.9,25,20,3,17,25,78,21,0,Matches,2022-2023,Ligue-1
Yanis Begraoui,ma MAR,"FW,MF",Toulouse,21.0,2001.0,0.7,2,0,1,0,1,1,2,50.0,1,0,0,0,1,3,0,0,Matches,2022-2023,Ligue-1
Alexis Beka Beka,fr FRA,"MF,DF",Nice,21.0,2001.0,6.1,16,5,6,9,1,4,15,26.7,11,9,1,8,12,28,6,0,Matches,2022-2023,Ligue-1
Jérémie Bela,ao ANG,"DF,MF",Clermont Foot,29.0,1993.0,8.3,6,4,2,1,3,3,4,75.0,1,10,1,9,9,15,8,0,Matches,2022-2023,Ligue-1
Reda Belahyane,ma MAR,MF,Nice,18.0,2004.0,2.0,8,6,5,3,0,3,5,60.0,2,5,1,4,2,10,0,0,Matches,2022-2023,Ligue-1
Youcef Belaïli,dz ALG,"MF,FW",Ajaccio,30.0,1992.0,12.8,18,10,3,9,6,8,20,40.0,12,10,1,9,5,23,4,0,Matches,2022-2023,Ligue-1
Youcef Belaïli,dz ALG,"FW,MF",Brest,30.0,1992.0,4.0,5,2,3,2,0,2,7,28.6,5,2,0,2,1,6,1,0,Matches,2022-2023,Ligue-1
Haris Belkebla,dz ALG,MF,Brest,28.0,1994.0,29.5,80,48,35,40,5,44,85,51.8,41,32,6,26,52,132,21,3,Matches,2022-2023,Ligue-1
Jean-Ricner Bellegarde,fr FRA,"MF,FW",Strasbourg,24.0,1998.0,26.9,47,25,15,21,11,11,25,44.0,14,26,3,23,26,73,22,0,Matches,2022-2023,Ligue-1
Jeanuël Belocian,fr FRA,DF,Rennes,17.0,2005.0,5.6,10,7,3,5,2,5,9,55.6,4,6,3,3,6,16,11,0,Matches,2022-2023,Ligue-1
Eliesse Ben Seghir,ma MAR,"FW,MF",Monaco,17.0,2005.0,11.7,18,10,4,12,2,4,12,33.3,8,18,1,17,4,22,1,0,Matches,2022-2023,Ligue-1
Salim Ben Seghir,fr FRA,MF,Marseille,19.0,2003.0,0.0,0,0,0,0,0,0,0,,0,1,0,1,0,0,0,0,Matches,2022-2023,Ligue-1
Wissam Ben Yedder,fr FRA,FW,Monaco,31.0,1990.0,23.5,16,9,2,5,9,4,13,30.8,9,15,0,15,4,20,0,0,Matches,2022-2023,Ligue-1
Nabil Bentaleb,dz ALG,MF,Angers,27.0,1994.0,27.7,74,40,31,35,8,36,61,59.0,25,33,11,22,44,118,29,3,Matches,2022-2023,Ligue-1
Patrick Berg,no NOR,"MF,FW",Lens,24.0,1997.0,0.3,0,0,0,0,0,0,1,0.0,1,0,0,0,1,1,0,0,Matches,2022-2023,Ligue-1
Mitchell van Bergen,nl NED,"FW,DF",Reims,22.0,1999.0,10.1,18,8,6,7,5,8,20,40.0,12,8,2,6,6,24,11,0,Matches,2022-2023,Ligue-1
Quentin Bernard,fr FRA,DF,Auxerre,33.0,1989.0,7.0,9,7,4,2,3,7,15,46.7,8,9,1,8,15,24,17,0,Matches,2022-2023,Ligue-1
Paul Bernardoni,fr FRA,GK,Angers,25.0,1997.0,27.0,2,0,2,0,0,2,3,66.7,1,1,0,1,1,3,12,1,Matches,2022-2023,Ligue-1
Juan Bernat,es ESP,"DF,MF",Paris S-G,29.0,1993.0,18.3,32,16,18,9,5,21,39,53.8,18,11,2,9,9,41,22,1,Matches,2022-2023,Ligue-1
Jason Berthomier,fr FRA,MF,Clermont Foot,32.0,1990.0,0.3,0,0,0,0,0,0,0,,0,0,0,0,0,0,0,0,Matches,2022-2023,Ligue-1
El Bilal Touré,ml MLI,FW,Reims,20.0,2001.0,1.0,0,0,0,0,0,0,0,,0,2,0,2,0,0,1,0,Matches,2022-2023,Ligue-1
Jean-Claude Billong,cm CMR,MF,Clermont Foot,28.0,1993.0,0.3,0,0,0,0,0,0,0,,0,1,1,0,1,1,0,0,Matches,2022-2023,Ligue-1
Veljko Birmančević,rs SRB,"FW,MF",Toulouse,24.0,1998.0,4.9,13,7,5,4,4,7,21,33.3,14,12,2,10,7,20,1,0,Matches,2022-2023,Ligue-1
Marco Bizot,nl NED,GK,Brest,31.0,1991.0,37.0,0,0,0,0,0,0,1,0.0,1,1,0,1,0,0,24,4,Matches,2022-2023,Ligue-1
Rubén Blanco,es ESP,GK,Marseille,27.0,1995.0,5.5,0,0,0,0,0,0,0,,0,0,0,0,0,0,1,0,Matches,2022-2023,Ligue-1
Ludovic Blas,fr FRA,"MF,FW",Nantes,24.0,1997.0,31.3,47,30,17,19,11,17,49,34.7,32,26,1,25,19,66,8,0,Matches,2022-2023,Ligue-1
Miha Blažič,si SVN,DF,Angers,29.0,1993.0,22.0,8,6,8,0,0,7,15,46.7,8,25,19,6,22,30,80,1,Matches,2022-2023,Ligue-1
Joaquín Blázquez,ar ARG,GK,Brest,21.0,2001.0,1.0,0,0,0,0,0,0,0,,0,0,0,0,0,0,2,0,Matches,2022-2023,Ligue-1
Myron Boadu,nl NED,FW,Monaco,21.0,2001.0,3.3,3,3,0,2,1,1,7,14.3,6,1,0,1,0,3,1,0,Matches,2022-2023,Ligue-1
Jérôme Boateng,de GER,DF,Lyon,33.0,1988.0,4.8,3,0,2,1,0,2,6,33.3,4,8,5,3,6,9,16,0,Matches,2022-2023,Ligue-1
Antonin Bobichon,fr FRA,MF,Angers,26.0,1995.0,0.2,0,0,0,0,0,0,0,,0,1,0,1,0,0,0,0,Matches,2022-2023,Ligue-1
Quentin Boisgard,fr FRA,MF,Lorient,25.0,1997.0,2.0,6,2,1,4,1,3,4,75.0,1,3,1,2,4,10,2,0,Matches,2022-2023,Ligue-1
Neto Borges,br BRA,DF,Clermont Foot,25.0,1996.0,31.5,75,45,45,20,10,46,75,61.3,29,45,11,34,41,116,62,1,Matches,2022-2023,Ligue-1
Kenji-Van Boto,mg MAD,DF,Auxerre,26.0,1996.0,2.0,3,2,2,0,1,2,4,50.0,2,0,0,0,1,4,3,0,Matches,2022-2023,Ligue-1
Kouamé Botué,bf BFA,"FW,MF",Ajaccio,19.0,2002.0,2.5,4,2,2,1,1,0,2,0.0,2,1,0,1,0,4,1,0,Matches,2022-2023,Ligue-1
Badredine Bouanani,dz ALG,"FW,MF",Nice,17.0,2004.0,9.6,13,9,2,7,4,7,14,50.0,7,4,0,4,1,14,2,0,Matches,2022-2023,Ligue-1
Hicham Boudaoui,dz ALG,MF,Nice,22.0,1999.0,20.8,67,32,31,30,6,35,53,66.0,18,34,5,29,36,103,16,0,Matches,2022-2023,Ligue-1
Franci Bouebari,fr FRA,DF,Strasbourg,18.0,2003.0,0.8,3,0,1,2,0,3,5,60.0,2,0,0,0,2,5,2,0,Matches,2022-2023,Ligue-1
Sofiane Boufal,ma MAR,"FW,MF",Angers,28.0,1993.0,9.3,14,9,7,4,3,3,14,21.4,11,6,0,6,5,19,1,0,Matches,2022-2023,Ligue-1
Ismaël Boura,km COM,"DF,FW",Lens,21.0,2000.0,1.0,6,4,4,2,0,5,6,83.3,1,2,1,1,2,8,3,0,Matches,2022-2023,Ligue-1
Benjamin Bourigeaud,fr FRA,"MF,FW",Rennes,28.0,1994.0,34.1,45,29,16,23,6,21,65,32.3,44,38,3,35,31,76,32,0,Matches,2022-2023,Ligue-1
Bilal Brahimi,dz ALG,"FW,MF",Nice,22.0,2000.0,8.9,8,5,2,5,1,1,7,14.3,6,4,0,4,4,12,0,0,Matches,2022-2023,Ligue-1
Lilian Brassier,fr FRA,DF,Brest,22.0,1999.0,34.4,42,30,31,8,3,23,32,71.9,9,42,19,23,53,95,132,1,Matches,2022-2023,Ligue-1
Andreas Bruus,dk DEN,"DF,FW",Troyes,23.0,1999.0,18.1,12,6,9,3,0,8,20,40.0,12,13,2,11,17,29,24,0,Matches,2022-2023,Ligue-1
Joe Bryan,eng ENG,"MF,DF",Nice,28.0,1993.0,2.0,5,4,3,2,0,4,4,100.0,0,2,0,2,1,6,1,0,Matches,2022-2023,Ligue-1
Adam Buksa,pl POL,"FW,MF",Lens,26.0,1996.0,1.1,1,0,0,0,1,0,3,0.0,3,0,0,0,0,1,0,0,Matches,2022-2023,Ligue-1
Maxime Busi,be BEL,DF,Reims,22.0,1999.0,11.6,21,16,9,11,1,13,29,44.8,16,14,6,8,14,35,24,0,Matches,2022-2023,Ligue-1
Marcin Bułka,pl POL,GK,Nice,22.0,1999.0,2.0,0,0,0,0,0,0,1,0.0,1,0,0,0,1,1,0,0,Matches,2022-2023,Ligue-1
Rémy Cabella,fr FRA,"MF,FW",Lille,32.0,1990.0,28.1,64,37,21,28,15,29,64,45.3,35,41,5,36,17,81,7,1,Matches,2022-2023,Ligue-1
Jimmy Cabot,fr FRA,"DF,MF",Lens,28.0,1994.0,5.7,20,12,10,8,2,12,26,46.2,14,5,0,5,4,24,12,0,Matches,2022-2023,Ligue-1
Jens Cajuste,se SWE,MF,Reims,22.0,1999.0,17.0,46,25,25,14,7,25,48,52.1,23,30,6,24,18,64,22,0,Matches,2022-2023,Ligue-1
Duje Ćaleta-Car,hr CRO,DF,Marseille,25.0,1996.0,0.1,0,0,0,0,0,0,0,,0,0,0,0,0,0,1,0,Matches,2022-2023,Ligue-1
Mahdi Camara,fr FRA,MF,Brest,24.0,1998.0,20.2,63,36,18,38,7,25,43,58.1,18,35,4,31,40,103,16,0,Matches,2022-2023,Ligue-1
Mohamed Camara,ml MLI,MF,Monaco,22.0,2000.0,24.4,83,45,38,39,6,48,92,52.2,44,45,6,39,27,110,14,1,Matches,2022-2023,Ligue-1
Ousmane Camara,gn GUI,"FW,MF",Auxerre,20.0,2001.0,0.3,1,1,0,0,1,0,0,,0,0,0,0,0,1,0,0,Matches,2022-2023,Ligue-1
Ousmane Camara,fr FRA,DF,Angers,19.0,2003.0,5.8,10,6,5,5,0,5,12,41.7,7,4,2,2,11,21,15,0,Matches,2022-2023,Ligue-1
Axel Camblan,fr FRA,"FW,MF",Brest,18.0,2003.0,0.8,2,2,1,1,0,0,1,0.0,1,0,0,0,0,2,0,0,Matches,2022-2023,Ligue-1
Pierrick Capelle,fr FRA,"MF,DF",Angers,35.0,1987.0,15.9,36,21,17,15,4,22,55,40.0,33,24,3,21,15,51,24,0,Matches,2022-2023,Ligue-1
Maxence Caqueret,fr FRA,MF,Lyon,22.0,2000.0,30.7,87,54,27,38,22,43,109,39.4,66,45,3,42,39,126,27,0,Matches,2022-2023,Ligue-1
Irvin Cardona,fr FRA,"FW,MF",Brest,24.0,1997.0,2.6,2,0,1,1,0,0,3,0.0,3,3,0,3,2,4,2,0,Matches,2022-2023,Ligue-1
Igor Carioca,br BRA,DF,Lorient,25.0,1996.0,5.1,18,11,12,2,4,12,21,57.1,9,7,0,7,5,23,17,0,Matches,2022-2023,Ligue-1
Matis Carvalho,pt POR,GK,Montpellier,23.0,1999.0,1.5,0,0,0,0,0,0,0,,0,0,0,0,1,1,0,0,Matches,2022-2023,Ligue-1
Jean-Charles Castelletto,cm CMR,DF,Nantes,27.0,1995.0,28.5,43,26,29,12,2,22,36,61.1,14,35,22,13,58,101,90,0,Matches,2022-2023,Ligue-1
Yoann Cathline,fr FRA,"FW,MF",Lorient,20.0,2002.0,12.1,19,12,7,6,6,5,12,41.7,7,10,1,9,8,27,16,1,Matches,2022-2023,Ligue-1
Maximiliano Caufriez,be BEL,DF,Clermont Foot,25.0,1997.0,24.7,40,24,31,8,1,20,28,71.4,8,33,18,15,34,74,70,0,Matches,2022-2023,Ligue-1
Fabien Centonze,fr FRA,DF,Nantes,26.0,1996.0,18.8,58,37,30,22,6,30,42,71.4,12,24,7,17,44,102,55,1,Matches,2022-2023,Ligue-1
Florian Chabrolle,fr FRA,MF,Ajaccio,24.0,1998.0,3.7,6,4,1,5,0,2,4,50.0,2,3,0,3,7,13,2,0,Matches,2022-2023,Ligue-1
El Chadaille Bitshiabu,fr FRA,DF,Paris S-G,17.0,2005.0,6.5,10,7,7,2,1,3,12,25.0,9,9,7,2,9,19,13,3,Matches,2022-2023,Ligue-1
Fares Chaïbi,dz ALG,"FW,MF",Toulouse,19.0,2002.0,26.0,31,18,8,15,8,17,50,34.0,33,38,5,33,19,50,36,1,Matches,2022-2023,Ligue-1
Muhammed Cham,at AUT,MF,Clermont Foot,21.0,2000.0,21.9,30,15,15,4,11,13,35,37.1,22,13,0,13,7,37,5,0,Matches,2022-2023,Ligue-1
Gaëtan Charbonnier,fr FRA,"FW,MF",Auxerre,33.0,1988.0,2.8,2,1,0,2,0,0,4,0.0,4,2,0,2,0,2,5,0,Matches,2022-2023,Ligue-1
Brendan Chardonnet,fr FRA,DF,Brest,27.0,1994.0,27.7,45,27,27,18,0,20,38,52.6,18,40,19,21,63,108,86,1,Matches,2022-2023,Ligue-1
Xavier Chavalerin,fr FRA,MF,Troyes,31.0,1991.0,27.0,82,50,39,30,13,27,71,38.0,44,31,8,23,41,123,24,0,Matches,2022-2023,Ligue-1
Ivane Chegra,fr FRA,"MF,FW",Ajaccio,18.0,2004.0,2.1,8,3,6,1,1,4,11,36.4,7,0,0,0,1,9,0,0,Matches,2022-2023,Ligue-1
Rayan Cherki,fr FRA,"MF,FW",Lyon,18.0,2003.0,20.8,14,8,2,5,7,8,23,34.8,15,6,0,6,5,19,1,0,Matches,2022-2023,Ligue-1
Ilyes Cheti,dz ALG,DF,Angers,27.0,1995.0,2.3,6,4,4,0,2,5,8,62.5,3,5,1,4,4,10,7,0,Matches,2022-2023,Ligue-1
Lucas Chevalier,fr FRA,GK,Lille,20.0,2001.0,32.0,2,1,2,0,0,2,2,100.0,0,1,0,1,2,4,7,2,Matches,2022-2023,Ligue-1
Pedro Chirivella,es ESP,MF,Nantes,25.0,1997.0,22.5,33,22,12,15,6,17,44,38.6,27,24,1,23,20,53,7,0,Matches,2022-2023,Ligue-1
Joris Chotard,fr FRA,MF,Montpellier,20.0,2001.0,27.3,64,34,37,23,4,40,78,51.3,38,40,11,29,40,104,42,1,Matches,2022-2023,Ligue-1
Yanis Cimignani,fr FRA,"MF,DF",Ajaccio,20.0,2002.0,3.1,11,5,3,7,1,4,5,80.0,1,5,1,4,2,13,2,0,Matches,2022-2023,Ligue-1
Souleymane Cissé,fr FRA,DF,Clermont Foot,19.0,2002.0,0.4,1,1,1,0,0,1,1,100.0,0,1,1,0,1,2,2,0,Matches,2022-2023,Ligue-1
Alexis Claude-Maurice,fr FRA,FW,Nice,24.0,1998.0,0.7,3,2,2,1,0,3,3,100.0,0,0,0,0,2,5,1,0,Matches,2022-2023,Ligue-1
Alexis Claude-Maurice,fr FRA,"MF,FW",Lens,24.0,1998.0,6.7,14,9,5,8,1,6,16,37.5,10,6,0,6,2,16,1,0,Matches,2022-2023,Ligue-1
Jonathan Clauss,fr FRA,DF,Marseille,29.0,1992.0,28.8,46,28,21,16,9,23,52,44.2,29,29,4,25,31,77,40,2,Matches,2022-2023,Ligue-1
Marcus Coco,fr FRA,"FW,MF",Nantes,26.0,1996.0,7.1,24,15,11,9,4,11,23,47.8,12,13,3,10,14,38,7,0,Matches,2022-2023,Ligue-1
Alexandre Coeff,fr FRA,DF,Auxerre,30.0,1992.0,6.5,10,5,6,4,0,4,9,44.4,5,9,4,5,8,18,35,1,Matches,2022-2023,Ligue-1
Abdu Conté,pt POR,DF,Troyes,24.0,1998.0,14.6,25,17,14,8,3,12,22,54.5,10,13,6,7,6,31,25,0,Matches,2022-2023,Ligue-1
Sébastien Corchia,fr FRA,DF,Nantes,31.0,1990.0,8.7,16,6,10,2,4,11,22,50.0,11,9,3,6,14,30,21,0,Matches,2022-2023,Ligue-1
David Costa,pt POR,"MF,FW",Lens,21.0,2001.0,15.6,13,7,1,10,2,7,19,36.8,12,19,1,18,11,24,6,0,Matches,2022-2023,Ligue-1
Logan Costa,cv CPV,DF,Toulouse,21.0,2001.0,4.6,9,4,7,1,1,6,9,66.7,3,6,3,3,4,13,12,0,Matches,2022-2023,Ligue-1
Nuno da Costa,cv CPV,"FW,MF",Auxerre,31.0,1991.0,22.3,45,23,14,23,8,11,46,23.9,35,21,1,20,20,65,15,0,Matches,2022-2023,Ligue-1
Benoît Costil,fr FRA,GK,Auxerre,35.0,1987.0,19.0,2,0,2,0,0,2,4,50.0,2,0,0,0,0,2,5,0,Matches,2022-2023,Ligue-1
Mathieu Coutadeur,fr FRA,MF,Ajaccio,36.0,1986.0,21.6,23,13,13,10,0,8,28,28.6,20,19,3,16,19,42,21,0,Matches,2022-2023,Ligue-1
Nicolas Cozza,fr FRA,DF,Montpellier,23.0,1999.0,14.2,38,21,27,9,2,26,38,68.4,12,11,5,6,21,59,35,1,Matches,2022-2023,Ligue-1
Damien Da Silva,fr FRA,DF,Lyon,34.0,1988.0,3.8,8,7,5,3,0,3,3,100.0,0,4,3,1,5,13,12,0,Matches,2022-2023,Ligue-1
Andréa Dacourt,fr FRA,MF,Nice,17.0,2005.0,0.0,0,0,0,0,0,0,0,,0,0,0,0,0,0,0,0,Matches,2022-2023,Ligue-1
Colin Dagba,fr FRA,"DF,MF",Strasbourg,23.0,1998.0,10.6,32,20,17,10,5,19,26,73.1,7,18,2,16,17,49,19,0,Matches,2022-2023,Ligue-1
Thijs Dallinga,nl NED,FW,Toulouse,21.0,2000.0,26.1,8,6,2,2,4,1,13,7.7,12,17,3,14,3,11,20,0,Matches,2022-2023,Ligue-1
Flavius Daniliuc,at AUT,DF,Nice,21.0,2001.0,1.0,2,0,2,0,0,1,1,100.0,0,4,1,3,0,2,1,0,Matches,2022-2023,Ligue-1
Kévin Danois,fr FRA,MF,Auxerre,18.0,2004.0,0.0,1,1,0,1,0,0,0,,0,0,0,0,1,2,0,0,Matches,2022-2023,Ligue-1
Kevin Danso,at AUT,DF,Lens,23.0,1998.0,35.9,37,19,25,11,1,19,30,63.3,11,48,34,14,33,70,124,0,Matches,2022-2023,Ligue-1
Dante,br BRA,DF,Nice,38.0,1983.0,36.7,70,40,45,21,4,36,59,61.0,23,52,31,21,47,117,125,2,Matches,2022-2023,Ligue-1
Achraf Dari,ma MAR,DF,Brest,23.0,1999.0,14.6,21,14,15,5,1,14,20,70.0,6,16,10,6,19,40,65,2,Matches,2022-2023,Ligue-1
Jonathan David,ca CAN,FW,Lille,22.0,2000.0,35.2,24,17,6,11,7,10,27,37.0,17,20,2,18,8,32,13,0,Matches,2022-2023,Ligue-1
Thibault De Smet,be BEL,DF,Reims,24.0,1998.0,19.5,24,17,10,14,0,11,37,29.7,26,28,5,23,20,44,40,1,Matches,2022-2023,Ligue-1
Brecht Dejaegere,be BEL,MF,Toulouse,31.0,1991.0,20.1,40,23,10,20,10,15,51,29.4,36,25,5,20,14,54,11,0,Matches,2022-2023,Ligue-1
Romain Del Castillo,fr FRA,"MF,FW",Brest,26.0,1996.0,15.8,39,24,13,17,9,16,36,44.4,20,14,1,13,11,50,5,0,Matches,2022-2023,Ligue-1
Thomas Delaine,fr FRA,"DF,MF",Strasbourg,30.0,1992.0,11.9,28,14,16,6,6,13,26,50.0,13,8,3,5,16,44,9,0,Matches,2022-2023,Ligue-1
Sacha Delaye,fr FRA,"FW,MF",Montpellier,20.0,2002.0,0.2,1,0,0,0,1,1,1,100.0,0,0,0,0,0,1,0,0,Matches,2022-2023,Ligue-1
Andy Delort,dz ALG,FW,Nice,30.0,1991.0,8.7,2,0,1,1,0,1,2,50.0,1,0,0,0,1,3,7,0,Matches,2022-2023,Ligue-1
Andy Delort,dz ALG,FW,Nantes,30.0,1991.0,5.2,5,4,1,2,2,2,6,33.3,4,3,0,3,0,5,2,0,Matches,2022-2023,Ligue-1
Karamoko Dembélé,eng ENG,"FW,MF",Brest,19.0,2003.0,2.0,2,0,1,1,0,2,2,100.0,0,1,0,1,1,3,0,0,Matches,2022-2023,Ligue-1
Moussa Dembélé,fr FRA,"FW,MF",Lyon,26.0,1996.0,9.7,8,4,3,3,2,4,7,57.1,3,5,0,5,2,10,6,0,Matches,2022-2023,Ligue-1
Siriki Dembélé,ci CIV,"MF,FW",Auxerre,25.0,1996.0,4.1,10,6,4,3,3,4,12,33.3,8,2,0,2,1,11,2,0,Matches,2022-2023,Ligue-1
Branco van den Boomen,nl NED,MF,Toulouse,27.0,1995.0,32.1,71,36,26,32,13,36,89,40.4,53,27,4,23,10,81,27,2,Matches,2022-2023,Ligue-1
Rémy Descamps,fr FRA,GK,Nantes,26.0,1996.0,1.0,0,0,0,0,0,0,0,,0,0,0,0,0,0,0,0,Matches,2022-2023,Ligue-1
Mikkel Desler,dk DEN,DF,Toulouse,27.0,1995.0,25.1,71,38,36,27,8,43,67,64.2,24,35,6,29,36,107,48,2,Matches,2022-2023,Ligue-1
Mamadou Diakhon,fr FRA,FW,Reims,16.0,2005.0,0.2,2,0,2,0,0,0,1,0.0,1,1,0,1,1,3,0,0,Matches,2022-2023,Ligue-1
Bafodé Diakité,fr FRA,DF,Lille,21.0,2001.0,29.5,54,35,23,24,7,32,57,56.1,25,37,8,29,17,71,58,0,Matches,2022-2023,Ligue-1
Ibrahim Diakité,gn GUI,DF,Reims,18.0,2003.0,1.5,3,3,3,0,0,2,3,66.7,1,0,0,0,5,8,6,0,Matches,2022-2023,Ligue-1
Baila Diallo,fr FRA,"DF,MF",Clermont Foot,21.0,2001.0,1.0,1,0,1,0,0,0,0,,0,1,1,0,0,1,1,0,Matches,2022-2023,Ligue-1
Habib Diallo,sn SEN,FW,Strasbourg,27.0,1995.0,32.0,18,10,8,7,3,6,16,37.5,10,19,4,15,12,30,26,0,Matches,2022-2023,Ligue-1
Ismael Diallo,ci CIV,DF,Ajaccio,25.0,1997.0,24.2,46,33,35,9,2,35,63,55.6,28,26,12,14,30,76,46,1,Matches,2022-2023,Ligue-1
Habib Diarra,sn SEN,"MF,FW",Strasbourg,18.0,2004.0,18.1,24,16,10,11,3,15,29,51.7,14,17,1,16,11,35,13,0,Matches,2022-2023,Ligue-1
Moussa Diarra,ml MLI,DF,Toulouse,21.0,2000.0,13.6,20,9,9,9,2,9,15,60.0,6,25,10,15,19,39,27,1,Matches,2022-2023,Ligue-1
Stéphane Diarra,fr FRA,"FW,MF",Lorient,23.0,1998.0,11.8,25,17,14,9,2,11,29,37.9,18,13,1,12,22,47,9,0,Matches,2022-2023,Ligue-1
Krépin Diatta,sn SEN,"MF,FW",Monaco,23.0,1999.0,23.0,30,21,4,17,9,13,32,40.6,19,29,1,28,17,47,12,0,Matches,2022-2023,Ligue-1
Mory Diaw,sn SEN,GK,Clermont Foot,29.0,1993.0,37.0,0,0,0,0,0,0,4,0.0,4,0,0,0,2,2,13,5,Matches,2022-2023,Ligue-1
Bamba Dieng,sn SEN,"FW,MF",Marseille,22.0,2000.0,2.2,4,4,2,1,1,3,4,75.0,1,5,1,4,0,4,0,0,Matches,2022-2023,Ligue-1
Bamba Dieng,sn SEN,FW,Lorient,22.0,2000.0,8.3,19,10,5,12,2,3,11,27.3,8,6,0,6,2,21,6,0,Matches,2022-2023,Ligue-1
Tristan Dingomé,cm CMR,MF,Troyes,31.0,1991.0,1.1,1,1,0,1,0,0,2,0.0,2,0,0,0,0,1,0,0,Matches,2022-2023,Ligue-1
Sinaly Diomande,ci CIV,DF,Lyon,21.0,2001.0,21.7,42,24,26,15,1,31,49,63.3,18,26,13,13,49,91,75,1,Matches,2022-2023,Ligue-1
Lois Diony,fr FRA,FW,Angers,29.0,1992.0,5.6,1,0,0,1,0,1,3,33.3,2,2,0,2,0,1,1,0,Matches,2022-2023,Ligue-1
Edan Diop,fr FRA,"DF,FW",Monaco,17.0,2004.0,2.5,13,8,3,3,7,7,15,46.7,8,7,1,6,4,17,1,0,Matches,2022-2023,Ligue-1
Sofiane Diop,fr FRA,"MF,FW",Nice,22.0,2000.0,13.6,23,11,12,6,5,7,20,35.0,13,14,2,12,16,39,5,0,Matches,2022-2023,Ligue-1
Sofiane Diop,fr FRA,MF,Monaco,22.0,2000.0,0.7,0,0,0,0,0,0,0,,0,0,0,0,1,1,0,0,Matches,2022-2023,Ligue-1
Yehvann Diouf,fr FRA,GK,Reims,22.0,1999.0,31.0,2,0,2,0,0,1,3,33.3,2,0,0,0,1,3,13,5,Matches,2022-2023,Ligue-1
Axel Disasi,fr FRA,DF,Monaco,24.0,1998.0,37.0,30,20,13,13,4,13,27,48.1,14,51,31,20,56,86,112,2,Matches,2022-2023,Ligue-1
Tiago Djaló,pt POR,DF,Lille,22.0,2000.0,22.4,31,21,23,7,1,13,20,65.0,7,17,11,6,23,54,60,1,Matches,2022-2023,Ligue-1
Alexander Djiku,gh GHA,DF,Strasbourg,27.0,1994.0,29.7,53,36,37,16,0,26,46,56.5,20,45,19,26,66,119,151,3,Matches,2022-2023,Ligue-1
Moussa Djitte,sn SEN,FW,Ajaccio,22.0,1999.0,1.5,1,0,0,0,1,1,2,50.0,1,0,0,0,0,1,1,0,Matches,2022-2023,Ligue-1
Ouparine Djoco,gw GNB,GK,Clermont Foot,24.0,1998.0,1.0,0,0,0,0,0,0,0,,0,0,0,0,0,0,1,0,Matches,2022-2023,Ligue-1
Alan Do Marcolino,ga GAB,FW,Rennes,20.0,2002.0,0.2,0,0,0,0,0,0,0,,0,0,0,0,0,0,1,0,Matches,2022-2023,Ligue-1
Jeremy Doku,be BEL,"MF,FW",Rennes,20.0,2002.0,14.3,25,16,6,13,6,12,24,50.0,12,10,0,10,5,30,2,0,Matches,2022-2023,Ligue-1
Kyliane Dong,fr FRA,"MF,FW",Troyes,17.0,2004.0,2.4,3,1,0,2,1,1,2,50.0,1,1,0,1,1,4,0,0,Matches,2022-2023,Ligue-1
Jordan Dongmo,cm CMR,MF,Troyes,21.0,2001.0,0.2,1,0,0,1,0,1,1,100.0,0,0,0,0,0,1,0,0,Matches,2022-2023,Ligue-1
Gianluigi Donnarumma,it ITA,GK,Paris S-G,23.0,1999.0,37.9,1,0,1,0,0,1,2,50.0,1,0,0,0,0,1,12,4,Matches,2022-2023,Ligue-1
Jodel Dossou,bj BEN,"MF,DF",Clermont Foot,30.0,1992.0,2.9,7,4,3,2,2,4,4,100.0,0,2,1,1,1,8,0,0,Matches,2022-2023,Ligue-1
Lohann Doucet,fr FRA,"MF,FW",Nantes,19.0,2002.0,1.0,3,0,2,0,1,3,4,75.0,1,2,0,2,2,5,4,0,Matches,2022-2023,Ligue-1
Siriné Doucouré,ml MLI,"FW,MF",Lorient,20.0,2002.0,1.5,2,2,2,0,0,1,2,50.0,1,0,0,0,1,3,0,0,Matches,2022-2023,Ligue-1
Désiré Doué,fr FRA,"MF,FW",Rennes,17.0,2005.0,12.4,37,18,10,23,4,13,32,40.6,19,17,1,16,13,50,3,0,Matches,2022-2023,Ligue-1
Guela Doué,ci CIV,"FW,MF",Rennes,19.0,2002.0,0.1,0,0,0,0,0,0,0,,0,0,0,0,0,0,0,0,Matches,2022-2023,Ligue-1
Ismaël Doukouré,fr FRA,"DF,MF",Strasbourg,19.0,2003.0,25.5,48,24,23,21,4,20,34,58.8,14,26,8,18,27,75,54,0,Matches,2022-2023,Ligue-1
Kamory Doumbia,ml MLI,MF,Reims,19.0,2003.0,12.8,31,16,9,14,8,12,37,32.4,25,17,1,16,13,44,3,0,Matches,2022-2023,Ligue-1
Souleyman Doumbia,ci CIV,"DF,FW",Angers,25.0,1996.0,19.9,45,31,31,13,1,17,31,54.8,14,20,3,17,27,72,27,1,Matches,2022-2023,Ligue-1
Rémy Dugimont,fr FRA,"FW,MF",Auxerre,36.0,1986.0,1.3,2,1,0,1,1,1,2,50.0,1,3,0,3,0,2,5,0,Matches,2022-2023,Ligue-1
Maxime Dupé,fr FRA,GK,Toulouse,29.0,1993.0,38.0,0,0,0,0,0,0,0,,0,0,0,0,0,0,9,3,Matches,2022-2023,Ligue-1
Jean-Kevin Duverne,ht HAI,DF,Brest,25.0,1997.0,27.9,72,38,44,24,4,42,73,57.5,31,33,5,28,28,100,65,1,Matches,2022-2023,Ligue-1
Hugo Ekitike,fr FRA,FW,Paris S-G,20.0,2002.0,12.8,12,4,1,10,1,4,12,33.3,8,12,0,12,9,21,3,0,Matches,2022-2023,Ligue-1
Alberth Elis,hn HON,"MF,FW",Brest,26.0,1996.0,2.9,4,3,1,2,1,1,7,14.3,6,1,0,1,1,5,2,0,Matches,2022-2023,Ligue-1
Breel Embolo,ch SUI,FW,Monaco,25.0,1997.0,20.7,15,9,2,7,6,5,10,50.0,5,14,3,11,5,20,12,0,Matches,2022-2023,Ligue-1
Maxime Estève,fr FRA,DF,Montpellier,20.0,2002.0,18.3,24,13,17,5,2,12,17,70.6,5,28,17,11,34,58,90,0,Matches,2022-2023,Ligue-1
Fábio,br BRA,"DF,MF",Nantes,32.0,1990.0,2.5,4,2,1,2,1,4,6,66.7,2,2,0,2,3,7,11,0,Matches,2022-2023,Ligue-1
Noah Fadiga,sn SEN,DF,Brest,22.0,1999.0,14.5,30,21,18,9,3,14,26,53.8,12,17,7,10,26,56,18,0,Matches,2022-2023,Ligue-1
Wout Faes,be BEL,DF,Reims,24.0,1998.0,3.0,1,1,1,0,0,1,2,50.0,1,6,3,3,7,8,19,0,Matches,2022-2023,Ligue-1
Romain Faivre,fr FRA,"MF,FW",Lorient,24.0,1998.0,13.8,13,8,5,4,4,5,25,20.0,20,11,0,11,1,14,4,0,Matches,2022-2023,Ligue-1
Romain Faivre,fr FRA,MF,Lyon,24.0,1998.0,3.3,6,3,2,2,2,1,3,33.3,2,3,0,3,0,6,0,0,Matches,2022-2023,Ligue-1
Fallou Fall,sn SEN,DF,Reims,18.0,2004.0,0.4,0,0,0,0,0,0,1,0.0,1,3,3,0,0,0,4,0,Matches,2022-2023,Ligue-1
Khalil Fayad,fr FRA,MF,Montpellier,18.0,2004.0,8.0,30,14,12,16,2,12,21,57.1,9,8,1,7,9,39,4,0,Matches,2022-2023,Ligue-1
Cheikh Faye,sn SEN,FW,Montpellier,23.0,1999.0,0.4,0,0,0,0,0,0,0,,0,0,0,0,1,1,0,0,Matches,2022-2023,Ligue-1
Jordan Ferri,fr FRA,MF,Montpellier,30.0,1992.0,30.4,55,35,32,19,4,30,89,33.7,59,22,6,16,26,81,21,0,Matches,2022-2023,Ligue-1
Karol Fila,pl POL,DF,Strasbourg,24.0,1998.0,0.5,0,0,0,0,0,0,0,,0,0,0,0,1,1,1,0,Matches,2022-2023,Ligue-1
Alexis Flips,fr FRA,"FW,MF",Reims,22.0,2000.0,22.0,51,30,18,17,16,27,64,42.2,37,35,5,30,24,75,12,0,Matches,2022-2023,Ligue-1
Seko Fofana,ci CIV,MF,Lens,27.0,1995.0,34.1,28,13,8,18,2,15,39,38.5,24,17,4,13,19,47,14,0,Matches,2022-2023,Ligue-1
Yahia Fofana,ci CIV,GK,Angers,21.0,2000.0,11.0,0,0,0,0,0,0,0,,0,0,0,0,1,1,4,1,Matches,2022-2023,Ligue-1
Youssouf Fofana,fr FRA,MF,Monaco,23.0,1999.0,34.3,81,41,31,42,8,38,74,51.4,36,50,6,44,56,137,32,1,Matches,2022-2023,Ligue-1
Thomas Foket,be BEL,DF,Reims,27.0,1994.0,22.0,35,22,18,11,6,17,46,37.0,29,21,7,14,33,68,29,2,Matches,2022-2023,Ligue-1
José Fonte,pt POR,DF,Lille,38.0,1983.0,28.8,23,17,18,4,1,10,21,47.6,11,27,14,13,25,48,112,2,Matches,2022-2023,Ligue-1
Steven Fortes,cv CPV,DF,Lens,30.0,1992.0,0.1,0,0,0,0,0,0,0,,0,0,0,0,0,0,0,0,Matches,2022-2023,Ligue-1
Przemysław Frankowski,pl POL,"DF,MF",Lens,27.0,1995.0,31.5,77,51,37,31,9,39,80,48.8,41,38,6,32,41,118,42,2,Matches,2022-2023,Ligue-1
Angelo Fulgini,fr FRA,"MF,FW",Lens,25.0,1996.0,9.5,14,7,2,4,8,5,14,35.7,9,11,0,11,8,22,2,0,Matches,2022-2023,Ligue-1
Gauthier Gallon,fr FRA,GK,Troyes,29.0,1993.0,29.6,2,2,2,0,0,2,4,50.0,2,0,0,0,2,4,17,0,Matches,2022-2023,Ligue-1
Kévin Gameiro,fr FRA,FW,Strasbourg,35.0,1987.0,23.3,20,10,6,10,4,8,28,28.6,20,10,1,9,9,29,0,0,Matches,2022-2023,Ligue-1
Ignatius Ganago,cm CMR,"FW,MF",Nantes,23.0,1999.0,16.9,9,7,2,3,4,4,7,57.1,3,13,1,12,2,11,12,0,Matches,2022-2023,Ligue-1
Ignatius Ganago,cm CMR,FW,Lens,23.0,1999.0,0.7,0,0,0,0,0,0,0,,0,0,0,0,0,0,1,0,Matches,2022-2023,Ligue-1
Johan Gastien,fr FRA,MF,Clermont Foot,34.0,1988.0,28.9,62,34,30,23,9,38,111,34.2,73,37,7,30,36,98,25,1,Matches,2022-2023,Ligue-1
Denis Genreau,au AUS,MF,Toulouse,23.0,1999.0,7.3,35,13,16,12,7,13,31,41.9,18,16,1,15,8,43,9,0,Matches,2022-2023,Ligue-1
Valère Germain,fr FRA,"FW,MF",Montpellier,32.0,1990.0,7.6,13,11,3,5,5,4,12,33.3,8,8,0,8,6,19,12,0,Matches,2022-2023,Ligue-1
Gerson,br BRA,MF,Marseille,25.0,1997.0,4.6,6,4,1,4,1,3,5,60.0,2,5,0,5,2,8,4,0,Matches,2022-2023,Ligue-1
Ismaël Gharbi,es ESP,"MF,FW",Paris S-G,18.0,2004.0,0.6,0,0,0,0,0,0,2,0.0,2,2,0,2,3,3,0,0,Matches,2022-2023,Ligue-1
Faouzi Ghoulam,dz ALG,DF,Angers,31.0,1991.0,5.3,3,3,1,1,1,3,5,60.0,2,4,2,2,4,7,12,1,Matches,2022-2023,Ligue-1
Samuel Gigot,fr FRA,DF,Marseille,28.0,1993.0,20.9,46,24,22,21,3,12,15,80.0,3,24,7,17,45,91,85,1,Matches,2022-2023,Ligue-1
Andrei Girotto,br BRA,"DF,MF",Nantes,30.0,1992.0,35.0,122,73,71,45,6,74,132,56.1,58,55,24,31,73,195,176,1,Matches,2022-2023,Ligue-1
Aleksandr Golovin,ru RUS,"MF,FW",Monaco,26.0,1996.0,27.4,62,36,19,32,11,28,72,38.9,44,28,1,27,37,99,10,0,Matches,2022-2023,Ligue-1
André Gomes,pt POR,MF,Lille,29.0,1993.0,18.1,37,19,12,17,8,19,52,36.5,33,20,5,15,9,46,16,1,Matches,2022-2023,Ligue-1
Angel Gomes,eng ENG,MF,Lille,21.0,2000.0,31.3,41,19,12,21,8,18,49,36.7,31,22,2,20,13,54,11,1,Matches,2022-2023,Ligue-1
Maxime Gonalons,fr FRA,MF,Clermont Foot,33.0,1989.0,16.1,52,32,25,21,6,25,53,47.2,28,21,1,20,20,72,7,1,Matches,2022-2023,Ligue-1
Oumar Gonzalez,cm CMR,DF,Ajaccio,24.0,1998.0,28.6,51,28,34,13,4,23,37,62.2,14,32,11,21,52,103,82,0,Matches,2022-2023,Ligue-1
Amine Gouiri,dz ALG,"FW,MF",Nice,22.0,2000.0,2.5,1,1,1,0,0,0,1,0.0,1,1,0,1,0,1,3,0,Matches,2022-2023,Ligue-1
Amine Gouiri,dz ALG,"FW,MF",Rennes,22.0,2000.0,28.0,42,25,14,16,12,14,33,42.4,19,21,0,21,12,54,10,0,Matches,2022-2023,Ligue-1
Jonathan Gradit,fr FRA,DF,Lens,29.0,1992.0,31.4,62,40,30,25,7,31,53,58.5,22,40,26,14,38,100,83,0,Matches,2022-2023,Ligue-1
Andrew Gravillon,gp GLP,DF,Reims,24.0,1998.0,11.5,16,8,9,6,1,8,13,61.5,5,18,9,9,21,37,36,0,Matches,2022-2023,Ligue-1
Adrian Grbić,at AUT,"MF,FW",Lorient,25.0,1996.0,0.3,0,0,0,0,0,0,1,0.0,1,3,0,3,0,0,0,0,Matches,2022-2023,Ligue-1
Gabriel Gudmundsson,se SWE,"DF,FW",Lille,23.0,1999.0,9.3,19,11,7,10,2,12,22,54.5,10,11,2,9,10,29,20,0,Matches,2022-2023,Ligue-1
Axel Gueguin,fr FRA,"FW,MF",Montpellier,17.0,2005.0,0.3,0,0,0,0,0,0,0,,0,1,0,1,0,0,0,0,Matches,2022-2023,Ligue-1
Mattéo Guendouzi,fr FRA,MF,Marseille,23.0,1999.0,23.4,39,18,9,21,9,14,38,36.8,24,12,5,7,21,60,18,0,Matches,2022-2023,Ligue-1
Evann Guessand,ci CIV,"FW,MF",Nantes,21.0,2001.0,14.0,24,16,8,13,3,6,12,50.0,6,17,1,16,9,33,6,0,Matches,2022-2023,Ligue-1
Pape Gueye,sn SEN,"MF,DF",Marseille,23.0,1999.0,5.5,18,7,10,7,1,7,15,46.7,8,9,2,7,9,27,2,0,Matches,2022-2023,Ligue-1
Frederic Guilbert,fr FRA,DF,Strasbourg,27.0,1994.0,16.2,47,29,18,23,6,25,43,58.1,18,24,3,21,43,90,33,1,Matches,2022-2023,Ligue-1
Serhou Guirassy,gn GUI,MF,Rennes,26.0,1996.0,0.3,0,0,0,0,0,0,0,,0,0,0,0,0,0,0,0,Matches,2022-2023,Ligue-1
Rafik Guitane,fr FRA,FW,Reims,23.0,1999.0,0.0,0,0,0,0,0,0,0,,0,0,0,0,0,0,1,0,Matches,2022-2023,Ligue-1
Malo Gusto,fr FRA,DF,Lyon,19.0,2003.0,17.7,42,26,23,11,8,21,43,48.8,22,22,5,17,28,70,23,1,Matches,2022-2023,Ligue-1
Jaouen Hadjam,dz ALG,DF,Nantes,19.0,2003.0,8.9,27,21,13,9,5,16,25,64.0,9,10,3,7,12,39,12,0,Matches,2022-2023,Ligue-1
Massadio Haïdara,ml MLI,"DF,MF",Lens,29.0,1992.0,18.6,24,16,9,9,6,12,24,50.0,12,26,9,17,36,60,39,1,Matches,2022-2023,Ligue-1
Achraf Hakimi,ma MAR,"DF,MF",Paris S-G,23.0,1998.0,22.8,54,34,19,20,15,31,59,52.5,28,34,2,32,16,70,19,0,Matches,2022-2023,Ligue-1
Mathis Hamdi,fr FRA,DF,Troyes,18.0,2003.0,0.8,0,0,0,0,0,0,1,0.0,1,0,0,0,1,1,1,0,Matches,2022-2023,Ligue-1
Ben Hamed Touré,ci CIV,FW,Ajaccio,18.0,2003.0,2.3,4,4,2,2,0,1,5,20.0,4,2,0,2,1,5,4,0,Matches,2022-2023,Ligue-1
Romain Hamouma,fr FRA,"FW,MF",Ajaccio,35.0,1987.0,12.0,8,3,3,3,2,3,6,50.0,3,8,0,8,2,10,2,0,Matches,2022-2023,Ligue-1
Saïd Hamulic,ba BIH,FW,Toulouse,21.0,2000.0,1.2,0,0,0,0,0,0,0,,0,0,0,0,0,0,0,0,Matches,2022-2023,Ligue-1
Amine Harit,ma MAR,"MF,FW",Marseille,25.0,1997.0,5.7,6,4,0,3,3,3,8,37.5,5,4,1,3,4,10,6,0,Matches,2022-2023,Ligue-1
Rhys Healey,wls WAL,FW,Toulouse,27.0,1994.0,0.7,0,0,0,0,0,0,0,,0,0,0,0,0,0,0,0,Matches,2022-2023,Ligue-1
Gauthier Hein,fr FRA,"MF,FW",Auxerre,25.0,1996.0,20.8,27,20,13,11,3,18,48,37.5,30,10,0,10,6,33,10,0,Matches,2022-2023,Ligue-1
Henrique,br BRA,"DF,FW",Lyon,28.0,1994.0,4.0,9,4,3,2,4,6,13,46.2,7,3,1,2,5,14,8,0,Matches,2022-2023,Ligue-1
Christophe Hérelle,mq MTQ,DF,Brest,29.0,1992.0,11.8,10,4,7,2,1,4,13,30.8,9,16,11,5,20,30,48,0,Matches,2022-2023,Ligue-1
Noah Holm,no NOR,"FW,MF",Reims,21.0,2001.0,2.2,6,4,2,2,2,2,5,40.0,3,0,0,0,0,6,5,0,Matches,2022-2023,Ligue-1
Franck Honorat,fr FRA,"FW,MF",Brest,25.0,1996.0,28.2,41,29,20,8,13,19,34,55.9,15,22,2,20,21,62,18,0,Matches,2022-2023,Ligue-1
Cédric Hountondji,bj BEN,DF,Angers,28.0,1994.0,34.4,50,36,31,17,2,19,29,65.5,10,44,22,22,59,109,132,1,Matches,2022-2023,Ligue-1
Ilyes Housni,fr FRA,FW,Paris S-G,17.0,2005.0,0.1,1,1,1,0,0,1,1,100.0,0,0,0,0,0,1,0,0,Matches,2022-2023,Ligue-1
Adrien Hunou,fr FRA,"MF,FW",Angers,28.0,1994.0,24.8,39,20,17,16,6,16,45,35.6,29,35,0,35,7,46,7,0,Matches,2022-2023,Ligue-1
Mounaim El Idrissy,fr FRA,FW,Ajaccio,23.0,1999.0,27.7,32,19,5,20,7,10,36,27.8,26,22,0,22,13,45,20,0,Matches,2022-2023,Ligue-1
Rareş Ilie,ro ROU,"MF,FW",Nice,19.0,2003.0,1.6,3,3,0,1,2,2,4,50.0,2,2,0,2,1,4,1,0,Matches,2022-2023,Ligue-1
Bonke Innocent,ng NGA,MF,Lorient,26.0,1996.0,13.1,28,17,13,14,1,11,36,30.6,25,22,5,17,26,54,31,0,Matches,2022-2023,Ligue-1
Ismaily,br BRA,DF,Lille,32.0,1990.0,19.8,41,18,16,16,9,17,32,53.1,15,25,5,20,21,62,39,0,Matches,2022-2023,Ligue-1
Junya Ito,jp JPN,FW,Reims,29.0,1993.0,32.4,40,20,14,15,11,13,53,24.5,40,29,1,28,8,48,4,1,Matches,2022-2023,Ligue-1
Ismail Jakobs,sn SEN,"DF,FW",Monaco,22.0,1999.0,12.4,11,5,7,3,1,5,12,41.7,7,9,1,8,9,20,18,0,Matches,2022-2023,Ligue-1
Marin Jakoliš,hr CRO,FW,Angers,25.0,1996.0,0.3,1,1,0,0,1,0,0,,0,0,0,0,0,1,0,0,Matches,2022-2023,Ligue-1
Léo Jardim,br BRA,GK,Lille,27.0,1995.0,6.0,0,0,0,0,0,0,1,0.0,1,0,0,0,0,0,0,1,Matches,2022-2023,Ligue-1
Luis Javier Suárez,co COL,FW,Marseille,24.0,1997.0,3.3,4,1,1,2,1,1,4,25.0,3,1,0,1,3,7,6,0,Matches,2022-2023,Ligue-1
Dany Jean,ht HAI,"DF,MF",Strasbourg,19.0,2002.0,0.1,0,0,0,0,0,0,1,0.0,1,1,0,1,0,0,0,0,Matches,2022-2023,Ligue-1
Julian Jeanvier,gn GUI,DF,Auxerre,30.0,1992.0,19.6,32,17,24,8,0,13,22,59.1,9,24,17,7,27,59,96,1,Matches,2022-2023,Ligue-1
Jeffinho,br BRA,FW,Lyon,22.0,1999.0,5.0,17,4,4,9,4,6,15,40.0,9,6,0,6,1,18,0,0,Matches,2022-2023,Ligue-1
Paul Joly,fr FRA,DF,Auxerre,22.0,2000.0,9.6,33,21,21,10,2,19,35,54.3,16,13,2,11,24,57,29,2,Matches,2022-2023,Ligue-1
Jubal,br BRA,DF,Auxerre,28.0,1993.0,35.7,41,26,29,11,1,19,38,50.0,19,57,34,23,53,94,193,0,Matches,2022-2023,Ligue-1
Christopher Jullien,fr FRA,DF,Montpellier,29.0,1993.0,29.9,46,28,29,14,3,28,51,54.9,23,35,18,17,43,89,114,1,Matches,2022-2023,Ligue-1
Eli Junior Kroupi,fr FRA,"FW,MF",Lorient,16.0,2006.0,0.1,0,0,0,0,0,0,1,0.0,1,0,0,0,1,1,0,0,Matches,2022-2023,Ligue-1
Issa Kaboré,bf BFA,DF,Marseille,21.0,2001.0,11.4,33,19,10,18,5,21,32,65.6,11,11,1,10,12,45,21,1,Matches,2022-2023,Ligue-1
Abdoul Kader Bamba,fr FRA,"FW,MF",Nantes,28.0,1994.0,0.9,0,0,0,0,0,0,2,0.0,2,3,1,2,0,0,1,0,Matches,2022-2023,Ligue-1
Gaël Kakuta,cd COD,FW,Lens,31.0,1991.0,0.2,0,0,0,0,0,0,0,,0,0,0,0,0,0,1,0,Matches,2022-2023,Ligue-1
Arnaud Kalimuendo,fr FRA,FW,Rennes,20.0,2002.0,20.5,15,8,3,6,6,5,20,25.0,15,15,2,13,2,17,9,0,Matches,2022-2023,Ligue-1
Gedeon Kalulu,cd COD,DF,Lorient,24.0,1997.0,27.1,64,34,43,14,7,30,48,62.5,18,32,3,29,28,92,79,2,Matches,2022-2023,Ligue-1
Justin-Noël Kalumba,fr FRA,DF,Angers,17.0,2004.0,6.1,9,5,5,2,2,5,16,31.3,11,4,1,3,4,13,5,0,Matches,2022-2023,Ligue-1
Waren Kamanzi,no NOR,DF,Toulouse,21.0,2000.0,7.4,16,9,9,5,2,13,19,68.4,6,8,2,6,8,24,9,0,Matches,2022-2023,Ligue-1
Bingourou Kamara,sn SEN,GK,Montpellier,25.0,1996.0,4.5,0,0,0,0,0,0,0,,0,0,0,0,0,0,2,0,Matches,2022-2023,Ligue-1
Nordine Kandil,fr FRA,"MF,FW",Strasbourg,20.0,2001.0,1.1,3,2,1,2,0,0,3,0.0,3,2,0,2,1,4,1,0,Matches,2022-2023,Ligue-1
Ayman Kari,fr FRA,"MF,DF",Lorient,17.0,2004.0,1.1,0,0,0,0,0,0,0,,0,4,0,4,3,3,0,0,Matches,2022-2023,Ligue-1
Kévin Keben Biakolo,cm CMR,DF,Toulouse,18.0,2004.0,4.0,3,2,2,0,1,0,4,0.0,4,1,0,1,5,8,9,0,Matches,2022-2023,Ligue-1
Check Keita,fr FRA,DF,Reims,19.0,2003.0,7.6,12,9,9,3,0,4,9,44.4,5,6,5,1,5,17,24,1,Matches,2022-2023,Ligue-1
Saîf-Eddine Khaoui,tn TUN,MF,Clermont Foot,27.0,1995.0,22.5,47,28,14,25,8,15,47,31.9,32,17,2,15,33,80,8,0,Matches,2022-2023,Ligue-1
Wahbi Khazri,tn TUN,"FW,MF",Montpellier,31.0,1991.0,18.2,26,13,13,7,6,6,25,24.0,19,17,1,16,9,35,20,0,Matches,2022-2023,Ligue-1
Anthony Khelifa,dz ALG,DF,Ajaccio,16.0,2005.0,0.1,0,0,0,0,0,0,0,,0,0,0,0,0,0,0,0,Matches,2022-2023,Ligue-1
Presnel Kimpembe,fr FRA,DF,Paris S-G,26.0,1995.0,8.1,17,8,9,6,2,9,13,69.2,4,12,7,5,13,30,9,1,Matches,2022-2023,Ligue-1
Samuel Koeberlé,fr FRA,MF,Reims,17.0,2004.0,0.0,0,0,0,0,0,0,0,,0,0,0,0,0,0,0,0,Matches,2022-2023,Ligue-1
Rudy Kohon,fr FRA,DF,Troyes,18.0,2004.0,0.7,4,3,4,0,0,2,2,100.0,0,1,0,1,1,5,2,0,Matches,2022-2023,Ligue-1
Sead Kolašinac,ba BIH,DF,Marseille,29.0,1993.0,24.6,52,36,24,22,6,24,37,64.9,13,19,2,17,43,95,35,1,Matches,2022-2023,Ligue-1
Cheick Konaté,ml MLI,DF,Clermont Foot,18.0,2004.0,6.4,19,12,10,7,2,13,22,59.1,9,7,1,6,13,32,8,1,Matches,2022-2023,Ligue-1
Ibrahima Koné,ml MLI,FW,Lorient,23.0,1999.0,17.5,24,13,3,13,8,5,11,45.5,6,13,0,13,4,28,18,0,Matches,2022-2023,Ligue-1
Youssouf Koné,ml MLI,DF,Ajaccio,27.0,1995.0,10.2,28,19,24,4,0,18,25,72.0,7,9,2,7,12,40,32,1,Matches,2022-2023,Ligue-1
Rominigue Kouamé,ml MLI,MF,Troyes,25.0,1996.0,29.6,44,27,28,14,2,17,41,41.5,24,32,11,21,49,93,46,1,Matches,2022-2023,Ligue-1
Boubakar Kouyaté,ml MLI,DF,Montpellier,25.0,1997.0,14.0,31,18,18,11,2,19,35,54.3,16,24,14,10,34,65,73,1,Matches,2022-2023,Ligue-1
Sael Kumbedi,fr FRA,DF,Lyon,17.0,2005.0,14.7,47,27,27,13,7,20,38,52.6,18,23,7,16,10,57,16,0,Matches,2022-2023,Ligue-1
Grejohn Kyei,fr FRA,FW,Clermont Foot,26.0,1995.0,24.8,16,7,2,9,5,4,13,30.8,9,14,3,11,6,22,22,0,Matches,2022-2023,Ligue-1
Rémy Labeau Lascary,gp GLP,"FW,MF",Lens,19.0,2003.0,1.4,4,2,4,0,0,0,0,,0,4,0,4,1,5,0,0,Matches,2022-2023,Ligue-1
Gaëtan Laborde,fr FRA,FW,Nice,28.0,1994.0,27.8,45,25,13,17,15,18,40,45.0,22,27,2,25,9,54,13,0,Matches,2022-2023,Ligue-1
Gaëtan Laborde,fr FRA,FW,Rennes,28.0,1994.0,2.8,1,1,1,0,0,0,1,0.0,1,1,0,1,0,1,1,0,Matches,2022-2023,Ligue-1
Alexandre Lacazette,fr FRA,FW,Lyon,31.0,1991.0,32.5,43,23,7,17,19,10,29,34.5,19,23,3,20,15,58,4,0,Matches,2022-2023,Ligue-1
Qazim Laçi,al ALB,MF,Ajaccio,26.0,1996.0,2.4,6,3,2,3,1,4,9,44.4,5,5,0,5,2,8,3,0,Matches,2022-2023,Ligue-1
Alban Lafont,fr FRA,GK,Nantes,23.0,1999.0,37.0,0,0,0,0,0,0,1,0.0,1,0,0,0,0,0,20,4,Matches,2022-2023,Ligue-1
Kenny Lala,mg MAD,DF,Brest,30.0,1991.0,15.7,36,19,19,15,2,22,38,57.9,16,15,5,10,21,57,28,0,Matches,2022-2023,Ligue-1
Mohamed Lamine Bayo,gn GUI,"FW,MF",Lille,24.0,1998.0,7.2,3,3,0,2,1,0,12,0.0,12,3,1,2,0,3,1,0,Matches,2022-2023,Ligue-1
Julien Laporte,fr FRA,DF,Lorient,28.0,1993.0,18.4,22,16,18,3,1,16,22,72.7,6,33,27,6,18,40,108,2,Matches,2022-2023,Ligue-1
Yasser Larouci,dz ALG,"DF,MF",Troyes,21.0,2001.0,20.0,23,13,13,8,2,15,24,62.5,9,15,1,14,26,49,46,0,Matches,2022-2023,Ligue-1
Armand Lauriente,fr FRA,FW,Lorient,23.0,1998.0,3.0,8,7,3,4,1,3,7,42.9,4,5,1,4,4,12,1,0,Matches,2022-2023,Ligue-1
Théo Le Bris,fr FRA,"MF,DF",Lorient,19.0,2002.0,16.1,31,19,17,11,3,15,33,45.5,18,21,2,19,18,49,31,0,Matches,2022-2023,Ligue-1
Julien Le Cardinal,fr FRA,DF,Lens,24.0,1997.0,1.8,6,4,5,0,1,4,6,66.7,2,3,0,3,2,8,5,0,Matches,2022-2023,Ligue-1
Jérémy Le Douaron,fr FRA,"MF,FW",Brest,24.0,1998.0,23.0,15,9,5,9,1,3,27,11.1,24,29,2,27,11,26,30,0,Matches,2022-2023,Ligue-1
Enzo Le Fée,fr FRA,MF,Lorient,22.0,2000.0,33.6,108,64,52,40,16,43,113,38.1,70,50,5,45,34,142,38,1,Matches,2022-2023,Ligue-1
Vincent Le Goff,fr FRA,DF,Lorient,32.0,1989.0,37.0,75,32,56,16,3,45,62,72.6,17,29,9,20,41,116,105,1,Matches,2022-2023,Ligue-1
Maxime Le Marchand,fr FRA,DF,Strasbourg,32.0,1989.0,22.4,39,24,23,14,2,19,31,61.3,12,22,14,8,37,76,74,0,Matches,2022-2023,Ligue-1
Paolo Lebas,fr FRA,MF,Ajaccio,19.0,2003.0,0.6,0,0,0,0,0,0,0,,0,0,0,0,0,0,0,0,Matches,2022-2023,Ligue-1
Jean-Louis Leca,fr FRA,GK,Lens,36.0,1985.0,1.0,0,0,0,0,0,0,0,,0,0,0,0,0,0,0,1,Matches,2022-2023,Ligue-1
Benjamin Lecomte,fr FRA,GK,Montpellier,31.0,1991.0,19.0,0,0,0,0,0,0,2,0.0,2,0,0,0,0,0,6,0,Matches,2022-2023,Ligue-1
Pierre Lees-Melou,fr FRA,MF,Brest,29.0,1993.0,30.7,97,55,55,37,5,57,123,46.3,66,48,13,35,52,149,46,1,Matches,2022-2023,Ligue-1
Félix Lemaréchal,fr FRA,MF,Brest,18.0,2003.0,3.2,5,5,2,1,2,0,3,0.0,3,6,0,6,1,6,2,0,Matches,2022-2023,Ligue-1
Mario Lemina,ga GAB,"MF,DF",Nice,28.0,1993.0,9.3,32,21,11,14,7,12,18,66.7,6,13,5,8,11,43,20,0,Matches,2022-2023,Ligue-1
Donovan Léon,gf GUF,GK,Auxerre,29.0,1992.0,2.0,0,0,0,0,0,0,0,,0,0,0,0,0,0,1,0,Matches,2022-2023,Ligue-1
Johann Lepenant,fr FRA,MF,Lyon,19.0,2002.0,21.5,58,34,24,27,7,32,86,37.2,54,29,5,24,28,86,17,3,Matches,2022-2023,Ligue-1
Benjamin Leroy,fr FRA,GK,Ajaccio,33.0,1989.0,31.1,0,0,0,0,0,0,2,0.0,2,0,0,0,1,1,16,2,Matches,2022-2023,Ligue-1
Léo Leroy,fr FRA,MF,Montpellier,22.0,2000.0,13.2,53,38,24,26,3,31,57,54.4,26,25,2,23,14,67,8,0,Matches,2022-2023,Ligue-1
Alexandre Letellier,fr FRA,GK,Paris S-G,31.0,1990.0,0.1,0,0,0,0,0,0,0,,0,0,0,0,0,0,0,0,Matches,2022-2023,Ligue-1
Ruan Levine,br BRA,"MF,FW",Ajaccio,23.0,1999.0,0.3,2,2,1,1,0,0,0,,0,1,0,1,2,4,0,0,Matches,2022-2023,Ligue-1
Dimitri Liénard,fr FRA,"DF,MF",Strasbourg,34.0,1988.0,17.1,46,29,20,18,8,34,57,59.6,23,28,4,24,16,62,24,0,Matches,2022-2023,Ligue-1
Mateusz Lis,pl POL,GK,Troyes,25.0,1997.0,8.3,0,0,0,0,0,0,1,0.0,1,1,0,1,0,0,3,0,Matches,2022-2023,Ligue-1
Bradley Locko,fr FRA,DF,Reims,20.0,2002.0,11.8,31,16,21,4,6,15,27,55.6,12,17,4,13,20,51,21,0,Matches,2022-2023,Ligue-1
Bradley Locko,fr FRA,DF,Brest,20.0,2002.0,3.0,4,3,2,1,1,2,3,66.7,1,4,0,4,2,6,13,0,Matches,2022-2023,Ligue-1
Anthony Lopes,pt POR,GK,Lyon,31.0,1990.0,31.3,1,0,1,0,0,1,4,25.0,3,0,0,0,3,4,10,0,Matches,2022-2023,Ligue-1
Rony Lopes,pt POR,"MF,FW",Troyes,26.0,1995.0,26.1,24,12,6,15,3,7,31,22.6,24,14,2,12,9,33,10,0,Matches,2022-2023,Ligue-1
Pau López,es ESP,GK,Marseille,27.0,1994.0,32.5,0,0,0,0,0,0,1,0.0,1,0,0,0,0,0,5,1,Matches,2022-2023,Ligue-1
Dion Lopy,sn SEN,MF,Reims,20.0,2002.0,15.3,45,24,22,16,7,23,62,37.1,39,27,3,24,22,67,18,0,Matches,2022-2023,Ligue-1
Jordan Lotomba,ch SUI,DF,Nice,23.0,1998.0,27.3,65,38,33,24,8,31,48,64.6,17,38,11,27,32,97,53,0,Matches,2022-2023,Ligue-1
Dejan Lovren,hr CRO,DF,Lyon,33.0,1989.0,16.2,25,19,20,5,0,20,29,69.0,9,20,10,10,26,51,70,1,Matches,2022-2023,Ligue-1
Jean Lucas,br BRA,MF,Monaco,24.0,1998.0,3.2,9,5,3,5,1,6,12,50.0,6,2,1,1,4,13,2,0,Matches,2022-2023,Ligue-1
Castello Lukeba,fr FRA,DF,Lyon,19.0,2002.0,33.2,39,23,27,8,4,21,31,67.7,10,42,24,18,75,114,105,1,Matches,2022-2023,Ligue-1
Youssouf M'Changama,km COM,MF,Auxerre,31.0,1990.0,12.0,22,11,7,12,3,7,13,53.8,6,6,0,6,15,37,6,1,Matches,2022-2023,Ligue-1
Deiver Machado,co COL,"DF,MF",Lens,28.0,1993.0,24.3,45,26,18,20,7,21,34,61.8,13,21,4,17,21,66,27,0,Matches,2022-2023,Ligue-1
Soungoutou Magassa,fr FRA,MF,Monaco,18.0,2003.0,0.9,4,1,2,2,0,2,4,50.0,2,3,0,3,1,5,1,0,Matches,2022-2023,Ligue-1
Hugo Magnetti,fr FRA,MF,Brest,24.0,1998.0,18.8,43,27,18,23,2,23,63,36.5,40,21,1,20,25,68,12,0,Matches,2022-2023,Ligue-1
Yohann Magnin,fr FRA,MF,Clermont Foot,25.0,1997.0,26.7,89,54,37,45,7,54,106,50.9,52,50,12,38,25,114,46,0,Matches,2022-2023,Ligue-1
Lovro Majer,hr CRO,"MF,FW",Rennes,24.0,1998.0,18.5,34,23,16,13,5,8,29,27.6,21,21,1,20,21,55,5,1,Matches,2022-2023,Ligue-1
Jean-Victor Makengo,fr FRA,MF,Lorient,24.0,1998.0,11.8,16,8,5,10,1,6,20,30.0,14,8,5,3,10,26,13,1,Matches,2022-2023,Ligue-1
Béni Makouana,cg CGO,"FW,MF",Montpellier,19.0,2002.0,2.2,1,0,0,1,0,0,2,0.0,2,3,1,2,0,1,1,0,Matches,2022-2023,Ligue-1
Ruslan Malinovskyi,ua UKR,"MF,FW",Marseille,29.0,1993.0,13.6,21,11,3,12,6,10,26,38.5,16,13,1,12,3,24,9,0,Matches,2022-2023,Ligue-1
Hianga Mananga Mbock,fr FRA,MF,Brest,22.0,1999.0,0.2,0,0,0,0,0,0,1,0.0,1,0,0,0,0,0,0,0,Matches,2022-2023,Ligue-1
Steve Mandanda,fr FRA,GK,Rennes,37.0,1985.0,33.5,0,0,0,0,0,0,2,0.0,2,0,0,0,0,0,9,3,Matches,2022-2023,Ligue-1
Thomas Mangani,fr FRA,MF,Ajaccio,35.0,1987.0,14.8,32,17,14,15,3,18,47,38.3,29,22,3,19,24,56,22,1,Matches,2022-2023,Ligue-1
Vito Mannone,it ITA,GK,Lorient,34.0,1988.0,17.9,0,0,0,0,0,0,0,,0,0,0,0,0,0,4,3,Matches,2022-2023,Ligue-1
Myziane Maolida,km COM,"MF,FW",Reims,23.0,1999.0,2.6,8,3,2,5,1,5,12,41.7,7,1,0,1,2,10,0,0,Matches,2022-2023,Ligue-1
Faitout Maouassa,fr FRA,"FW,DF",Montpellier,24.0,1998.0,21.4,52,32,26,20,6,18,41,43.9,23,31,3,28,20,72,23,0,Matches,2022-2023,Ligue-1
Vincent Marchetti,fr FRA,MF,Ajaccio,25.0,1997.0,27.2,55,26,29,19,7,25,68,36.8,43,23,3,20,19,74,31,0,Matches,2022-2023,Ligue-1
Guillermo Maripán,cl CHI,DF,Monaco,28.0,1994.0,24.0,46,26,26,20,0,17,33,51.5,16,39,27,12,38,84,87,0,Matches,2022-2023,Ligue-1
Marquinhos,br BRA,DF,Paris S-G,28.0,1994.0,30.2,33,25,18,12,3,18,26,69.2,8,43,27,16,23,56,83,2,Matches,2022-2023,Ligue-1
Jonas Martin,fr FRA,MF,Lille,32.0,1990.0,3.1,9,7,4,5,0,5,14,35.7,9,3,1,2,7,16,3,0,Matches,2022-2023,Ligue-1
Gelson Martins,pt POR,"MF,FW",Monaco,27.0,1995.0,3.8,15,8,6,4,5,4,13,30.8,9,4,1,3,3,18,2,0,Matches,2022-2023,Ligue-1
Han-Noah Massengo,fr FRA,MF,Auxerre,21.0,2001.0,12.4,27,15,10,15,2,7,16,43.8,9,12,3,9,14,41,7,0,Matches,2022-2023,Ligue-1
Yanis Massolin,fr FRA,MF,Clermont Foot,19.0,2002.0,0.7,2,1,1,0,1,0,1,0.0,1,1,0,1,2,4,0,0,Matches,2022-2023,Ligue-1
Eliot Matazo,be BEL,MF,Monaco,20.0,2002.0,13.1,26,12,11,13,2,11,26,42.3,15,18,4,14,15,41,11,1,Matches,2022-2023,Ligue-1
Chrislain Matsima,fr FRA,"DF,MF",Lorient,20.0,2002.0,2.5,0,0,0,0,0,0,0,,0,3,3,0,2,2,7,0,Matches,2022-2023,Ligue-1
Chrislain Matsima,fr FRA,DF,Monaco,20.0,2002.0,5.0,11,6,7,2,2,4,7,57.1,3,5,5,0,9,20,16,0,Matches,2022-2023,Ligue-1
Jean Mattéo Bahoya,fr FRA,"FW,MF",Angers,17.0,2005.0,3.0,7,3,1,3,3,4,7,57.1,3,4,0,4,0,7,0,0,Matches,2022-2023,Ligue-1
Azor Matusiwa,nl NED,MF,Reims,24.0,1998.0,27.6,66,41,30,29,7,36,61,59.0,25,37,11,26,46,112,52,0,Matches,2022-2023,Ligue-1
Aïman Maurer,ma MAR,MF,Clermont Foot,17.0,2004.0,5.6,2,1,1,1,0,1,10,10.0,9,1,0,1,3,5,5,0,Matches,2022-2023,Ligue-1
Stephy Mavididi,eng ENG,FW,Montpellier,24.0,1998.0,14.3,24,19,12,8,4,13,27,48.1,14,21,1,20,4,28,10,0,Matches,2022-2023,Ligue-1
Christian Mawissa,fr FRA,DF,Toulouse,17.0,2005.0,1.1,2,0,1,1,0,1,3,33.3,2,0,0,0,3,5,1,0,Matches,2022-2023,Ligue-1
Fernand Mayembo,cg CGO,DF,Ajaccio,26.0,1996.0,7.9,8,5,6,2,0,4,9,44.4,5,2,0,2,11,19,36,0,Matches,2022-2023,Ligue-1
Derek Mazou-Sacko,fr FRA,MF,Troyes,17.0,2004.0,0.2,0,0,0,0,0,0,1,0.0,1,1,0,1,1,1,1,0,Matches,2022-2023,Ligue-1
Kylian Mbappé,fr FRA,FW,Paris S-G,23.0,1998.0,31.3,10,4,0,5,5,5,16,31.3,11,5,0,5,5,15,6,0,Matches,2022-2023,Ligue-1
Chancel Mbemba,cd COD,DF,Marseille,27.0,1994.0,31.7,43,26,24,17,2,22,31,71.0,9,25,12,13,42,85,89,0,Matches,2022-2023,Ligue-1
Jason Mbock,fr FRA,"MF,FW",Angers,22.0,1999.0,0.3,0,0,0,0,0,0,0,,0,0,0,0,0,0,0,0,Matches,2022-2023,Ligue-1
Nathanael Mbuku,cd COD,"FW,MF",Reims,20.0,2002.0,0.7,2,1,2,0,0,2,2,100.0,0,0,0,0,0,2,0,0,Matches,2022-2023,Ligue-1
Facundo Medina,ar ARG,DF,Lens,23.0,1999.0,30.9,31,20,16,15,0,13,35,37.1,22,25,9,16,26,57,62,1,Matches,2022-2023,Ligue-1
Bamo Meïté,ci CIV,DF,Lorient,20.0,2001.0,16.7,18,8,13,4,1,7,16,43.8,9,33,23,10,16,34,70,0,Matches,2022-2023,Ligue-1
Farid El Melali,dz ALG,"DF,FW",Angers,25.0,1997.0,9.0,21,12,7,12,2,11,22,50.0,11,16,0,16,8,29,7,0,Matches,2022-2023,Ligue-1
Birger Meling,no NOR,DF,Rennes,27.0,1994.0,13.4,24,15,9,12,3,12,25,48.0,13,18,2,16,23,47,26,0,Matches,2022-2023,Ligue-1
Nuno Mendes,pt POR,DF,Paris S-G,20.0,2002.0,17.2,45,30,29,12,4,30,41,73.2,11,19,3,16,17,62,18,0,Matches,2022-2023,Ligue-1
Pedro Mendes,pt POR,DF,Montpellier,31.0,1990.0,0.1,0,0,0,0,0,0,0,,0,0,0,0,0,0,0,1,Matches,2022-2023,Ligue-1
Thiago Mendes,br BRA,"MF,DF",Lyon,30.0,1992.0,22.9,48,27,24,21,3,30,40,75.0,10,28,8,20,47,95,51,4,Matches,2022-2023,Ligue-1
Antoine Mendy,sn SEN,DF,Nice,18.0,2004.0,5.8,22,13,16,5,1,9,15,60.0,6,6,1,5,2,24,16,0,Matches,2022-2023,Ligue-1
Arial Mendy,sn SEN,DF,Clermont Foot,27.0,1994.0,2.5,4,2,3,0,1,2,2,100.0,0,2,0,2,4,8,4,0,Matches,2022-2023,Ligue-1
Batista Mendy,fr FRA,"MF,DF",Angers,22.0,2000.0,31.8,70,30,34,28,8,37,53,69.8,16,38,6,32,21,91,29,2,Matches,2022-2023,Ligue-1
Gideon Mensah,gh GHA,DF,Auxerre,24.0,1998.0,25.1,80,44,43,32,5,44,77,57.1,33,33,10,23,38,118,41,0,Matches,2022-2023,Ligue-1
Quentin Merlin,fr FRA,DF,Nantes,20.0,2002.0,19.9,31,19,19,8,4,18,38,47.4,20,27,4,23,24,55,30,0,Matches,2022-2023,Ligue-1
Lionel Messi,ar ARG,"FW,MF",Paris S-G,35.0,1987.0,31.5,26,18,1,13,12,11,27,40.7,16,11,0,11,2,28,0,0,Matches,2022-2023,Ligue-1
Amine Messoussa,fr FRA,FW,Lille,17.0,2004.0,0.0,0,0,0,0,0,0,0,,0,0,0,0,0,0,0,0,Matches,2022-2023,Ligue-1
Arkadiusz Milik,pl POL,FW,Marseille,28.0,1994.0,1.4,1,1,0,0,1,0,1,0.0,1,0,0,0,0,1,2,0,Matches,2022-2023,Ligue-1
Takumi Minamino,jp JPN,"MF,FW",Monaco,27.0,1995.0,8.0,15,8,5,7,3,7,35,20.0,28,14,0,14,6,21,4,0,Matches,2022-2023,Ligue-1
Terem Moffi,ng NGA,FW,Nice,23.0,1999.0,14.8,12,6,0,6,6,2,12,16.7,10,3,0,3,2,14,5,0,Matches,2022-2023,Ligue-1
Terem Moffi,ng NGA,FW,Lorient,23.0,1999.0,15.4,8,5,1,4,3,3,5,60.0,2,11,3,8,3,11,10,0,Matches,2022-2023,Ligue-1
Mostafa Mohamed,eg EGY,FW,Nantes,24.0,1997.0,21.5,18,13,5,7,6,9,20,45.0,11,23,1,22,10,28,33,0,Matches,2022-2023,Ligue-1
Florent Mollet,fr FRA,MF,Nantes,30.0,1991.0,12.1,14,6,5,4,5,7,24,29.2,17,12,1,11,10,24,11,0,Matches,2022-2023,Ligue-1
Marlos Moreno,co COL,"MF,DF",Troyes,25.0,1996.0,0.1,2,2,2,0,0,2,3,66.7,1,1,1,0,0,2,0,0,Matches,2022-2023,Ligue-1
Lebo Mothiba,za RSA,"FW,MF",Strasbourg,26.0,1996.0,4.8,1,0,1,0,0,0,1,0.0,1,6,1,5,0,1,4,0,Matches,2022-2023,Ligue-1
Steve Mounié,bj BEN,FW,Brest,27.0,1994.0,18.4,13,5,1,7,5,5,14,35.7,9,18,7,11,3,16,20,0,Matches,2022-2023,Ligue-1
Bevic Moussiti-Oko,cg CGO,FW,Ajaccio,27.0,1995.0,7.8,3,1,1,1,1,1,2,50.0,1,5,3,2,2,5,8,0,Matches,2022-2023,Ligue-1
Samuel Moutoussamy,cd COD,MF,Nantes,25.0,1996.0,26.7,64,34,27,28,9,26,76,34.2,50,23,2,21,24,88,15,0,Matches,2022-2023,Ligue-1
François Mughe,cm CMR,MF,Marseille,18.0,2004.0,0.1,0,0,0,0,0,0,0,,0,0,0,0,0,0,0,0,Matches,2022-2023,Ligue-1
Nordi Mukiele,fr FRA,DF,Paris S-G,24.0,1997.0,12.6,31,23,16,6,9,19,29,65.5,10,22,9,13,14,45,16,0,Matches,2022-2023,Ligue-1
Marshall Munetsi,zw ZIM,MF,Reims,26.0,1996.0,30.0,58,27,13,31,14,20,48,41.7,28,37,11,26,26,84,41,1,Matches,2022-2023,Ligue-1
Yvon Mvogo,ch SUI,GK,Lorient,28.0,1994.0,20.1,0,0,0,0,0,0,0,,0,0,0,0,2,2,6,3,Matches,2022-2023,Ligue-1
Nathan N'Goumou,cm CMR,FW,Toulouse,22.0,2000.0,1.0,3,2,2,1,0,1,1,100.0,0,2,0,2,2,5,0,0,Matches,2022-2023,Ligue-1
Youssouf Ndayishimiye,bi BDI,"MF,DF",Nice,23.0,1998.0,6.3,13,9,8,5,0,6,11,54.5,5,8,5,3,12,25,22,1,Matches,2022-2023,Ligue-1
Papa Ndiaga Yade,mr MTN,"DF,MF",Troyes,22.0,2000.0,6.3,10,6,6,2,2,7,22,31.8,15,10,2,8,8,18,10,0,Matches,2022-2023,Ligue-1
Neymar,br BRA,"MF,FW",Paris S-G,30.0,1992.0,17.2,22,14,6,9,7,9,19,47.4,10,7,1,6,4,26,1,1,Matches,2022-2023,Ligue-1
Ibrahima Niane,sn SEN,FW,Angers,23.0,1999.0,12.6,6,2,1,4,1,1,6,16.7,5,8,2,6,1,7,9,0,Matches,2022-2023,Ligue-1
M'Baye Niang,sn SEN,FW,Auxerre,27.0,1994.0,16.5,13,7,1,8,4,3,13,23.1,10,22,1,21,1,14,20,0,Matches,2022-2023,Ligue-1
Rasmus Nicolaisen,dk DEN,DF,Toulouse,25.0,1997.0,33.3,48,21,34,14,0,29,46,63.0,17,58,45,13,50,98,152,0,Matches,2022-2023,Ligue-1
Arnaud Nordin,fr FRA,FW,Montpellier,24.0,1998.0,26.7,26,14,10,12,4,12,28,42.9,16,19,1,18,14,40,7,0,Matches,2022-2023,Ligue-1
Riad Nouri,fr FRA,"MF,FW",Ajaccio,37.0,1985.0,18.8,21,12,7,10,4,12,29,41.4,17,8,1,7,15,36,11,0,Matches,2022-2023,Ligue-1
Alexander Nübel,de GER,GK,Monaco,25.0,1996.0,38.0,0,0,0,0,0,0,1,0.0,1,0,0,0,1,1,10,3,Matches,2022-2023,Ligue-1
Gerzino Nyamsi,fr FRA,DF,Strasbourg,25.0,1997.0,17.5,28,20,14,12,2,10,12,83.3,2,19,11,8,10,38,63,1,Matches,2022-2023,Ligue-1
Wilson Odobert,fr FRA,"MF,FW",Troyes,17.0,2004.0,19.6,20,14,10,7,3,9,25,36.0,16,11,0,11,15,35,5,0,Matches,2022-2023,Ligue-1
Florent Ogier,fr FRA,DF,Clermont Foot,33.0,1989.0,18.9,33,16,20,12,1,22,39,56.4,17,22,13,9,18,51,64,1,Matches,2022-2023,Ligue-1
Warmed Omari,km COM,DF,Rennes,22.0,2000.0,15.1,20,11,14,6,0,14,28,50.0,14,13,7,6,17,37,43,1,Matches,2022-2023,Ligue-1
Jonas Omlin,ch SUI,GK,Montpellier,28.0,1994.0,13.0,1,0,1,0,0,0,0,,0,0,0,0,0,1,8,1,Matches,2022-2023,Ligue-1
Ado Onaiwu,jp JPN,FW,Toulouse,26.0,1995.0,12.0,11,6,4,4,3,5,13,38.5,8,5,1,4,2,13,5,0,Matches,2022-2023,Ligue-1
Jean Onana,cm CMR,"MF,DF",Lens,22.0,2000.0,9.0,28,17,8,17,3,10,22,45.5,12,15,5,10,18,46,20,0,Matches,2022-2023,Ligue-1
Loïs Openda,be BEL,FW,Lens,22.0,2000.0,28.0,11,9,2,6,3,2,13,15.4,11,9,0,9,2,13,6,0,Matches,2022-2023,Ligue-1
Dango Ouattara,bf BFA,"FW,MF",Lorient,20.0,2002.0,17.2,41,26,20,11,10,15,28,53.6,13,24,6,18,19,60,21,0,Matches,2022-2023,Ligue-1
Zinédine Ould Khaled,fr FRA,"MF,FW",Angers,22.0,2000.0,0.6,1,1,0,1,0,0,1,0.0,1,0,0,0,2,3,0,0,Matches,2022-2023,Ligue-1
Azzedine Ounahi,ma MAR,"MF,FW",Marseille,22.0,2000.0,1.3,2,1,1,1,0,0,2,0.0,2,1,0,1,0,2,0,0,Matches,2022-2023,Ligue-1
Azzedine Ounahi,ma MAR,"MF,FW",Angers,22.0,2000.0,12.5,19,8,5,13,1,10,20,50.0,10,8,0,8,15,34,4,1,Matches,2022-2023,Ligue-1
Adam Ounas,dz ALG,"FW,MF",Lille,25.0,1996.0,11.8,20,11,4,10,6,8,13,61.5,5,16,0,16,7,27,5,0,Matches,2022-2023,Ligue-1
Ante Palaversa,hr CRO,MF,Troyes,22.0,2000.0,0.3,1,1,1,0,0,0,0,,0,0,0,0,1,2,0,0,Matches,2022-2023,Ligue-1
Nicolas Pallois,fr FRA,DF,Nantes,34.0,1987.0,24.6,69,44,51,16,2,42,70,60.0,28,35,18,17,30,99,131,2,Matches,2022-2023,Ligue-1
Erik Palmer-Brown,us USA,DF,Troyes,25.0,1997.0,35.5,42,27,31,10,1,18,33,54.5,15,56,29,27,26,68,166,1,Matches,2022-2023,Ligue-1
Lucas Paquetá,br BRA,MF,Lyon,24.0,1997.0,1.8,5,4,0,5,0,1,3,33.3,2,2,0,2,1,6,3,0,Matches,2022-2023,Ligue-1
Leandro Paredes,ar ARG,MF,Paris S-G,28.0,1994.0,0.6,1,1,1,0,0,1,1,100.0,0,2,1,1,1,2,0,0,Matches,2022-2023,Ligue-1
Dimitri Payet,fr FRA,"MF,FW",Marseille,35.0,1987.0,9.3,6,4,2,2,2,3,11,27.3,8,4,0,4,0,6,4,0,Matches,2022-2023,Ligue-1
Théo Pellenard,fr FRA,DF,Auxerre,28.0,1994.0,1.1,1,0,1,0,0,1,1,100.0,0,3,1,2,2,3,2,0,Matches,2022-2023,Ligue-1
Timothee Pembele,fr FRA,DF,Paris S-G,19.0,2002.0,2.9,5,5,3,1,1,2,4,50.0,2,2,0,2,4,9,2,0,Matches,2022-2023,Ligue-1
Patrick Pentz,at AUT,GK,Reims,25.0,1997.0,7.0,0,0,0,0,0,0,0,,0,0,0,0,0,0,1,0,Matches,2022-2023,Ligue-1
Nicolas Pépé,ci CIV,"FW,MF",Nice,27.0,1995.0,16.6,25,13,14,5,6,11,25,44.0,14,17,0,17,3,28,1,0,Matches,2022-2023,Ligue-1
Brayann Pereira,fr FRA,DF,Auxerre,19.0,2003.0,2.0,6,5,5,1,0,1,5,20.0,4,2,2,0,2,8,8,1,Matches,2022-2023,Ligue-1
Danilo Pereira,pt POR,"DF,MF",Paris S-G,30.0,1991.0,26.8,32,17,15,14,3,19,26,73.1,7,26,19,7,36,68,59,1,Matches,2022-2023,Ligue-1
Mathias Pereira Lage,pt POR,"MF,FW",Brest,25.0,1996.0,14.0,20,7,5,14,1,11,29,37.9,18,10,1,9,14,34,12,0,Matches,2022-2023,Ligue-1
Gaëtan Perrin,fr FRA,"MF,FW",Auxerre,26.0,1996.0,15.5,17,8,5,6,6,8,30,26.7,22,15,0,15,10,27,9,0,Matches,2022-2023,Ligue-1
Lucas Perrin,fr FRA,DF,Strasbourg,23.0,1998.0,19.6,44,27,28,14,2,25,49,51.0,24,13,5,8,36,80,53,0,Matches,2022-2023,Ligue-1
Ronaël Pierre-Gabriel,fr FRA,DF,Strasbourg,24.0,1998.0,7.3,25,18,11,12,2,15,17,88.2,2,16,3,13,9,34,22,0,Matches,2022-2023,Ligue-1
Julien Ponceau,fr FRA,MF,Lorient,21.0,2000.0,18.4,28,19,10,14,4,10,32,31.3,22,27,3,24,14,42,12,0,Matches,2022-2023,Ligue-1
Łukasz Poręba,pl POL,MF,Lens,22.0,2000.0,2.9,5,4,2,1,2,2,3,66.7,1,3,0,3,4,9,2,0,Matches,2022-2023,Ligue-1
Jackson Porozo,ec ECU,DF,Troyes,21.0,2000.0,18.0,32,20,24,7,1,13,31,41.9,18,24,17,7,33,65,75,0,Matches,2022-2023,Ligue-1
Sanjin Prcić,ba BIH,MF,Strasbourg,28.0,1993.0,18.1,27,12,6,16,5,19,31,61.3,12,22,7,15,25,52,22,0,Matches,2022-2023,Ligue-1
Mehdi Puch-Herrantz,fr FRA,MF,Ajaccio,18.0,2004.0,0.5,2,2,0,1,1,1,2,50.0,1,1,0,1,3,5,0,0,Matches,2022-2023,Ligue-1
Ghjuvanni Quilichini,fr FRA,GK,Ajaccio,19.0,2002.0,0.9,0,0,0,0,0,0,0,,0,0,0,0,0,0,1,0,Matches,2022-2023,Ligue-1
Ionuț Radu,ro ROU,GK,Auxerre,25.0,1997.0,17.0,0,0,0,0,0,0,0,,0,0,0,0,0,0,3,3,Matches,2022-2023,Ligue-1
Simon Ramet,fr FRA,DF,Lille,19.0,2003.0,0.0,0,0,0,0,0,0,0,,0,0,0,0,0,0,0,0,Matches,2022-2023,Ligue-1
Adil Rami,fr FRA,DF,Troyes,36.0,1985.0,17.7,19,14,13,5,1,17,32,53.1,15,23,16,7,25,44,75,3,Matches,2022-2023,Ligue-1
Sergio Ramos,es ESP,DF,Paris S-G,36.0,1986.0,30.0,34,26,14,18,2,23,44,52.3,21,29,13,16,34,68,93,3,Matches,2022-2023,Ligue-1
Aaron Ramsey,wls WAL,MF,Nice,31.0,1990.0,17.6,47,25,18,19,10,16,39,41.0,23,25,4,21,17,64,18,1,Matches,2022-2023,Ligue-1
Lilian Raolisoa,fr FRA,"DF,MF",Angers,22.0,2000.0,1.9,11,9,6,3,2,7,10,70.0,3,3,1,2,3,14,5,0,Matches,2022-2023,Ligue-1
Elba Rashani,xk KVX,"MF,FW",Clermont Foot,29.0,1993.0,24.0,39,26,13,19,7,13,39,33.3,26,27,2,25,21,60,19,0,Matches,2022-2023,Ligue-1
Rafael Ratão,br BRA,"FW,MF",Toulouse,26.0,1995.0,20.6,52,36,29,16,7,27,73,37.0,46,34,0,34,21,73,7,0,Matches,2022-2023,Ligue-1
Rayan Raveloson,mg MAD,"DF,MF",Auxerre,25.0,1997.0,27.0,38,23,21,16,1,23,33,69.7,10,43,12,31,39,77,70,0,Matches,2022-2023,Ligue-1
Jeff Reine-Adélaïde,fr FRA,MF,Troyes,24.0,1998.0,2.6,3,2,2,1,0,1,2,50.0,1,2,0,2,2,5,1,0,Matches,2022-2023,Ligue-1
Jeff Reine-Adélaïde,fr FRA,MF,Lyon,24.0,1998.0,3.7,8,5,1,5,2,5,9,55.6,4,4,0,4,6,14,0,0,Matches,2022-2023,Ligue-1
Alexsandro Ribeiro,br BRA,DF,Lille,22.0,1999.0,17.9,32,18,24,7,1,19,28,67.9,9,11,2,9,25,57,59,1,Matches,2022-2023,Ligue-1
Rémy Riou,fr FRA,GK,Lyon,34.0,1987.0,6.7,1,0,1,0,0,1,1,100.0,0,0,0,0,0,1,3,0,Matches,2022-2023,Ligue-1
Renaud Ripart,fr FRA,"FW,MF",Troyes,29.0,1993.0,14.7,40,23,14,20,6,19,52,36.5,33,29,2,27,7,47,5,0,Matches,2022-2023,Ligue-1
Joe Rodon,wls WAL,DF,Rennes,24.0,1997.0,15.7,11,7,9,2,0,4,10,40.0,6,16,12,4,9,20,54,1,Matches,2022-2023,Ligue-1
Valentin Rongier,fr FRA,MF,Marseille,27.0,1994.0,33.7,93,59,33,47,13,41,77,53.2,36,50,11,39,54,147,38,1,Matches,2022-2023,Ligue-1
Pablo Rosario,nl NED,"MF,DF",Nice,25.0,1997.0,19.6,46,26,22,20,4,18,34,52.9,16,15,5,10,23,69,32,1,Matches,2022-2023,Ligue-1
Anthony Rouault,fr FRA,DF,Toulouse,21.0,2001.0,36.8,66,37,54,10,2,30,58,51.7,28,52,26,26,56,122,126,4,Matches,2022-2023,Ligue-1
Kays Ruiz,fr FRA,MF,Auxerre,19.0,2002.0,0.7,1,1,1,0,0,0,1,0.0,1,2,1,1,3,4,0,0,Matches,2022-2023,Ligue-1
Fabián Ruiz Peña,es ESP,MF,Paris S-G,26.0,1996.0,21.0,62,28,25,30,7,43,79,54.4,36,24,1,23,18,80,23,1,Matches,2022-2023,Ligue-1
Halid Šabanović,ba BIH,DF,Angers,22.0,1999.0,7.1,8,6,7,1,0,6,8,75.0,2,8,2,6,8,16,12,0,Matches,2022-2023,Ligue-1
Falaye Sacko,ml MLI,DF,Montpellier,27.0,1995.0,28.7,46,25,25,15,6,32,51,62.7,19,43,14,29,33,79,75,1,Matches,2022-2023,Ligue-1
Wesley Saïd,fr FRA,"FW,MF",Lens,27.0,1995.0,7.2,4,1,1,2,1,2,6,33.3,4,4,0,4,1,5,2,0,Matches,2022-2023,Ligue-1
Théo Sainte-Luce,fr FRA,DF,Montpellier,23.0,1998.0,5.9,13,11,8,5,0,7,14,50.0,7,7,2,5,10,23,11,0,Matches,2022-2023,Ligue-1
Hamza Sakhi,fr FRA,MF,Auxerre,26.0,1996.0,18.4,44,22,22,17,5,22,42,52.4,20,16,1,15,25,69,9,0,Matches,2022-2023,Ligue-1
Mamadou Sakho,fr FRA,DF,Montpellier,32.0,1990.0,8.5,9,5,4,5,0,3,5,60.0,2,17,12,5,8,17,35,1,Matches,2022-2023,Ligue-1
Ibrahim Salah,ma MAR,"FW,MF",Rennes,20.0,2001.0,2.5,8,1,5,3,0,2,15,13.3,13,3,0,3,2,10,0,0,Matches,2022-2023,Ligue-1
Amine Salama,fr FRA,"FW,MF",Angers,22.0,2000.0,13.9,11,9,3,7,1,2,12,16.7,10,8,2,6,10,21,2,0,Matches,2022-2023,Ligue-1
Yoann Salmier,gf GUF,DF,Troyes,29.0,1992.0,29.4,51,29,34,12,5,21,35,60.0,14,34,19,15,39,90,124,0,Matches,2022-2023,Ligue-1
Mama Samba Baldé,gw GNB,FW,Troyes,26.0,1995.0,29.6,46,21,14,21,11,13,28,46.4,15,30,3,27,10,56,13,0,Matches,2022-2023,Ligue-1
Brice Samba,fr FRA,GK,Lens,28.0,1994.0,37.0,1,0,1,0,0,1,2,50.0,1,1,0,1,0,1,12,2,Matches,2022-2023,Ligue-1
Renato Sanches,pt POR,MF,Paris S-G,24.0,1997.0,8.0,8,1,1,3,4,5,14,35.7,9,13,3,10,9,17,4,0,Matches,2022-2023,Ligue-1
Alexis Sánchez,cl CHI,"FW,MF",Marseille,33.0,1988.0,29.8,27,17,5,16,6,3,24,12.5,21,14,0,14,5,32,6,0,Matches,2022-2023,Ligue-1
Morgan Sanson,fr FRA,MF,Strasbourg,27.0,1994.0,15.8,36,25,10,16,10,17,56,30.4,39,21,1,20,22,58,9,0,Matches,2022-2023,Ligue-1
Baptiste Santamaria,fr FRA,MF,Rennes,27.0,1995.0,20.1,41,22,13,23,5,21,41,51.2,20,21,5,16,21,62,23,0,Matches,2022-2023,Ligue-1
Pablo Sarabia,es ESP,"FW,MF",Paris S-G,30.0,1992.0,4.1,5,4,2,2,1,1,7,14.3,6,3,0,3,2,7,0,0,Matches,2022-2023,Ligue-1
Amin Sarr,se SWE,FW,Lyon,21.0,2001.0,6.0,9,6,1,4,4,1,4,25.0,3,2,0,2,0,9,4,0,Matches,2022-2023,Ligue-1
Malang Sarr,fr FRA,DF,Monaco,23.0,1999.0,8.0,6,3,5,1,0,1,5,20.0,4,11,7,4,15,21,29,2,Matches,2022-2023,Ligue-1
Mamadou Sarr,fr FRA,MF,Lyon,16.0,2005.0,0.1,0,0,0,0,0,0,0,,0,0,0,0,0,0,0,0,Matches,2022-2023,Ligue-1
Téji Savanier,fr FRA,MF,Montpellier,30.0,1991.0,28.3,46,30,16,19,11,23,70,32.9,47,30,2,28,30,76,12,1,Matches,2022-2023,Ligue-1
Kasper Schmeichel,dk DEN,GK,Nice,35.0,1986.0,36.0,1,0,1,0,0,1,4,25.0,3,1,0,1,1,2,11,1,Matches,2022-2023,Ligue-1
Alidu Seidu,gh GHA,DF,Clermont Foot,22.0,2000.0,27.3,52,31,35,14,3,31,51,60.8,20,28,14,14,52,104,50,2,Matches,2022-2023,Ligue-1
Matz Sels,be BEL,GK,Strasbourg,30.0,1992.0,38.0,4,3,4,0,0,4,4,100.0,0,0,0,0,4,8,23,0,Matches,2022-2023,Ligue-1
Marvin Senaya,tg TOG,DF,Strasbourg,21.0,2001.0,0.1,0,0,0,0,0,0,1,0.0,1,1,0,1,0,0,1,0,Matches,2022-2023,Ligue-1
Kaj Sierhuis,nl NED,"FW,MF",Reims,24.0,1998.0,2.4,3,3,1,0,2,0,5,0.0,5,3,1,2,1,4,2,0,Matches,2022-2023,Ligue-1
Vincent Sierro,ch SUI,MF,Toulouse,26.0,1995.0,7.4,19,11,9,9,1,11,29,37.9,18,12,3,9,4,23,11,1,Matches,2022-2023,Ligue-1
Caio Henrique Oliveira Silva,br BRA,DF,Monaco,25.0,1997.0,32.2,74,51,42,28,4,44,76,57.9,32,28,8,20,26,100,68,1,Matches,2022-2023,Ligue-1
Abdallah Sima,sn SEN,FW,Angers,21.0,2001.0,20.4,22,13,4,15,3,7,19,36.8,12,8,0,8,4,26,19,0,Matches,2022-2023,Ligue-1
Moses Simon,ng NGA,"FW,MF",Nantes,27.0,1995.0,26.1,18,9,6,7,5,7,15,46.7,8,14,1,13,11,29,3,0,Matches,2022-2023,Ligue-1
Lassine Sinayoko,ml MLI,"MF,FW",Auxerre,22.0,1999.0,17.4,33,15,14,12,7,21,40,52.5,19,12,0,12,18,51,17,0,Matches,2022-2023,Ligue-1
Ibrahima Sissoko,ml MLI,MF,Strasbourg,24.0,1997.0,14.6,40,22,18,17,5,22,42,52.4,20,20,6,14,10,50,19,0,Matches,2022-2023,Ligue-1
Moussa Sissoko,fr FRA,MF,Nantes,32.0,1989.0,21.3,26,16,16,7,3,12,18,66.7,6,22,5,17,16,42,17,0,Matches,2022-2023,Ligue-1
Naatan Skyttä,fi FIN,MF,Toulouse,20.0,2002.0,0.3,0,0,0,0,0,0,0,,0,0,0,0,1,1,0,0,Matches,2022-2023,Ligue-1
Islam Slimani,dz ALG,FW,Brest,34.0,1988.0,11.0,5,3,2,2,1,0,3,0.0,3,2,0,2,1,6,11,0,Matches,2022-2023,Ligue-1
Eduard Sobol,ua UKR,DF,Strasbourg,27.0,1995.0,9.7,19,10,10,6,3,9,13,69.2,4,10,1,9,8,27,19,0,Matches,2022-2023,Ligue-1
Carlos Soler,es ESP,MF,Paris S-G,25.0,1997.0,13.2,20,12,6,10,4,10,19,52.6,9,12,4,8,4,24,6,0,Matches,2022-2023,Ligue-1
François-Joseph Sollacaro,fr FRA,GK,Ajaccio,28.0,1994.0,6.0,0,0,0,0,0,0,0,,0,0,0,0,0,0,2,2,Matches,2022-2023,Ligue-1
Florian Sotoca,fr FRA,"MF,FW",Lens,31.0,1990.0,33.9,39,19,11,17,11,15,40,37.5,25,41,2,39,29,68,51,0,Matches,2022-2023,Ligue-1
Moussa Soumano,fr FRA,FW,Ajaccio,17.0,2005.0,5.5,2,2,0,1,1,0,6,0.0,6,2,0,2,0,2,0,0,Matches,2022-2023,Ligue-1
Arnaud Souquet,fr FRA,"DF,FW",Montpellier,30.0,1992.0,4.0,22,16,13,7,2,11,14,78.6,3,8,3,5,4,26,4,0,Matches,2022-2023,Ligue-1
Kevin Spadanuda,ch SUI,"MF,FW",Ajaccio,25.0,1997.0,11.8,29,18,15,9,5,12,33,36.4,21,18,0,18,11,40,5,0,Matches,2022-2023,Ligue-1
Djed Spence,eng ENG,DF,Rennes,21.0,2000.0,6.4,14,6,8,2,4,11,18,61.1,7,10,3,7,4,18,15,0,Matches,2022-2023,Ligue-1
Stijn Spierings,nl NED,MF,Toulouse,26.0,1996.0,34.7,95,67,37,49,9,43,101,42.6,58,49,11,38,53,148,44,0,Matches,2022-2023,Ligue-1
Calvin Stengs,nl NED,FW,Nice,23.0,1998.0,2.4,2,2,1,0,1,1,2,50.0,1,0,0,0,0,2,0,0,Matches,2022-2023,Ligue-1
Tony Strata,ro ROU,"MF,DF",Ajaccio,17.0,2004.0,1.5,4,3,4,0,0,4,5,80.0,1,2,0,2,1,5,7,0,Matches,2022-2023,Ligue-1
Gabriel Suazo,cl CHI,DF,Toulouse,24.0,1997.0,14.0,38,22,20,15,3,29,63,46.0,34,21,5,16,22,60,24,1,Matches,2022-2023,Ligue-1
Kamaldeen Sulemana,gh GHA,"FW,MF",Rennes,20.0,2002.0,3.6,6,3,1,4,1,1,5,20.0,4,2,0,2,4,10,2,0,Matches,2022-2023,Ligue-1
Yuito Suzuki,jp JPN,"FW,MF",Strasbourg,20.0,2001.0,0.4,0,0,0,0,0,0,0,,0,3,0,3,0,0,0,0,Matches,2022-2023,Ligue-1
Issiaga Sylla,gn GUI,DF,Montpellier,28.0,1994.0,14.5,28,16,19,8,1,15,31,48.4,16,19,3,16,32,60,35,0,Matches,2022-2023,Ligue-1
Issiaga Sylla,gn GUI,DF,Toulouse,28.0,1994.0,15.2,28,15,14,9,5,15,34,44.1,19,15,5,10,38,66,38,0,Matches,2022-2023,Ligue-1
Nicolás Tagliafico,ar ARG,DF,Lyon,29.0,1992.0,33.2,91,53,36,41,14,50,78,64.1,28,45,11,34,57,148,47,0,Matches,2022-2023,Ligue-1
Waniss Taibi,fr FRA,MF,Angers,20.0,2002.0,2.1,9,5,4,4,1,2,4,50.0,2,1,0,1,2,11,2,0,Matches,2022-2023,Ligue-1
Flavien Tait,fr FRA,MF,Rennes,29.0,1993.0,18.7,30,15,8,17,5,19,42,45.2,23,16,4,12,20,50,12,0,Matches,2022-2023,Ligue-1
Montassar Talbi,tn TUN,DF,Lorient,24.0,1998.0,38.0,53,25,40,13,0,22,35,62.9,13,55,34,21,40,93,190,3,Matches,2022-2023,Ligue-1
Thibault Tamas,fr FRA,DF,Montpellier,21.0,2001.0,0.1,0,0,0,0,0,0,0,,0,0,0,0,1,1,0,0,Matches,2022-2023,Ligue-1
Florian Tardieu,fr FRA,MF,Troyes,30.0,1992.0,11.2,31,20,19,12,0,12,31,38.7,19,19,4,15,23,54,15,0,Matches,2022-2023,Ligue-1
Nuno Tavares,pt POR,"DF,MF",Marseille,22.0,2000.0,26.1,56,30,19,24,13,28,56,50.0,28,32,4,28,15,71,25,0,Matches,2022-2023,Ligue-1
Enzo Tchato,cm CMR,DF,Montpellier,19.0,2002.0,12.2,26,17,14,11,1,13,22,59.1,9,17,2,15,7,33,33,0,Matches,2022-2023,Ligue-1
Martin Terrier,fr FRA,"FW,MF",Rennes,25.0,1997.0,14.7,25,11,7,9,9,13,24,54.2,11,15,2,13,14,39,6,0,Matches,2022-2023,Ligue-1
Tetê,br BRA,"FW,MF",Lyon,22.0,2000.0,12.3,21,10,8,5,8,10,19,52.6,9,9,0,9,13,34,2,0,Matches,2022-2023,Ligue-1
Arthur Theate,be BEL,DF,Rennes,22.0,2000.0,34.7,29,19,17,8,4,17,30,56.7,13,26,14,12,30,59,114,3,Matches,2022-2023,Ligue-1
Sada Thioub,sn SEN,"DF,FW",Angers,27.0,1995.0,11.8,19,10,9,8,2,8,17,47.1,9,13,0,13,7,26,5,1,Matches,2022-2023,Ligue-1
Adrien Thomasson,fr FRA,MF,Strasbourg,28.0,1993.0,10.4,19,9,8,6,5,9,30,30.0,21,18,0,18,3,22,2,0,Matches,2022-2023,Ligue-1
Adrien Thomasson,fr FRA,"MF,FW",Lens,28.0,1993.0,14.2,24,17,8,11,5,12,45,26.7,33,25,2,23,4,28,17,0,Matches,2022-2023,Ligue-1
Khéphren Thuram,fr FRA,MF,Nice,21.0,2001.0,28.3,51,25,22,23,6,19,43,44.2,24,33,13,20,38,89,34,0,Matches,2022-2023,Ligue-1
Alexis Tibidi,fr FRA,"FW,MF",Troyes,18.0,2003.0,0.8,1,1,1,0,0,0,0,,0,0,0,0,0,1,0,0,Matches,2022-2023,Ligue-1
Jean-Clair Todibo,fr FRA,DF,Nice,22.0,1999.0,31.9,76,48,54,19,3,41,56,73.2,15,41,19,22,41,117,110,2,Matches,2022-2023,Ligue-1
Karl Toko Ekambi,cm CMR,"FW,MF",Rennes,29.0,1992.0,10.8,3,1,1,1,1,3,9,33.3,6,5,0,5,9,12,3,0,Matches,2022-2023,Ligue-1
Karl Toko Ekambi,cm CMR,"FW,MF",Lyon,29.0,1992.0,15.0,9,9,2,4,3,4,15,26.7,11,12,2,10,9,18,6,0,Matches,2022-2023,Ligue-1
Corentin Tolisso,fr FRA,MF,Lyon,27.0,1994.0,22.6,44,27,16,23,5,25,66,37.9,41,25,5,20,24,68,23,1,Matches,2022-2023,Ligue-1
Birama Touré,ml MLI,MF,Auxerre,30.0,1992.0,37.8,80,47,35,35,10,34,93,36.6,59,54,9,45,67,147,49,0,Matches,2022-2023,Ligue-1
Mohamed Toure,au AUS,"FW,MF",Reims,18.0,2004.0,0.3,0,0,0,0,0,0,0,,0,0,0,0,0,0,0,0,Matches,2022-2023,Ligue-1
Souleymane Touré,fr FRA,DF,Marseille,19.0,2003.0,0.8,2,1,1,1,0,1,2,50.0,1,1,0,1,0,2,5,0,Matches,2022-2023,Ligue-1
Souleymane Touré,fr FRA,DF,Auxerre,19.0,2003.0,17.6,29,13,19,9,1,16,20,80.0,4,32,12,20,26,55,56,1,Matches,2022-2023,Ligue-1
Yoann Touzghar,tn TUN,FW,Ajaccio,35.0,1986.0,5.0,3,2,0,2,1,0,1,0.0,1,0,0,0,0,3,1,0,Matches,2022-2023,Ligue-1
Charles Traore,ml MLI,DF,Nantes,30.0,1992.0,5.4,8,5,5,2,1,5,7,71.4,2,9,2,7,10,18,12,0,Matches,2022-2023,Ligue-1
Hamari Traoré,ml MLI,DF,Rennes,30.0,1992.0,28.1,48,32,26,15,7,28,52,53.8,24,33,7,26,38,86,64,0,Matches,2022-2023,Ligue-1
Théo Trinker,fr FRA,MF,Nice,21.0,2001.0,0.0,0,0,0,0,0,0,0,,0,0,0,0,0,0,0,0,Matches,2022-2023,Ligue-1
Adrien Truffert,fr FRA,DF,Rennes,20.0,2001.0,21.7,62,32,36,17,9,31,46,67.4,15,32,8,24,22,84,55,0,Matches,2022-2023,Ligue-1
Theocharis Tsingaras,gr GRE,MF,Toulouse,21.0,2000.0,0.1,0,0,0,0,0,0,0,,0,0,0,0,0,0,0,0,Matches,2022-2023,Ligue-1
Ike Ugbo,ca CAN,"FW,MF",Troyes,23.0,1998.0,9.9,5,2,2,2,1,3,11,27.3,8,8,2,6,2,7,4,0,Matches,2022-2023,Ligue-1
Lesley Ugochukwu,fr FRA,MF,Rennes,18.0,2004.0,14.8,36,19,13,20,3,16,24,66.7,8,24,10,14,21,57,16,0,Matches,2022-2023,Ligue-1
Cengiz Ünder,tr TUR,"MF,DF",Marseille,25.0,1997.0,27.7,37,19,15,13,9,13,34,38.2,21,18,2,16,18,55,13,0,Matches,2022-2023,Ligue-1
Jere Uronen,fi FIN,DF,Brest,28.0,1994.0,3.3,8,5,4,4,0,7,12,58.3,5,6,2,4,7,15,5,0,Matches,2022-2023,Ligue-1
Yan Valery,tn TUN,DF,Angers,23.0,1999.0,27.7,54,39,28,20,6,20,37,54.1,17,35,15,20,34,88,82,0,Matches,2022-2023,Ligue-1
Vanderson,br BRA,"DF,MF",Monaco,21.0,2001.0,24.6,84,48,36,34,14,44,75,58.7,31,36,9,27,48,132,36,1,Matches,2022-2023,Ligue-1
Jordan Veretout,fr FRA,MF,Marseille,29.0,1993.0,31.8,56,35,17,32,7,25,53,47.2,28,22,7,15,36,92,40,2,Matches,2022-2023,Ligue-1
Marco Verratti,it ITA,MF,Paris S-G,29.0,1992.0,24.4,76,49,34,36,6,38,89,42.7,51,42,6,36,27,103,11,3,Matches,2022-2023,Ligue-1
João Victor,br BRA,DF,Nantes,24.0,1998.0,9.4,19,11,9,7,3,12,22,54.5,10,11,1,10,15,34,30,0,Matches,2022-2023,Ligue-1
Clément Vidal,fr FRA,"DF,MF",Ajaccio,22.0,2000.0,21.1,25,15,14,11,0,18,38,47.4,20,27,16,11,27,52,73,1,Matches,2022-2023,Ligue-1
Alan Virginius,fr FRA,FW,Lille,19.0,2003.0,2.9,3,2,1,1,1,0,4,0.0,4,0,0,0,2,5,1,0,Matches,2022-2023,Ligue-1
Mattia Viti,it ITA,DF,Nice,20.0,2002.0,7.0,4,2,1,1,2,2,5,40.0,3,9,3,6,8,12,22,0,Matches,2022-2023,Ligue-1
Vitinha,pt POR,FW,Marseille,22.0,2000.0,5.2,15,7,0,6,9,3,11,27.3,8,3,0,3,2,17,6,0,Matches,2022-2023,Ligue-1
Vitinha,pt POR,MF,Paris S-G,22.0,2000.0,27.2,58,25,21,27,10,27,83,32.5,56,27,4,23,25,83,15,0,Matches,2022-2023,Ligue-1
Kevin Volland,de GER,"FW,MF",Monaco,30.0,1992.0,7.1,8,4,1,5,2,2,8,25.0,6,8,0,8,2,10,0,0,Matches,2022-2023,Ligue-1
Elye Wahi,fr FRA,FW,Montpellier,19.0,2003.0,27.9,9,3,2,3,4,5,14,35.7,9,14,2,12,3,12,5,0,Matches,2022-2023,Ligue-1
Timothy Weah,us USA,"DF,FW",Lille,22.0,2000.0,19.4,24,14,13,9,2,16,29,55.2,13,17,3,14,23,47,18,0,Matches,2022-2023,Ligue-1
Mateusz Wieteska,pl POL,DF,Clermont Foot,25.0,1997.0,34.6,41,23,28,13,0,19,33,57.6,14,44,28,16,56,97,97,4,Matches,2022-2023,Ligue-1
Christopher Wooh,cm CMR,DF,Rennes,20.0,2001.0,11.2,16,7,8,8,0,9,11,81.8,2,11,5,6,6,22,49,0,Matches,2022-2023,Ligue-1
Christopher Wooh,cm CMR,MF,Lens,20.0,2001.0,0.0,0,0,0,0,0,0,1,0.0,1,0,0,0,0,0,1,0,Matches,2022-2023,Ligue-1
Xeka,pt POR,MF,Rennes,27.0,1994.0,6.1,10,3,6,3,1,7,16,43.8,9,11,2,9,6,16,8,0,Matches,2022-2023,Ligue-1
Yusuf Yazıcı,tr TUR,MF,Lille,25.0,1997.0,2.2,0,0,0,0,0,0,0,,0,2,0,2,0,0,1,0,Matches,2022-2023,Ligue-1
Darlin Yongwa,cm CMR,DF,Lorient,21.0,2000.0,8.7,13,11,7,5,1,4,15,26.7,11,13,1,12,5,18,11,0,Matches,2022-2023,Ligue-1
Leny Yoro,fr FRA,DF,Lille,16.0,2005.0,8.5,11,5,8,3,0,4,9,44.4,5,6,1,5,18,29,27,1,Matches,2022-2023,Ligue-1
Mohamed Youssouf,km COM,DF,Ajaccio,34.0,1988.0,27.3,72,44,41,24,7,38,61,62.3,23,32,8,24,65,137,70,0,Matches,2022-2023,Ligue-1
Warren Zaïre-Emery,fr FRA,"MF,DF",Paris S-G,16.0,2006.0,10.3,17,10,5,10,2,8,29,27.6,21,11,0,11,12,29,17,0,Matches,2022-2023,Ligue-1
Oliver Zandén,se SWE,"DF,MF",Toulouse,20.0,2001.0,1.6,2,1,1,0,1,2,5,40.0,3,0,0,0,1,3,7,0,Matches,2022-2023,Ligue-1
Akim Zedadka,dz ALG,DF,Auxerre,27.0,1995.0,17.8,35,21,21,10,4,18,32,56.3,14,17,3,14,23,58,51,1,Matches,2022-2023,Ligue-1
Akim Zedadka,dz ALG,"DF,MF",Lille,27.0,1995.0,3.9,1,1,1,0,0,0,2,0.0,2,3,0,3,2,3,6,0,Matches,2022-2023,Ligue-1
Mehdi Zeffane,dz ALG,"DF,MF",Clermont Foot,30.0,1992.0,7.3,12,7,5,7,0,4,21,19.0,17,14,6,8,22,34,12,0,Matches,2022-2023,Ligue-1
Arber Zeneli,xk KVX,"FW,MF",Reims,27.0,1995.0,11.1,9,3,3,3,3,5,12,41.7,7,8,0,8,2,11,2,0,Matches,2022-2023,Ligue-1
Nathan Zeze,fr FRA,DF,Nantes,17.0,2005.0,0.7,3,2,2,1,0,1,1,100.0,0,0,0,0,0,3,1,0,Matches,2022-2023,Ligue-1
Edon Zhegrova,xk KVX,"FW,MF",Lille,23.0,1999.0,11.7,18,12,6,7,5,12,20,60.0,8,9,0,9,2,20,2,0,Matches,2022-2023,Ligue-1
Tanguy Zoukrou,fr FRA,DF,Troyes,19.0,2003.0,5.7,14,7,8,6,0,10,14,71.4,4,18,11,7,2,16,24,0,Matches,2022-2023,Ligue-1
Keyliane Abdallah,fr FRA,FW,Marseille,17.0,2006.0,0.0,0,0,0,0,0,0,0,,0,0,0,0,0,0,0,0,Matches,2023-2024,Ligue-1
Yunis Abdelhamid,ma MAR,DF,Reims,35.0,1987.0,30.9,64,35,36,23,5,26,45,57.8,19,51,32,19,39,103,109,2,Matches,2023-2024,Ligue-1
Salis Abdul Samed,gh GHA,MF,Lens,23.0,2000.0,16.9,21,14,8,10,3,8,18,44.4,10,12,1,11,12,33,18,0,Matches,2023-2024,Ligue-1
Laurent Abergel,fr FRA,MF,Lorient,30.0,1993.0,31.8,85,52,43,34,8,38,96,39.6,58,29,6,23,61,146,61,3,Matches,2023-2024,Ligue-1
Matthis Abline,fr FRA,FW,Nantes,20.0,2003.0,11.6,9,4,4,3,2,3,8,37.5,5,3,0,3,3,12,5,0,Matches,2023-2024,Ligue-1
Zakaria Aboukhlal,ma MAR,"MF,FW",Toulouse,23.0,2000.0,8.4,9,8,1,5,3,3,12,25.0,9,9,1,8,1,10,2,0,Matches,2023-2024,Ligue-1
Akor Adams,ng NGA,FW,Montpellier,23.0,2000.0,25.0,12,4,3,4,5,3,7,42.9,4,9,2,7,5,17,11,0,Matches,2023-2024,Ligue-1
Nathaniel Adjei,gh GHA,DF,Lorient,20.0,2002.0,13.8,13,9,8,3,2,6,7,85.7,1,15,8,7,18,31,64,1,Matches,2023-2024,Ligue-1
Adryelson,br BRA,"DF,FW",Lyon,25.0,1998.0,0.1,0,0,0,0,0,0,0,,0,0,0,0,1,1,3,0,Matches,2023-2024,Ligue-1
Adson,br BRA,"MF,FW",Nantes,22.0,2000.0,2.6,7,6,1,6,0,2,2,100.0,0,5,0,5,2,9,2,0,Matches,2023-2024,Ligue-1
Emmanuel Agbadou,ci CIV,DF,Reims,26.0,1997.0,28.8,65,41,38,23,4,44,64,68.8,20,47,25,22,55,120,116,1,Matches,2023-2024,Ligue-1
Ruben Aguilar,fr FRA,DF,Lens,30.0,1993.0,21.4,53,31,27,23,3,27,45,60.0,18,35,5,30,26,79,46,0,Matches,2023-2024,Ligue-1
Tosin Aiyegun,bj BEN,"MF,FW",Lorient,25.0,1998.0,10.0,6,4,2,3,1,3,9,33.3,6,4,1,3,2,8,8,0,Matches,2023-2024,Ligue-1
Sergio Akieme,es ESP,DF,Reims,25.0,1997.0,9.1,11,5,6,3,2,8,11,72.7,3,9,3,6,10,21,25,0,Matches,2023-2024,Ligue-1
Maghnes Akliouche,fr FRA,"MF,FW",Monaco,21.0,2002.0,17.9,37,23,12,20,5,12,36,33.3,24,21,0,21,9,46,3,0,Matches,2023-2024,Ligue-1
Paul Akouokou,ci CIV,MF,Lyon,25.0,1997.0,3.4,14,9,2,10,2,6,7,85.7,1,5,1,4,6,20,11,0,Matches,2023-2024,Ligue-1
Aboubacar Ali,km COM,"MF,FW",Strasbourg,17.0,2006.0,1.4,2,0,0,2,0,0,0,,0,1,0,1,1,3,2,0,Matches,2023-2024,Ligue-1
Mohamed Ali Cho,fr FRA,FW,Nice,19.0,2004.0,9.6,12,9,4,7,1,3,11,27.3,8,10,0,10,3,15,6,0,Matches,2023-2024,Ligue-1
Nabil Alioui,fr FRA,"MF,FW",Le Havre,24.0,1999.0,11.2,3,2,2,1,0,2,4,50.0,2,6,1,5,3,6,4,0,Matches,2023-2024,Ligue-1
Jim Allevinah,ga GAB,"MF,DF",Clermont Foot,28.0,1995.0,20.7,30,18,11,14,5,14,35,40.0,21,20,3,17,13,43,30,0,Matches,2023-2024,Ligue-1
Skelly Alvero,fr FRA,MF,Lyon,21.0,2002.0,4.7,8,7,5,2,1,2,9,22.2,7,5,1,4,2,10,5,0,Matches,2023-2024,Ligue-1
Papa Amadou Diallo,sn SEN,FW,Metz,19.0,2004.0,9.9,18,8,10,7,1,7,21,33.3,14,11,1,10,11,29,16,0,Matches,2023-2024,Ligue-1
Jordan Amavi,fr FRA,DF,Brest,29.0,1994.0,1.0,1,1,0,1,0,1,3,33.3,2,2,1,1,3,4,2,0,Matches,2023-2024,Ligue-1
Kelvin Amian,fr FRA,DF,Nantes,25.0,1998.0,8.9,16,7,12,4,0,11,15,73.3,4,6,0,6,7,23,28,0,Matches,2023-2024,Ligue-1
Michael Amir Murillo,pa PAN,DF,Marseille,27.0,1996.0,11.1,23,11,13,6,4,15,23,65.2,8,9,2,7,11,34,34,2,Matches,2023-2024,Ligue-1
Benjamin André,fr FRA,MF,Lille,32.0,1990.0,28.6,89,49,39,45,5,43,81,53.1,38,34,5,29,35,124,60,0,Matches,2023-2024,Ligue-1
Komnen Andrić,rs SRB,FW,Clermont Foot,28.0,1995.0,1.9,2,1,0,1,1,0,4,0.0,4,2,0,2,0,2,1,0,Matches,2023-2024,Ligue-1
Ângelo,br BRA,"FW,MF",Strasbourg,18.0,2004.0,12.2,24,11,9,7,8,11,31,35.5,20,18,0,18,9,33,2,0,Matches,2023-2024,Ligue-1
Stredair Appuah,fr FRA,"FW,MF",Nantes,19.0,2004.0,0.9,0,0,0,0,0,0,3,0.0,3,0,0,0,1,1,1,0,Matches,2023-2024,Ligue-1
Yoël Armougom,fr FRA,"DF,MF",Clermont Foot,25.0,1998.0,2.6,3,3,2,0,1,2,3,66.7,1,1,0,1,1,4,3,0,Matches,2023-2024,Ligue-1
Hákon Arnar Haraldsson,is ISL,"FW,MF",Lille,20.0,2003.0,14.3,12,8,4,7,1,5,21,23.8,16,7,2,5,3,15,5,0,Matches,2023-2024,Ligue-1
Mohamed El Arouch,fr FRA,FW,Lyon,19.0,2004.0,0.0,0,0,0,0,0,0,0,,0,0,0,0,0,0,0,0,Matches,2023-2024,Ligue-1
Marco Asensio,es ESP,"MF,FW",Paris S-G,27.0,1996.0,12.4,12,10,4,7,1,4,13,30.8,9,7,0,7,5,17,2,0,Matches,2023-2024,Ligue-1
Joel Asoro,se SWE,"FW,MF",Metz,24.0,1999.0,9.4,13,9,7,6,0,3,10,30.0,7,7,1,6,6,19,9,0,Matches,2023-2024,Ligue-1
Lorenz Assignon,tg TOG,DF,Rennes,23.0,2000.0,11.2,24,12,12,8,4,9,24,37.5,15,9,4,5,9,33,27,1,Matches,2023-2024,Ligue-1
Youcef Atal,dz ALG,DF,Nice,27.0,1996.0,4.0,9,3,6,2,1,6,8,75.0,2,7,1,6,4,13,1,0,Matches,2023-2024,Ligue-1
Valentin Atangana Edoa,fr FRA,MF,Reims,17.0,2005.0,6.2,19,13,6,9,4,5,13,38.5,8,5,1,4,6,25,9,0,Matches,2023-2024,Ligue-1
Arthur Atta,fr FRA,"MF,FW",Metz,20.0,2003.0,10.3,18,14,8,7,3,8,19,42.1,11,13,3,10,10,28,23,0,Matches,2023-2024,Ligue-1
Pierre-Emerick Aubameyang,ga GAB,FW,Marseille,34.0,1989.0,29.1,22,14,4,11,7,7,26,26.9,19,30,5,25,9,31,26,0,Matches,2023-2024,Ligue-1
André Ayew,gh GHA,FW,Le Havre,33.0,1989.0,12.3,15,11,7,6,2,6,9,66.7,3,8,3,5,2,17,11,0,Matches,2023-2024,Ligue-1
Neil El Aynaoui,fr FRA,MF,Lens,22.0,2001.0,17.4,37,20,13,20,4,20,46,43.5,26,20,6,14,32,69,21,1,Matches,2023-2024,Ligue-1
Abdellah Baallal,ma MAR,MF,Clermont Foot,18.0,2004.0,0.0,0,0,0,0,0,0,0,,0,1,0,1,0,0,0,0,Matches,2023-2024,Ligue-1
Shavy Babicka,ga GAB,"FW,MF",Toulouse,23.0,2000.0,4.1,11,8,2,7,2,2,5,40.0,3,6,1,5,0,11,2,0,Matches,2023-2024,Ligue-1
Aliou Badara Baldé,gn GUI,"FW,DF",Nice,20.0,2002.0,0.8,4,1,0,3,1,1,1,100.0,0,2,1,1,3,7,0,0,Matches,2023-2024,Ligue-1
Tiemoué Bakayoko,fr FRA,MF,Lorient,28.0,1994.0,14.6,34,17,14,17,3,15,28,53.6,13,10,4,6,26,60,15,1,Matches,2023-2024,Ligue-1
Dilane Bakwa,fr FRA,"FW,MF",Strasbourg,20.0,2002.0,24.2,30,22,12,13,5,11,40,27.5,29,26,1,25,20,50,11,0,Matches,2023-2024,Ligue-1
Carlos Baleba,cm CMR,MF,Lille,19.0,2004.0,0.7,6,2,1,4,1,3,4,75.0,1,0,0,0,2,8,0,0,Matches,2023-2024,Ligue-1
Leonardo Balerdi,ar ARG,DF,Marseille,24.0,1999.0,25.2,79,50,55,23,1,49,67,73.1,18,38,15,23,51,130,91,0,Matches,2023-2024,Ligue-1
Folarin Balogun,us USA,FW,Monaco,22.0,2001.0,18.8,12,4,3,8,1,5,13,38.5,8,10,0,10,3,15,4,0,Matches,2023-2024,Ligue-1
Mohamed Bamba,ci CIV,FW,Lorient,21.0,2001.0,12.6,14,9,3,8,3,4,10,40.0,6,7,1,6,2,16,3,0,Matches,2023-2024,Ligue-1
Mamady Bangré,bf BFA,"FW,MF",Toulouse,22.0,2001.0,1.1,4,2,2,2,0,3,4,75.0,1,0,0,0,4,8,3,0,Matches,2023-2024,Ligue-1
Bradley Barcola,fr FRA,FW,Lyon,20.0,2002.0,3.0,5,2,0,2,3,1,7,14.3,6,4,0,4,2,7,0,0,Matches,2023-2024,Ligue-1
Bradley Barcola,fr FRA,"FW,MF",Paris S-G,20.0,2002.0,15.2,34,16,12,13,9,7,25,28.0,18,27,2,25,10,44,13,1,Matches,2023-2024,Ligue-1
Melvin Bard,fr FRA,DF,Nice,22.0,2000.0,29.5,69,38,28,30,11,37,63,58.7,26,46,12,34,42,111,46,0,Matches,2023-2024,Ligue-1
Steven Baseya,fr FRA,DF,Strasbourg,18.0,2005.0,0.1,2,1,1,1,0,1,1,100.0,0,0,0,0,0,2,1,0,Matches,2023-2024,Ligue-1
Mohamed Bechikh,fr FRA,"FW,MF",Strasbourg,18.0,2005.0,0.2,0,0,0,0,0,0,0,,0,0,0,0,0,0,0,0,Matches,2023-2024,Ligue-1
Yanis Begraoui,ma MAR,"FW,MF",Toulouse,22.0,2001.0,3.3,5,3,1,3,1,3,9,33.3,6,4,0,4,5,10,5,0,Matches,2023-2024,Ligue-1
Jérémie Bela,ao ANG,"MF,FW",Clermont Foot,30.0,1993.0,2.3,1,1,0,1,0,1,3,33.3,2,1,0,1,0,1,1,0,Matches,2023-2024,Ligue-1
Reda Belahyane,ma MAR,MF,Nice,19.0,2004.0,0.3,1,0,0,1,0,1,1,100.0,0,0,0,0,0,1,0,0,Matches,2023-2024,Ligue-1
Alaa Bellaarouch,ma MAR,GK,Strasbourg,21.0,2002.0,15.0,0,0,0,0,0,0,0,,0,0,0,0,1,1,11,2,Matches,2023-2024,Ligue-1
Jean-Ricner Bellegarde,fr FRA,"MF,FW",Strasbourg,25.0,1998.0,3.0,5,3,3,2,0,3,6,50.0,3,4,0,4,4,9,0,0,Matches,2023-2024,Ligue-1
Jeanuël Belocian,fr FRA,DF,Rennes,18.0,2005.0,16.1,32,22,23,8,1,22,28,78.6,6,18,10,8,13,45,49,0,Matches,2023-2024,Ligue-1
Eliesse Ben Seghir,ma MAR,"MF,FW",Monaco,18.0,2005.0,4.8,9,6,2,5,2,3,7,42.9,4,6,0,6,2,11,2,0,Matches,2023-2024,Ligue-1
Wissam Ben Yedder,fr FRA,FW,Monaco,32.0,1990.0,25.7,4,3,1,2,1,1,11,9.1,10,18,0,18,8,12,1,0,Matches,2023-2024,Ligue-1
Saïd Benrahma,dz ALG,"FW,MF",Lyon,27.0,1995.0,8.6,9,7,1,6,2,5,7,71.4,2,7,0,7,1,10,3,0,Matches,2023-2024,Ligue-1
Nabil Bentaleb,dz ALG,MF,Lille,28.0,1994.0,21.9,49,32,29,18,2,22,43,51.2,21,33,12,21,37,86,33,0,Matches,2023-2024,Ligue-1
Lucas Beraldo,br BRA,DF,Paris S-G,19.0,2003.0,11.2,22,14,14,8,0,10,25,40.0,15,15,6,9,20,42,25,0,Matches,2023-2024,Ligue-1
Dimitry Bertaud,cd COD,GK,Montpellier,25.0,1998.0,4.0,0,0,0,0,0,0,0,,0,0,0,0,0,0,0,0,Matches,2023-2024,Ligue-1
Marco Bizot,nl NED,GK,Brest,32.0,1991.0,32.0,0,0,0,0,0,0,1,0.0,1,0,0,0,0,0,18,3,Matches,2023-2024,Ligue-1
Rubén Blanco,es ESP,GK,Marseille,28.0,1995.0,1.3,0,0,0,0,0,0,0,,0,0,0,0,0,0,0,0,Matches,2023-2024,Ligue-1
Ludovic Blas,fr FRA,"FW,MF",Rennes,25.0,1997.0,17.4,30,14,16,13,1,12,28,42.9,16,13,1,12,6,36,9,0,Matches,2023-2024,Ligue-1
Myron Boadu,nl NED,FW,Monaco,22.0,2001.0,0.9,2,2,0,1,1,1,2,50.0,1,2,0,2,0,2,0,0,Matches,2023-2024,Ligue-1
Jeremie Boga,ci CIV,FW,Nice,26.0,1997.0,22.2,18,7,6,10,2,10,20,50.0,10,26,2,24,8,26,4,0,Matches,2023-2024,Ligue-1
Adama Bojang,gm GAM,FW,Reims,19.0,2004.0,0.9,2,1,1,0,1,0,0,,0,2,1,1,1,3,0,0,Matches,2023-2024,Ligue-1
Neto Borges,br BRA,DF,Clermont Foot,26.0,1996.0,28.0,48,24,25,18,5,28,63,44.4,35,28,6,22,57,105,84,0,Matches,2023-2024,Ligue-1
Saïmon Bouabré,fr FRA,MF,Monaco,17.0,2006.0,0.5,2,2,0,2,0,1,2,50.0,1,1,0,1,0,2,0,0,Matches,2023-2024,Ligue-1
Ayyoub Bouaddi,fr FRA,MF,Lille,15.0,2007.0,1.5,6,2,6,0,0,2,5,40.0,3,2,0,2,1,7,3,0,Matches,2023-2024,Ligue-1
Badredine Bouanani,dz ALG,FW,Nice,18.0,2004.0,1.8,3,2,1,1,1,3,4,75.0,1,5,0,5,3,6,0,0,Matches,2023-2024,Ligue-1
Badredine Bouanani,dz ALG,MF,Lorient,18.0,2004.0,4.9,4,2,1,1,2,2,4,50.0,2,3,0,3,2,6,3,0,Matches,2023-2024,Ligue-1
Mohamed Bouchenna,fr FRA,"MF,FW",Clermont Foot,17.0,2006.0,0.3,1,0,1,0,0,0,0,,0,0,0,0,0,1,0,0,Matches,2023-2024,Ligue-1
Hicham Boudaoui,dz ALG,MF,Nice,23.0,1999.0,17.9,41,19,16,22,3,21,30,70.0,9,15,1,14,11,52,15,0,Matches,2023-2024,Ligue-1
Benjamin Bourigeaud,fr FRA,"MF,FW",Rennes,29.0,1994.0,26.9,31,18,14,9,8,13,44,29.5,31,31,2,29,22,53,39,2,Matches,2023-2024,Ligue-1
Bilal Boutobba,fr FRA,"FW,MF",Clermont Foot,24.0,1998.0,10.3,22,12,6,10,6,10,23,43.5,13,9,0,9,8,30,3,0,Matches,2023-2024,Ligue-1
Hugo Boutsingkham,fr FRA,"MF,FW",Nantes,20.0,2003.0,0.1,0,0,0,0,0,0,0,,0,0,0,0,0,0,1,0,Matches,2023-2024,Ligue-1
Bilal Brahimi,dz ALG,FW,Nice,23.0,2000.0,0.1,0,0,0,0,0,0,1,0.0,1,0,0,0,0,0,0,0,Matches,2023-2024,Ligue-1
Bilal Brahimi,dz ALG,"FW,MF",Brest,23.0,2000.0,2.5,0,0,0,0,0,0,3,0.0,3,3,0,3,0,0,0,0,Matches,2023-2024,Ligue-1
Lilian Brassier,fr FRA,DF,Brest,23.0,1999.0,29.7,31,18,18,13,0,12,24,50.0,12,28,21,7,41,72,93,0,Matches,2023-2024,Ligue-1
Maxime Busi,be BEL,"FW,DF",Reims,23.0,1999.0,1.8,2,0,0,1,1,0,2,0.0,2,6,1,5,4,6,5,0,Matches,2023-2024,Ligue-1
Marcin Bułka,pl POL,GK,Nice,23.0,1999.0,34.0,0,0,0,0,0,0,2,0.0,2,0,0,0,0,0,9,3,Matches,2023-2024,Ligue-1
Rémy Cabella,fr FRA,"FW,MF",Lille,33.0,1990.0,16.4,54,36,19,20,15,20,54,37.0,34,32,0,32,5,59,5,0,Matches,2023-2024,Ligue-1
Duje Ćaleta-Car,hr CRO,DF,Lyon,26.0,1996.0,22.1,26,11,19,6,1,18,22,81.8,4,27,14,13,18,44,94,1,Matches,2023-2024,Ligue-1
Lamine Camara,sn SEN,MF,Metz,19.0,2004.0,25.1,62,42,26,30,6,24,49,49.0,25,35,2,33,28,90,34,0,Matches,2023-2024,Ligue-1
Mahdi Camara,fr FRA,MF,Brest,25.0,1998.0,22.4,55,39,8,40,7,20,49,40.8,29,24,1,23,27,82,19,0,Matches,2023-2024,Ligue-1
Mohamed Camara,ml MLI,MF,Monaco,23.0,2000.0,11.5,35,21,10,20,5,15,29,51.7,14,8,2,6,11,46,7,0,Matches,2023-2024,Ligue-1
Axel Camblan,fr FRA,FW,Brest,19.0,2003.0,1.0,3,1,0,2,1,2,4,50.0,2,2,0,2,0,3,0,0,Matches,2023-2024,Ligue-1
Fali Candé,gw GNB,DF,Metz,25.0,1998.0,20.5,40,19,31,9,0,20,35,57.1,15,41,28,13,20,60,107,1,Matches,2023-2024,Ligue-1
Gino Caoki,fr FRA,MF,Lorient,19.0,2004.0,0.1,0,0,0,0,0,0,1,0.0,1,0,0,0,0,0,0,0,Matches,2023-2024,Ligue-1
Maxence Caqueret,fr FRA,MF,Lyon,23.0,2000.0,33.6,91,64,39,37,15,38,107,35.5,69,40,9,31,48,139,26,2,Matches,2023-2024,Ligue-1
Igor Carioca,br BRA,"DF,MF",Lorient,26.0,1996.0,2.9,8,6,6,1,1,4,6,66.7,2,0,0,0,3,11,6,0,Matches,2023-2024,Ligue-1
Antonin Cartillier,fr FRA,DF,Monaco,19.0,2004.0,0.1,0,0,0,0,0,0,0,,0,1,0,1,0,0,0,0,Matches,2023-2024,Ligue-1
Josué Casimir,fr FRA,"FW,DF",Le Havre,21.0,2001.0,22.4,31,18,14,14,3,7,18,38.9,11,23,2,21,13,44,25,0,Matches,2023-2024,Ligue-1
Cristian Cásseres Jr.,ve VEN,MF,Toulouse,23.0,2000.0,21.6,70,34,31,33,6,29,61,47.5,32,34,4,30,27,97,33,1,Matches,2023-2024,Ligue-1
Jean-Charles Castelletto,cm CMR,DF,Nantes,28.0,1995.0,27.4,34,26,22,10,2,18,29,62.1,11,19,10,9,32,66,81,0,Matches,2023-2024,Ligue-1
Maximiliano Caufriez,be BEL,DF,Clermont Foot,26.0,1997.0,18.4,38,28,31,5,2,19,29,65.5,10,18,12,6,18,56,69,2,Matches,2023-2024,Ligue-1
Ivan Cavaleiro,pt POR,FW,Lille,29.0,1993.0,8.6,10,6,3,4,3,7,20,35.0,13,9,2,7,5,15,6,0,Matches,2023-2024,Ligue-1
Fabien Centonze,fr FRA,DF,Nantes,27.0,1996.0,1.0,2,1,2,0,0,2,3,66.7,1,2,1,1,0,2,1,0,Matches,2023-2024,Ligue-1
Fares Chaïbi,dz ALG,"FW,MF",Toulouse,20.0,2002.0,0.6,0,0,0,0,0,0,0,,0,0,0,0,0,0,2,0,Matches,2023-2024,Ligue-1
Muhammed Cham,at AUT,"MF,FW",Clermont Foot,22.0,2000.0,28.4,25,14,10,13,2,11,27,40.7,16,20,2,18,8,33,5,1,Matches,2023-2024,Ligue-1
Brendan Chardonnet,fr FRA,DF,Brest,28.0,1994.0,33.0,57,34,33,22,2,32,63,50.8,31,58,34,24,53,110,139,3,Matches,2023-2024,Ligue-1
Jhoanner Chávez,ec ECU,DF,Lens,21.0,2002.0,5.3,6,5,2,2,2,3,9,33.3,6,2,0,2,5,11,11,0,Matches,2023-2024,Ligue-1
Rayan Cherki,fr FRA,"MF,FW",Lyon,19.0,2003.0,19.1,28,15,4,16,8,17,46,37.0,29,13,3,10,7,35,1,0,Matches,2023-2024,Ligue-1
Lucas Chevalier,fr FRA,GK,Lille,21.0,2001.0,33.0,3,0,3,0,0,3,4,75.0,1,1,0,1,0,3,11,2,Matches,2023-2024,Ligue-1
Pedro Chirivella,es ESP,MF,Nantes,26.0,1997.0,28.8,50,28,20,29,1,30,76,39.5,46,22,5,17,31,81,28,0,Matches,2023-2024,Ligue-1
Joris Chotard,fr FRA,MF,Montpellier,21.0,2001.0,28.7,81,52,45,25,11,48,96,50.0,48,47,21,26,44,125,60,0,Matches,2023-2024,Ligue-1
Djaoui Cissé,fr FRA,MF,Rennes,19.0,2004.0,0.0,0,0,0,0,0,0,0,,0,0,0,0,0,0,0,0,Matches,2023-2024,Ligue-1
Ibrahim Cissoko,nl NED,"FW,MF",Toulouse,20.0,2003.0,2.7,4,3,3,1,0,1,3,33.3,2,3,0,3,1,5,0,0,Matches,2023-2024,Ligue-1
Alexis Claude-Maurice,fr FRA,MF,Nice,25.0,1998.0,5.6,12,5,3,6,3,1,5,20.0,4,4,1,3,5,17,7,0,Matches,2023-2024,Ligue-1
Jonathan Clauss,fr FRA,DF,Marseille,30.0,1992.0,23.0,47,20,22,19,6,26,49,53.1,23,17,3,14,36,83,46,0,Matches,2023-2024,Ligue-1
Marcus Coco,fr FRA,"DF,FW",Nantes,27.0,1996.0,16.5,43,26,29,10,4,28,60,46.7,32,19,1,18,21,64,38,0,Matches,2023-2024,Ligue-1
Maxime Colin,fr FRA,DF,Metz,31.0,1991.0,20.4,39,23,25,7,7,16,29,55.2,13,22,7,15,20,59,71,0,Matches,2023-2024,Ligue-1
Eray Cömert,ch SUI,DF,Nantes,25.0,1998.0,22.2,42,28,28,13,1,28,38,73.7,10,35,18,17,36,78,77,1,Matches,2023-2024,Ligue-1
Alois Confais,fr FRA,"MF,FW",Le Havre,26.0,1996.0,0.1,2,2,1,1,0,1,1,100.0,0,0,0,0,0,2,0,0,Matches,2023-2024,Ligue-1
Joaquín Correa,ar ARG,"FW,MF",Marseille,28.0,1994.0,4.8,7,5,4,2,1,0,8,0.0,8,2,0,2,1,8,1,0,Matches,2023-2024,Ligue-1
Oscar Cortés,co COL,"FW,MF",Lens,19.0,2003.0,0.5,0,0,0,0,0,0,0,,0,1,0,1,0,0,0,0,Matches,2023-2024,Ligue-1
David Costa,pt POR,MF,Lens,22.0,2001.0,16.6,18,10,5,12,1,10,23,43.5,13,21,4,17,16,34,8,1,Matches,2023-2024,Ligue-1
Logan Costa,cv CPV,DF,Toulouse,22.0,2001.0,29.4,40,24,31,9,0,15,24,62.5,9,42,27,15,23,63,120,1,Matches,2023-2024,Ligue-1
Grégoire Coudert,fr FRA,GK,Brest,24.0,1999.0,2.0,0,0,0,0,0,0,0,,0,0,0,0,0,0,0,0,Matches,2023-2024,Ligue-1
Mamadou Coulibaly,fr FRA,MF,Monaco,19.0,2004.0,1.3,7,4,2,3,2,3,8,37.5,5,4,0,4,0,7,0,0,Matches,2023-2024,Ligue-1
Tanguy Coulibaly,fr FRA,"FW,MF",Montpellier,22.0,2001.0,6.9,13,11,8,4,1,4,9,44.4,5,11,1,10,2,15,2,0,Matches,2023-2024,Ligue-1
Nicolas Cozza,fr FRA,DF,Nantes,24.0,1999.0,9.9,35,23,23,10,2,17,24,70.8,7,7,0,7,14,49,32,0,Matches,2023-2024,Ligue-1
Trévis Dago,ci CIV,"FW,MF",Lille,18.0,2005.0,0.3,0,0,0,0,0,0,0,,0,0,0,0,1,1,0,0,Matches,2023-2024,Ligue-1
Thijs Dallinga,nl NED,FW,Toulouse,22.0,2000.0,27.9,29,15,6,11,12,9,15,60.0,6,11,4,7,3,32,35,0,Matches,2023-2024,Ligue-1
Kevin Danso,at AUT,DF,Lens,24.0,1998.0,29.5,24,14,12,11,1,15,30,50.0,15,43,30,13,23,47,115,1,Matches,2023-2024,Ligue-1
Dante,br BRA,DF,Nice,39.0,1983.0,31.6,62,30,44,16,2,38,52,73.1,14,43,22,21,37,99,77,2,Matches,2023-2024,Ligue-1
Raimane Daou,km COM,"DF,MF",Marseille,18.0,2004.0,0.3,1,1,1,0,0,1,2,50.0,1,0,0,0,0,1,2,0,Matches,2023-2024,Ligue-1
Mohamed Daramy,dk DEN,"FW,MF",Reims,21.0,2002.0,18.3,10,9,4,4,2,6,16,37.5,10,5,1,4,4,14,4,0,Matches,2023-2024,Ligue-1
Achraf Dari,ma MAR,"DF,FW",Brest,24.0,1999.0,1.3,1,1,1,0,0,0,2,0.0,2,2,0,2,5,6,9,1,Matches,2023-2024,Ligue-1
Jonathan David,ca CAN,FW,Lille,23.0,2000.0,29.2,26,15,6,13,7,8,26,30.8,18,16,0,16,9,35,4,0,Matches,2023-2024,Ligue-1
Thibault De Smet,be BEL,DF,Reims,25.0,1998.0,20.3,56,35,36,16,4,33,59,55.9,26,25,5,20,21,77,51,1,Matches,2023-2024,Ligue-1
Romain Del Castillo,fr FRA,FW,Brest,27.0,1996.0,27.7,46,29,14,18,14,18,70,25.7,52,33,1,32,9,55,8,0,Matches,2023-2024,Ligue-1
Thomas Delaine,fr FRA,"DF,MF",Strasbourg,31.0,1992.0,22.7,38,19,29,8,1,20,42,47.6,22,18,2,16,17,55,51,0,Matches,2023-2024,Ligue-1
Sacha Delaye,fr FRA,"MF,FW",Montpellier,21.0,2002.0,1.4,7,2,2,2,3,1,6,16.7,5,2,0,2,0,7,1,0,Matches,2023-2024,Ligue-1
Karamoko Dembélé,eng ENG,"MF,FW",Brest,20.0,2003.0,0.2,0,0,0,0,0,0,0,,0,0,0,0,0,0,0,0,Matches,2023-2024,Ligue-1
Ousmane Dembélé,fr FRA,"MF,FW",Paris S-G,26.0,1997.0,16.7,19,14,2,7,10,6,13,46.2,7,11,0,11,5,24,4,1,Matches,2023-2024,Ligue-1
Jessy Deminguet,fr FRA,"MF,FW",Strasbourg,25.0,1998.0,7.7,14,9,6,8,0,6,18,33.3,12,8,0,8,9,23,5,1,Matches,2023-2024,Ligue-1
Rémy Descamps,fr FRA,GK,Nantes,27.0,1996.0,6.0,0,0,0,0,0,0,0,,0,0,0,0,0,0,7,0,Matches,2023-2024,Ligue-1
Mikkel Desler,dk DEN,DF,Toulouse,28.0,1995.0,17.2,18,12,8,7,3,9,17,52.9,8,32,13,19,19,37,38,0,Matches,2023-2024,Ligue-1
Arthur Desmas,fr FRA,GK,Le Havre,29.0,1994.0,33.0,0,0,0,0,0,0,2,0.0,2,0,0,0,0,0,13,1,Matches,2023-2024,Ligue-1
Lamine Diack,sn SEN,MF,Nantes,22.0,2000.0,0.0,0,0,0,0,0,0,0,,0,0,0,0,0,0,0,0,Matches,2023-2024,Ligue-1
Mamadou Diakhon,fr FRA,"FW,MF",Reims,17.0,2005.0,2.3,5,3,2,1,2,3,9,33.3,6,1,0,1,1,6,1,0,Matches,2023-2024,Ligue-1
Bafodé Diakité,fr FRA,DF,Lille,22.0,2001.0,18.8,29,20,12,15,2,24,32,75.0,8,16,8,8,21,50,49,1,Matches,2023-2024,Ligue-1
Ibrahim Diakité,gn GUI,DF,Reims,19.0,2003.0,1.2,1,0,0,1,0,0,1,0.0,1,3,0,3,2,3,5,0,Matches,2023-2024,Ligue-1
Oumar Diakité,ci CIV,FW,Reims,19.0,2003.0,17.6,25,12,10,9,6,7,21,33.3,14,13,0,13,7,32,7,0,Matches,2023-2024,Ligue-1
Habib Diarra,sn SEN,"MF,FW",Strasbourg,19.0,2004.0,25.6,30,23,8,20,2,9,33,27.3,24,23,4,19,17,47,15,0,Matches,2023-2024,Ligue-1
Moussa Diarra,ml MLI,DF,Toulouse,22.0,2000.0,15.5,32,12,16,15,1,13,27,48.1,14,30,14,16,20,52,43,0,Matches,2023-2024,Ligue-1
Krépin Diatta,sn SEN,"DF,FW",Monaco,24.0,1999.0,13.4,37,20,17,16,4,27,49,55.1,22,17,2,15,16,53,22,0,Matches,2023-2024,Ligue-1
Mory Diaw,sn SEN,GK,Clermont Foot,30.0,1993.0,30.0,1,1,1,0,0,1,2,50.0,1,0,0,0,1,2,13,5,Matches,2023-2024,Ligue-1
Mahamadou Diawara,fr FRA,MF,Lyon,18.0,2005.0,4.0,9,6,4,5,0,3,11,27.3,8,4,1,3,4,13,4,0,Matches,2023-2024,Ligue-1
Bamba Dieng,sn SEN,FW,Lorient,23.0,2000.0,6.1,3,3,0,3,0,1,3,33.3,2,3,0,3,0,3,7,0,Matches,2023-2024,Ligue-1
Guillaume Dietsch,fr FRA,GK,Metz,22.0,2001.0,0.8,0,0,0,0,0,0,0,,0,0,0,0,0,0,0,0,Matches,2023-2024,Ligue-1
Sinaly Diomande,ci CIV,DF,Lyon,22.0,2001.0,9.9,10,4,5,3,2,9,16,56.3,7,12,9,3,15,25,26,1,Matches,2023-2024,Ligue-1
Edan Diop,fr FRA,"MF,DF",Monaco,18.0,2004.0,1.8,10,8,6,3,1,7,9,77.8,2,3,0,3,1,11,5,0,Matches,2023-2024,Ligue-1
Sofiane Diop,fr FRA,FW,Nice,23.0,2000.0,5.5,8,6,3,4,1,4,10,40.0,6,4,0,4,3,11,3,0,Matches,2023-2024,Ligue-1
Andy Diouf,fr FRA,MF,Lens,20.0,2003.0,14.6,28,19,12,11,5,14,22,63.6,8,13,3,10,3,31,5,1,Matches,2023-2024,Ligue-1
Yehvann Diouf,fr FRA,GK,Reims,23.0,1999.0,34.0,0,0,0,0,0,0,1,0.0,1,0,0,0,1,1,19,3,Matches,2023-2024,Ligue-1
Chaim El Djebali,tn TUN,MF,Lyon,19.0,2004.0,0.1,0,0,0,0,0,0,0,,0,0,0,0,0,0,0,0,Matches,2023-2024,Ligue-1
Jeremy Doku,be BEL,FW,Rennes,21.0,2002.0,1.2,2,2,1,0,1,1,1,100.0,0,0,0,0,0,2,0,0,Matches,2023-2024,Ligue-1
Gianluigi Donnarumma,it ITA,GK,Paris S-G,24.0,1999.0,24.1,0,0,0,0,0,0,0,,0,0,0,0,1,1,9,4,Matches,2023-2024,Ligue-1
Siriné Doucouré,ml MLI,FW,Lorient,21.0,2002.0,4.7,8,6,0,4,4,3,3,100.0,0,4,0,4,1,9,6,0,Matches,2023-2024,Ligue-1
Désiré Doué,fr FRA,"MF,FW",Rennes,18.0,2005.0,18.1,32,18,11,14,7,10,33,30.3,23,30,1,29,14,46,8,0,Matches,2023-2024,Ligue-1
Guela Doué,ci CIV,DF,Rennes,20.0,2002.0,13.7,28,21,14,12,2,22,32,68.8,10,12,1,11,15,43,65,1,Matches,2023-2024,Ligue-1
Douglas,br BRA,MF,Nantes,26.0,1997.0,19.7,70,42,34,30,6,30,59,50.8,29,22,8,14,26,96,30,0,Matches,2023-2024,Ligue-1
Ismaël Doukouré,fr FRA,"MF,DF",Strasbourg,20.0,2003.0,18.4,23,16,7,14,2,13,21,61.9,8,19,7,12,19,42,29,2,Matches,2023-2024,Ligue-1
Kamory Doumbia,ml MLI,MF,Brest,20.0,2003.0,9.8,28,18,8,10,10,10,29,34.5,19,14,0,14,9,37,6,0,Matches,2023-2024,Ligue-1
Jean-Kevin Duverne,ht HAI,DF,Nantes,26.0,1997.0,15.0,37,19,16,17,4,18,44,40.9,26,17,5,12,18,55,34,0,Matches,2023-2024,Ligue-1
Aron Dønnum,no NOR,"FW,MF",Toulouse,25.0,1998.0,17.7,16,10,3,8,5,7,22,31.8,15,13,0,13,8,24,16,1,Matches,2023-2024,Ligue-1
Simon Ebonog,cm CMR,MF,Le Havre,18.0,2004.0,0.2,1,1,0,1,0,1,1,100.0,0,1,1,0,0,1,1,0,Matches,2023-2024,Ligue-1
Hugo Ekitike,fr FRA,FW,Paris S-G,21.0,2002.0,0.1,0,0,0,0,0,0,0,,0,0,0,0,0,0,0,0,Matches,2023-2024,Ligue-1
Simon Elisor,fr FRA,FW,Metz,24.0,1999.0,8.5,9,2,3,2,4,2,6,33.3,4,6,1,5,0,9,9,0,Matches,2023-2024,Ligue-1
Breel Embolo,ch SUI,FW,Monaco,26.0,1997.0,2.0,3,3,0,2,1,1,4,25.0,3,1,0,1,1,4,2,0,Matches,2023-2024,Ligue-1
Emanuel Emegha,nl NED,FW,Strasbourg,20.0,2003.0,23.1,8,5,2,4,2,4,9,44.4,5,13,3,10,2,10,25,0,Matches,2023-2024,Ligue-1
Maxime Estève,fr FRA,DF,Montpellier,21.0,2002.0,11.1,16,12,11,5,0,10,15,66.7,5,13,9,4,18,34,50,0,Matches,2023-2024,Ligue-1
Oscar Estupiñan,co COL,FW,Metz,26.0,1996.0,2.9,5,4,0,3,2,1,2,50.0,1,2,0,2,0,5,0,0,Matches,2023-2024,Ligue-1
Romain Faivre,fr FRA,"MF,FW",Lorient,25.0,1998.0,16.1,13,6,5,4,4,6,15,40.0,9,6,1,5,7,20,3,1,Matches,2023-2024,Ligue-1
Ilhan Fakili,fr FRA,"MF,FW",Clermont Foot,17.0,2006.0,1.0,0,0,0,0,0,0,1,0.0,1,1,0,1,1,1,0,0,Matches,2023-2024,Ligue-1
Khalil Fayad,fr FRA,"FW,MF",Montpellier,19.0,2004.0,11.4,28,15,17,7,4,9,22,40.9,13,15,3,12,14,42,6,0,Matches,2023-2024,Ligue-1
Ichem Ferrah,fr FRA,FW,Lille,17.0,2005.0,0.0,0,0,0,0,0,0,0,,0,0,0,0,0,0,0,0,Matches,2023-2024,Ligue-1
Jordan Ferri,fr FRA,MF,Montpellier,31.0,1992.0,22.6,36,22,16,17,3,20,67,29.9,47,19,1,18,13,49,23,0,Matches,2023-2024,Ligue-1
Malick Fofana,be BEL,FW,Lyon,18.0,2005.0,6.2,5,4,3,1,1,4,9,44.4,5,3,0,3,5,10,9,0,Matches,2023-2024,Ligue-1
Youssouf Fofana,fr FRA,MF,Monaco,24.0,1999.0,30.0,61,39,19,36,6,30,66,45.5,36,35,7,28,37,98,31,1,Matches,2023-2024,Ligue-1
Thomas Foket,be BEL,DF,Reims,28.0,1994.0,20.4,32,17,21,8,3,20,45,44.4,25,34,12,22,25,57,36,0,Matches,2023-2024,Ligue-1
Tiago Fonseca Morais,pt POR,FW,Lille,19.0,2003.0,0.5,1,1,0,1,0,0,0,,0,0,0,0,1,2,0,0,Matches,2023-2024,Ligue-1
Przemysław Frankowski,pl POL,DF,Lens,28.0,1995.0,24.4,60,39,25,26,9,31,74,41.9,43,30,7,23,25,85,36,0,Matches,2023-2024,Ligue-1
Angelo Fulgini,fr FRA,MF,Lens,26.0,1996.0,15.3,23,14,6,13,4,11,19,57.9,8,22,1,21,8,31,11,0,Matches,2023-2024,Ligue-1
Kévin Gameiro,fr FRA,"FW,MF",Strasbourg,36.0,1987.0,15.0,10,10,5,3,2,2,17,11.8,15,9,0,9,3,13,7,0,Matches,2023-2024,Ligue-1
Ignatius Ganago,cm CMR,"FW,MF",Nantes,24.0,1999.0,2.0,0,0,0,0,0,0,1,0.0,1,1,0,1,1,1,1,0,Matches,2023-2024,Ligue-1
Ulisses Garcia,ch SUI,DF,Marseille,27.0,1996.0,10.1,21,16,6,13,2,13,20,65.0,7,8,3,5,7,28,13,2,Matches,2023-2024,Ligue-1
Johan Gastien,fr FRA,MF,Clermont Foot,35.0,1988.0,25.1,43,22,18,21,4,23,81,28.4,58,31,9,22,36,79,24,4,Matches,2023-2024,Ligue-1
Yann Gboho,fr FRA,"MF,FW",Toulouse,22.0,2001.0,13.3,14,4,6,6,2,8,23,34.8,15,21,1,20,4,18,2,0,Matches,2023-2024,Ligue-1
Gelabert,es ESP,"MF,FW",Toulouse,22.0,2000.0,8.4,14,8,5,6,3,7,20,35.0,13,8,2,6,5,19,8,0,Matches,2023-2024,Ligue-1
Denis Genreau,au AUS,"MF,FW",Toulouse,24.0,1999.0,5.2,12,9,6,6,0,8,15,53.3,7,8,1,7,6,18,8,0,Matches,2023-2024,Ligue-1
Samuel Gigot,fr FRA,DF,Marseille,29.0,1993.0,19.2,33,22,16,13,4,13,19,68.4,6,28,18,10,25,58,93,1,Matches,2023-2024,Ligue-1
Aleksandr Golovin,ru RUS,"MF,FW",Monaco,27.0,1996.0,23.9,42,30,14,22,6,15,42,35.7,27,37,3,34,21,63,14,0,Matches,2023-2024,Ligue-1
Angel Gomes,eng ENG,MF,Lille,22.0,2000.0,28.6,26,13,4,15,7,14,32,43.8,18,23,6,17,18,44,28,1,Matches,2023-2024,Ligue-1
Maxime Gonalons,fr FRA,MF,Clermont Foot,34.0,1989.0,14.4,47,33,14,27,6,25,57,43.9,32,18,3,15,20,67,11,0,Matches,2023-2024,Ligue-1
Mathieu Gorgelin,fr FRA,GK,Le Havre,32.0,1990.0,1.0,0,0,0,0,0,0,0,,0,0,0,0,0,0,0,0,Matches,2023-2024,Ligue-1
Amine Gouiri,dz ALG,"FW,MF",Rennes,23.0,2000.0,23.0,20,10,4,11,5,8,19,42.1,11,18,1,17,14,34,12,0,Matches,2023-2024,Ligue-1
Jonathan Gradit,fr FRA,DF,Lens,30.0,1992.0,23.5,32,20,15,14,3,19,35,54.3,16,30,17,13,37,69,61,0,Matches,2023-2024,Ligue-1
Samuel Grandsir,fr FRA,"MF,FW",Le Havre,26.0,1996.0,6.7,16,12,5,9,2,8,18,44.4,10,4,0,4,3,19,3,1,Matches,2023-2024,Ligue-1
Adrian Grbić,at AUT,FW,Lorient,26.0,1996.0,0.3,0,0,0,0,0,0,0,,0,0,0,0,0,0,0,0,Matches,2023-2024,Ligue-1
Gabriel Gudmundsson,se SWE,"DF,FW",Lille,24.0,1999.0,14.1,22,16,7,13,2,12,20,60.0,8,14,3,11,15,37,25,0,Matches,2023-2024,Ligue-1
Axel Gueguin,fr FRA,"DF,FW",Montpellier,18.0,2005.0,1.5,9,5,6,2,1,2,6,33.3,4,2,0,2,2,11,6,0,Matches,2023-2024,Ligue-1
Mattéo Guendouzi,fr FRA,MF,Marseille,24.0,1999.0,0.2,0,0,0,0,0,0,0,,0,1,1,0,0,0,0,0,Matches,2023-2024,Ligue-1
Evann Guessand,ci CIV,FW,Nice,22.0,2001.0,17.3,16,7,2,7,7,6,7,85.7,1,12,1,11,12,28,7,0,Matches,2023-2024,Ligue-1
Pape Gueye,sn SEN,"MF,DF",Marseille,24.0,1999.0,8.5,33,21,11,19,3,13,19,68.4,6,17,3,14,13,46,12,0,Matches,2023-2024,Ligue-1
Morgan Guilavogui,gn GUI,"FW,MF",Lens,25.0,1998.0,6.3,21,10,4,12,5,5,11,45.5,6,11,2,9,4,25,7,0,Matches,2023-2024,Ligue-1
Frederic Guilbert,fr FRA,"DF,MF",Strasbourg,28.0,1994.0,27.7,87,50,49,30,8,47,72,65.3,25,39,10,29,71,158,99,1,Matches,2023-2024,Ligue-1
Jaouen Hadjam,dz ALG,DF,Nantes,20.0,2003.0,1.2,6,4,5,1,0,1,2,50.0,1,0,0,0,3,9,2,0,Matches,2023-2024,Ligue-1
Massadio Haïdara,ml MLI,DF,Lens,30.0,1992.0,8.2,9,8,5,3,1,4,6,66.7,2,7,2,5,11,20,32,3,Matches,2023-2024,Ligue-1
Oualid El Hajjam,ma MAR,"DF,MF",Le Havre,32.0,1991.0,4.4,8,7,5,2,1,2,9,22.2,7,5,1,4,6,14,10,0,Matches,2023-2024,Ligue-1
Achraf Hakimi,ma MAR,DF,Paris S-G,24.0,1998.0,21.5,29,19,14,9,6,17,34,50.0,17,28,4,24,12,41,28,2,Matches,2023-2024,Ligue-1
Amine Harit,ma MAR,"MF,FW",Marseille,26.0,1997.0,20.2,28,16,8,17,3,13,37,35.1,24,31,4,27,12,40,4,0,Matches,2023-2024,Ligue-1
Silvan Hefti,ch SUI,"DF,FW",Montpellier,25.0,1997.0,7.9,21,15,10,7,4,15,29,51.7,14,7,2,5,8,29,11,0,Matches,2023-2024,Ligue-1
Henrique,br BRA,DF,Lyon,29.0,1994.0,6.7,10,6,6,4,0,6,11,54.5,5,8,2,6,10,20,3,0,Matches,2023-2024,Ligue-1
Luis Henrique,br BRA,"FW,DF",Marseille,21.0,2001.0,8.7,8,7,4,1,3,4,7,57.1,3,9,0,9,8,16,3,0,Matches,2023-2024,Ligue-1
Christophe Hérelle,mq MTQ,DF,Metz,30.0,1992.0,18.0,32,15,24,7,1,13,23,56.5,10,16,9,7,18,50,68,2,Matches,2023-2024,Ligue-1
Lucas Hernández,fr FRA,DF,Paris S-G,27.0,1996.0,21.2,52,36,28,15,9,29,50,58.0,21,21,5,16,27,79,38,0,Matches,2023-2024,Ligue-1
Andrej Ilic,rs SRB,FW,Lille,23.0,2000.0,0.1,0,0,0,0,0,0,0,,0,0,0,0,0,0,0,0,Matches,2023-2024,Ligue-1
Bonke Innocent,ng NGA,MF,Lorient,27.0,1996.0,2.3,6,4,2,2,2,2,9,22.2,7,2,1,1,4,10,2,0,Matches,2023-2024,Ligue-1
Ismaily,br BRA,DF,Lille,33.0,1990.0,27.4,72,47,34,25,13,31,60,51.7,29,33,6,27,32,104,77,0,Matches,2023-2024,Ligue-1
Yanis Issoufou,fr FRA,MF,Montpellier,16.0,2006.0,0.1,0,0,0,0,0,0,0,,0,0,0,0,0,0,0,0,Matches,2023-2024,Ligue-1
Junya Ito,jp JPN,"FW,MF",Reims,30.0,1993.0,30.2,33,15,11,14,8,10,36,27.8,26,23,1,22,14,47,7,0,Matches,2023-2024,Ligue-1
Jérémy Jacquet,fr FRA,MF,Rennes,18.0,2005.0,0.1,1,1,1,0,0,0,1,0.0,1,0,0,0,1,2,0,0,Matches,2023-2024,Ligue-1
Jérémy Jacquet,fr FRA,DF,Clermont Foot,18.0,2005.0,2.8,4,3,4,0,0,3,3,100.0,0,7,3,4,6,10,10,0,Matches,2023-2024,Ligue-1
Ismail Jakobs,sn SEN,DF,Monaco,23.0,1999.0,16.3,57,41,27,21,9,29,47,61.7,18,19,2,17,11,68,40,0,Matches,2023-2024,Ligue-1
Ablie Jallow,gm GAM,"MF,FW",Metz,24.0,1998.0,10.2,8,5,2,3,3,3,5,60.0,2,4,0,4,8,16,3,0,Matches,2023-2024,Ligue-1
Danley Jean-Jacques,ht HAI,MF,Metz,23.0,2000.0,29.8,54,28,24,21,9,19,56,33.9,37,48,7,41,44,98,44,0,Matches,2023-2024,Ligue-1
Jeffinho,br BRA,"FW,MF",Lyon,23.0,1999.0,3.4,11,4,3,5,3,4,11,36.4,7,1,0,1,0,11,0,0,Matches,2023-2024,Ligue-1
Antoine Joujou,fr FRA,"FW,MF",Le Havre,20.0,2003.0,8.7,20,12,7,7,6,11,21,52.4,10,11,2,9,7,27,5,0,Matches,2023-2024,Ligue-1
Christopher Jullien,fr FRA,DF,Montpellier,30.0,1993.0,13.7,16,12,11,5,0,6,17,35.3,11,25,20,5,12,28,106,2,Matches,2023-2024,Ligue-1
Eli Junior Kroupi,fr FRA,"FW,MF",Lorient,17.0,2006.0,12.0,7,4,2,2,3,1,9,11.1,8,6,0,6,10,17,5,0,Matches,2023-2024,Ligue-1
Abdoul Kader Bamba,fr FRA,"FW,MF",Nantes,29.0,1994.0,6.8,10,7,2,5,3,5,15,33.3,10,4,0,4,4,14,4,1,Matches,2023-2024,Ligue-1
Yaya Kader Fofana,ml MLI,"MF,DF",Reims,19.0,2004.0,0.4,3,3,1,1,1,0,1,0.0,1,0,0,0,1,4,0,0,Matches,2023-2024,Ligue-1
Tino Kadewere,zw ZIM,"FW,MF",Lyon,27.0,1996.0,3.3,1,1,0,1,0,1,5,20.0,4,3,1,2,5,6,7,0,Matches,2023-2024,Ligue-1
Tino Kadewere,zw ZIM,"FW,MF",Nantes,27.0,1996.0,8.7,9,4,3,3,3,6,11,54.5,5,10,1,9,10,19,8,0,Matches,2023-2024,Ligue-1
Arnaud Kalimuendo,fr FRA,FW,Rennes,21.0,2002.0,23.8,5,4,2,2,1,2,5,40.0,3,13,2,11,4,9,4,0,Matches,2023-2024,Ligue-1
Gedeon Kalulu,cd COD,DF,Lorient,25.0,1997.0,10.8,23,17,13,8,2,12,22,54.5,10,18,2,16,5,28,30,0,Matches,2023-2024,Ligue-1
Waren Kamanzi,no NOR,"DF,FW",Toulouse,22.0,2000.0,13.2,36,24,16,16,4,13,23,56.5,10,11,3,8,9,45,35,0,Matches,2023-2024,Ligue-1
Lee Kang-in,kr KOR,"FW,MF",Paris S-G,22.0,2001.0,16.3,26,13,7,9,10,15,36,41.7,21,7,0,7,6,32,3,0,Matches,2023-2024,Ligue-1
Yann Karamoh,fr FRA,"FW,MF",Montpellier,25.0,1998.0,3.2,1,0,0,0,1,1,2,50.0,1,3,0,3,0,1,0,0,Matches,2023-2024,Ligue-1
Ayman Kari,fr FRA,MF,Lorient,18.0,2004.0,9.9,18,14,9,9,0,12,19,63.2,7,19,2,17,6,24,9,1,Matches,2023-2024,Ligue-1
Panos Katseris,gr GRE,DF,Lorient,22.0,2001.0,11.6,26,20,16,8,2,16,25,64.0,9,20,4,16,8,34,18,0,Matches,2023-2024,Ligue-1
Kévin Keben Biakolo,cm CMR,DF,Toulouse,19.0,2004.0,5.8,4,2,4,0,0,3,6,50.0,3,7,0,7,8,12,17,0,Matches,2023-2024,Ligue-1
Yassine Kechta,ma MAR,MF,Le Havre,21.0,2002.0,20.5,46,24,24,19,3,31,73,42.5,42,20,3,17,23,69,16,1,Matches,2023-2024,Ligue-1
Thilo Kehrer,de GER,DF,Monaco,26.0,1996.0,14.7,32,22,22,7,3,22,39,56.4,17,18,6,12,30,62,55,0,Matches,2023-2024,Ligue-1
Habib Keita,ml MLI,MF,Clermont Foot,21.0,2002.0,14.2,34,19,14,15,5,17,28,60.7,11,27,10,17,29,63,30,0,Matches,2023-2024,Ligue-1
Reda Khadra,de GER,"FW,MF",Reims,22.0,2001.0,15.2,16,10,5,4,7,8,20,40.0,12,8,2,6,3,19,13,0,Matches,2023-2024,Ligue-1
Wahbi Khazri,tn TUN,FW,Montpellier,32.0,1991.0,12.6,24,17,8,12,4,14,35,40.0,21,10,0,10,3,27,7,0,Matches,2023-2024,Ligue-1
Abdukodir Khusanov,uz UZB,DF,Lens,19.0,2004.0,9.0,21,12,13,8,0,9,17,52.9,8,13,8,5,13,34,32,2,Matches,2023-2024,Ligue-1
Philipp Köhn,ch SUI,GK,Monaco,25.0,1998.0,22.0,1,1,1,0,0,1,1,100.0,0,0,0,0,1,2,5,3,Matches,2023-2024,Ligue-1
Randal Kolo Muani,fr FRA,"FW,MF",Paris S-G,24.0,1998.0,14.1,10,8,5,3,2,5,13,38.5,8,5,0,5,4,14,10,0,Matches,2023-2024,Ligue-1
Cheick Konaté,ml MLI,DF,Clermont Foot,19.0,2004.0,11.9,26,15,17,9,0,20,36,55.6,16,16,2,14,13,39,21,0,Matches,2023-2024,Ligue-1
Geoffrey Kondogbia,cf CTA,MF,Marseille,30.0,1993.0,16.3,48,31,18,25,5,13,32,40.6,19,21,4,17,30,78,25,0,Matches,2023-2024,Ligue-1
Abdoul Koné,fr FRA,DF,Reims,18.0,2005.0,2.1,7,7,5,2,0,4,11,36.4,7,2,0,2,2,9,9,0,Matches,2023-2024,Ligue-1
Amadou Koné,ml MLI,MF,Reims,18.0,2005.0,5.3,13,8,11,2,0,6,10,60.0,4,8,3,5,10,23,10,0,Matches,2023-2024,Ligue-1
Ibrahima Koné,ml MLI,FW,Lorient,24.0,1999.0,0.4,0,0,0,0,0,0,1,0.0,1,0,0,0,0,0,0,0,Matches,2023-2024,Ligue-1
N'Guessan Kouadio,ci CIV,"MF,FW",Metz,20.0,2003.0,1.2,3,1,0,3,0,0,3,0.0,3,3,0,3,1,4,0,0,Matches,2023-2024,Ligue-1
Koffi Kouao,ci CIV,DF,Metz,25.0,1998.0,9.6,20,13,12,7,1,11,17,64.7,6,9,6,3,13,33,38,1,Matches,2023-2024,Ligue-1
Therence Koudou,fr FRA,DF,Reims,18.0,2004.0,3.5,2,2,1,1,0,0,2,0.0,2,4,3,1,4,6,9,0,Matches,2023-2024,Ligue-1
Boubakar Kouyaté,ml MLI,DF,Montpellier,26.0,1997.0,21.4,49,30,39,8,2,28,51,54.9,23,31,20,11,29,78,123,1,Matches,2023-2024,Ligue-1
Sael Kumbedi,fr FRA,DF,Lyon,18.0,2005.0,10.3,30,20,14,12,4,9,22,40.9,13,12,3,9,14,44,18,2,Matches,2023-2024,Ligue-1
Layvin Kurzawa,fr FRA,DF,Paris S-G,30.0,1992.0,0.1,0,0,0,0,0,0,0,,0,0,0,0,0,0,0,0,Matches,2023-2024,Ligue-1
Daler Kuzyaev,ru RUS,MF,Le Havre,30.0,1993.0,23.2,34,19,11,13,10,15,43,34.9,28,18,5,13,22,56,18,1,Matches,2023-2024,Ligue-1
Grejohn Kyei,fr FRA,FW,Clermont Foot,27.0,1995.0,11.4,6,4,2,2,2,2,3,66.7,1,5,1,4,1,7,10,0,Matches,2023-2024,Ligue-1
Gaëtan Laborde,fr FRA,"FW,MF",Nice,29.0,1994.0,21.2,18,12,8,4,6,11,30,36.7,19,20,2,18,6,24,8,1,Matches,2023-2024,Ligue-1
Alexandre Lacazette,fr FRA,FW,Lyon,32.0,1991.0,25.5,19,12,8,9,2,5,17,29.4,12,22,3,19,8,27,9,0,Matches,2023-2024,Ligue-1
Alban Lafont,fr FRA,GK,Nantes,24.0,1999.0,27.7,0,0,0,0,0,0,2,0.0,2,0,0,0,0,0,14,0,Matches,2023-2024,Ligue-1
Kenny Lala,mg MAD,DF,Brest,31.0,1991.0,33.0,78,51,39,28,11,30,56,53.6,26,27,6,21,28,106,75,1,Matches,2023-2024,Ligue-1
Mathis Lambourde,fr FRA,FW,Rennes,17.0,2006.0,0.1,0,0,0,0,0,0,1,0.0,1,1,0,1,0,0,1,0,Matches,2023-2024,Ligue-1
Mohamed Lamine Bayo,gn GUI,FW,Le Havre,25.0,1998.0,15.4,13,5,2,5,6,2,10,20.0,8,8,1,7,2,15,11,0,Matches,2023-2024,Ligue-1
Didier Lamkel Zé,cm CMR,"FW,MF",Metz,26.0,1996.0,6.1,7,2,2,4,1,2,5,40.0,3,4,0,4,0,7,11,0,Matches,2023-2024,Ligue-1
Julien Laporte,fr FRA,DF,Lorient,29.0,1993.0,20.2,23,14,15,7,1,16,36,44.4,20,36,26,10,11,34,116,1,Matches,2023-2024,Ligue-1
Théo Le Bris,fr FRA,"DF,MF",Lorient,20.0,2002.0,16.8,35,22,25,7,3,19,40,47.5,21,24,3,21,12,47,42,0,Matches,2023-2024,Ligue-1
Julien Le Cardinal,fr FRA,DF,Brest,25.0,1997.0,5.3,19,11,11,7,1,8,12,66.7,4,6,3,3,13,32,26,0,Matches,2023-2024,Ligue-1
Julien Le Cardinal,fr FRA,DF,Lens,25.0,1997.0,0.6,6,2,4,2,0,4,9,44.4,5,2,1,1,0,6,0,0,Matches,2023-2024,Ligue-1
Jérémy Le Douaron,fr FRA,FW,Brest,25.0,1998.0,18.0,21,10,7,9,5,11,26,42.3,15,14,1,13,2,23,10,0,Matches,2023-2024,Ligue-1
Enzo Le Fée,fr FRA,MF,Rennes,23.0,2000.0,17.0,50,35,23,17,10,23,47,48.9,24,17,3,14,19,69,20,0,Matches,2023-2024,Ligue-1
Vincent Le Goff,fr FRA,"DF,MF",Lorient,33.0,1989.0,6.0,5,0,4,0,1,4,8,50.0,4,11,3,8,3,8,10,0,Matches,2023-2024,Ligue-1
Adrien Lebeau,fr FRA,"MF,FW",Brest,24.0,1999.0,0.6,0,0,0,0,0,0,3,0.0,3,2,1,1,0,0,1,0,Matches,2023-2024,Ligue-1
Jean-Louis Leca,fr FRA,GK,Lens,37.0,1985.0,1.0,0,0,0,0,0,0,0,,0,0,0,0,0,0,1,0,Matches,2023-2024,Ligue-1
Benjamin Lecomte,fr FRA,GK,Montpellier,32.0,1991.0,30.0,0,0,0,0,0,0,1,0.0,1,0,0,0,0,0,16,1,Matches,2023-2024,Ligue-1
Pierre Lees-Melou,fr FRA,MF,Brest,30.0,1993.0,28.0,96,67,51,41,4,49,129,38.0,80,61,11,50,43,139,64,3,Matches,2023-2024,Ligue-1
Johann Lepenant,fr FRA,MF,Lyon,20.0,2002.0,2.8,4,3,2,2,0,1,8,12.5,7,5,0,5,4,8,0,0,Matches,2023-2024,Ligue-1
Léo Leroy,fr FRA,MF,Montpellier,23.0,2000.0,5.5,19,10,8,8,3,6,21,28.6,15,12,3,9,7,26,8,0,Matches,2023-2024,Ligue-1
Gautier Lloris,fr FRA,DF,Le Havre,28.0,1995.0,30.9,50,28,40,9,1,28,42,66.7,14,50,30,20,32,82,142,1,Matches,2023-2024,Ligue-1
Abou Lô,sn SEN,"MF,DF",Metz,23.0,2000.0,2.2,3,1,2,1,0,1,4,25.0,3,5,2,3,4,7,8,0,Matches,2023-2024,Ligue-1
Bradley Locko,fr FRA,DF,Brest,21.0,2002.0,32.9,97,55,57,34,6,47,80,58.8,33,28,1,27,40,137,69,0,Matches,2023-2024,Ligue-1
Renan Lodi,br BRA,DF,Marseille,25.0,1998.0,13.7,24,16,8,13,3,13,21,61.9,8,7,2,5,16,40,35,0,Matches,2023-2024,Ligue-1
Elysée Logbo,fr FRA,FW,Le Havre,19.0,2004.0,2.8,0,0,0,0,0,0,3,0.0,3,7,3,4,0,0,2,0,Matches,2023-2024,Ligue-1
Anthony Lopes,pt POR,GK,Lyon,32.0,1990.0,31.0,0,0,0,0,0,0,0,,0,0,0,0,0,0,16,0,Matches,2023-2024,Ligue-1
Pau López,es ESP,GK,Marseille,28.0,1994.0,32.7,0,0,0,0,0,0,2,0.0,2,0,0,0,0,0,10,1,Matches,2023-2024,Ligue-1
Jordan Lotomba,ch SUI,DF,Nice,24.0,1998.0,20.0,36,28,18,9,9,25,35,71.4,10,30,9,21,16,52,26,1,Matches,2023-2024,Ligue-1
Tom Louchet,fr FRA,"MF,DF",Nice,20.0,2003.0,4.5,14,5,6,6,2,7,11,63.6,4,7,3,4,3,17,9,0,Matches,2023-2024,Ligue-1
Imran Louza,ma MAR,MF,Lorient,24.0,1999.0,9.6,13,7,2,8,3,2,8,25.0,6,8,1,7,9,22,4,0,Matches,2023-2024,Ligue-1
Dejan Lovren,hr CRO,DF,Lyon,34.0,1989.0,8.0,9,7,6,3,0,3,7,42.9,4,6,5,1,12,21,37,0,Matches,2023-2024,Ligue-1
Joshua M'Bahia,ci CIV,MF,Clermont Foot,18.0,2005.0,0.2,0,0,0,0,0,0,0,,0,0,0,0,0,0,0,0,Matches,2023-2024,Ligue-1
Othmane Maamma,ma MAR,FW,Montpellier,17.0,2005.0,1.0,3,3,2,0,1,1,1,100.0,0,3,0,3,0,3,0,0,Matches,2023-2024,Ligue-1
Deiver Machado,co COL,DF,Lens,29.0,1993.0,12.5,24,18,10,10,4,15,20,75.0,5,13,2,11,7,31,8,0,Matches,2023-2024,Ligue-1
Soungoutou Magassa,fr FRA,"DF,MF",Monaco,19.0,2003.0,15.0,56,26,22,32,2,26,48,54.2,22,21,4,17,21,77,36,2,Matches,2023-2024,Ligue-1
Hugo Magnetti,fr FRA,MF,Brest,25.0,1998.0,26.0,49,27,18,26,5,24,58,41.4,34,19,1,18,18,67,18,0,Matches,2023-2024,Ligue-1
Yohann Magnin,fr FRA,MF,Clermont Foot,26.0,1997.0,18.7,49,31,12,32,5,22,47,46.8,25,38,13,25,19,68,26,1,Matches,2023-2024,Ligue-1
Frank Magri,cm CMR,"FW,MF",Toulouse,23.0,1999.0,16.0,22,14,5,12,5,15,21,71.4,6,16,4,12,4,26,17,0,Matches,2023-2024,Ligue-1
Adel Mahamoud,km COM,FW,Nantes,20.0,2003.0,0.1,0,0,0,0,0,0,1,0.0,1,0,0,0,0,0,0,0,Matches,2023-2024,Ligue-1
Habib Maïga,ci CIV,"MF,FW",Metz,27.0,1996.0,1.6,2,2,1,0,1,1,3,33.3,2,2,0,2,4,6,2,0,Matches,2023-2024,Ligue-1
Ainsley Maitland-Niles,eng ENG,"DF,MF",Lyon,25.0,1997.0,15.9,34,18,12,14,8,19,37,51.4,18,16,6,10,17,51,29,1,Matches,2023-2024,Ligue-1
Radosław Majecki,pl POL,GK,Monaco,23.0,1999.0,12.0,0,0,0,0,0,0,0,,0,1,0,1,0,0,5,1,Matches,2023-2024,Ligue-1
Lovro Majer,hr CRO,MF,Rennes,25.0,1998.0,0.2,0,0,0,0,0,0,0,,0,0,0,0,0,0,1,0,Matches,2023-2024,Ligue-1
Jean-Victor Makengo,fr FRA,"MF,FW",Lorient,25.0,1998.0,5.3,5,4,3,2,0,2,6,33.3,4,12,1,11,8,13,5,0,Matches,2023-2024,Ligue-1
Aaron Malouda,fr FRA,FW,Lille,17.0,2005.0,0.0,0,0,0,0,0,0,0,,0,0,0,0,0,0,0,0,Matches,2023-2024,Ligue-1
Hianga Mananga Mbock,fr FRA,"MF,FW",Brest,23.0,1999.0,0.1,1,0,0,0,1,1,2,50.0,1,0,0,0,1,2,0,0,Matches,2023-2024,Ligue-1
Steve Mandanda,fr FRA,GK,Rennes,38.0,1985.0,34.0,2,0,2,0,0,2,4,50.0,2,0,0,0,0,2,6,1,Matches,2023-2024,Ligue-1
Orel Mangala,be BEL,MF,Lyon,25.0,1998.0,4.4,5,3,0,2,3,1,3,33.3,2,3,2,1,5,10,6,0,Matches,2023-2024,Ligue-1
Vito Mannone,it ITA,GK,Lille,35.0,1988.0,1.0,0,0,0,0,0,0,0,,0,0,0,0,0,0,0,0,Matches,2023-2024,Ligue-1
Faitout Maouassa,fr FRA,"MF,DF",Lens,25.0,1998.0,0.8,1,1,1,0,0,1,1,100.0,0,1,0,1,0,1,3,0,Matches,2023-2024,Ligue-1
Guillermo Maripán,cl CHI,DF,Monaco,29.0,1994.0,19.6,22,8,15,6,1,10,27,37.0,17,26,13,13,30,52,106,4,Matches,2023-2024,Ligue-1
Marquinhos,br BRA,"FW,MF",Nantes,20.0,2003.0,1.7,3,2,2,0,1,1,4,25.0,3,7,2,5,6,9,1,0,Matches,2023-2024,Ligue-1
Marquinhos,br BRA,DF,Paris S-G,29.0,1994.0,17.1,19,11,10,7,2,11,17,64.7,6,29,19,10,17,36,58,1,Matches,2023-2024,Ligue-1
Jonas Martin,fr FRA,MF,Brest,33.0,1990.0,13.4,43,27,17,24,2,21,36,58.3,15,16,2,14,9,52,28,2,Matches,2023-2024,Ligue-1
Clinton Mata,ao ANG,DF,Lyon,30.0,1992.0,24.7,43,24,29,8,6,23,40,57.5,17,35,16,19,40,83,61,0,Matches,2023-2024,Ligue-1
Eliot Matazo,be BEL,MF,Monaco,21.0,2002.0,1.1,3,1,0,3,0,2,4,50.0,2,1,1,0,3,6,0,0,Matches,2023-2024,Ligue-1
Nemanja Matić,rs SRB,MF,Rennes,34.0,1988.0,11.4,19,10,7,9,3,9,12,75.0,3,15,7,8,27,46,19,0,Matches,2023-2024,Ligue-1
Nemanja Matić,rs SRB,MF,Lyon,34.0,1988.0,13.9,17,11,8,7,2,9,19,47.4,10,17,6,11,16,33,17,1,Matches,2023-2024,Ligue-1
Chrislain Matsima,fr FRA,DF,Clermont Foot,21.0,2002.0,13.1,18,11,11,7,0,10,18,55.6,8,14,10,4,13,31,74,1,Matches,2023-2024,Ligue-1
Chrislain Matsima,fr FRA,DF,Monaco,21.0,2002.0,3.3,9,7,5,3,1,2,7,28.6,5,4,1,3,4,13,4,0,Matches,2023-2024,Ligue-1
Azor Matusiwa,nl NED,MF,Reims,25.0,1998.0,15.4,39,27,17,19,3,22,32,68.8,10,21,3,18,33,72,32,1,Matches,2023-2024,Ligue-1
Azor Matusiwa,nl NED,MF,Rennes,25.0,1998.0,8.8,7,3,3,4,0,4,7,57.1,3,9,2,7,11,18,17,0,Matches,2023-2024,Ligue-1
Aïman Maurer,ma MAR,"MF,FW",Clermont Foot,18.0,2004.0,0.6,1,1,1,0,0,1,3,33.3,2,0,0,0,0,1,0,0,Matches,2023-2024,Ligue-1
Christian Mawissa,fr FRA,DF,Toulouse,18.0,2005.0,12.4,22,15,14,4,4,9,23,39.1,14,22,11,11,22,44,41,1,Matches,2023-2024,Ligue-1
Noam Mayoka-Tika,be BEL,MF,Marseille,19.0,2003.0,0.0,0,0,0,0,0,0,0,,0,0,0,0,0,0,0,0,Matches,2023-2024,Ligue-1
Senny Mayulu,fr FRA,"FW,MF",Paris S-G,17.0,2006.0,3.6,13,8,6,6,1,6,7,85.7,1,1,0,1,3,16,0,0,Matches,2023-2024,Ligue-1
Youssef Maziz,fr FRA,"FW,MF",Metz,25.0,1998.0,1.4,0,0,0,0,0,0,2,0.0,2,1,0,1,1,1,2,0,Matches,2023-2024,Ligue-1
Ethan Mbappé,fr FRA,"MF,DF",Paris S-G,16.0,2006.0,0.5,0,0,0,0,0,0,2,0.0,2,1,0,1,0,0,0,0,Matches,2023-2024,Ligue-1
Kylian Mbappé,fr FRA,FW,Paris S-G,24.0,1998.0,24.0,4,1,1,1,2,4,9,44.4,5,4,0,4,2,6,2,0,Matches,2023-2024,Ligue-1
Malick Mbaye,sn SEN,"MF,FW",Metz,19.0,2004.0,1.7,5,1,0,1,4,1,2,50.0,1,1,0,1,1,6,2,0,Matches,2023-2024,Ligue-1
Chancel Mbemba,cd COD,DF,Marseille,28.0,1994.0,24.5,33,21,25,7,1,17,30,56.7,13,21,13,8,13,46,95,1,Matches,2023-2024,Ligue-1
Nolan Mbemba,cg CGO,MF,Le Havre,28.0,1995.0,0.2,2,1,0,1,1,1,2,50.0,1,0,0,0,0,2,0,0,Matches,2023-2024,Ligue-1
Christ Mbondi,fr FRA,FW,Reims,18.0,2004.0,0.0,1,1,1,0,0,1,1,100.0,0,0,0,0,0,1,0,0,Matches,2023-2024,Ligue-1
Facundo Medina,ar ARG,DF,Lens,24.0,1999.0,30.2,64,38,25,31,8,44,69,63.8,25,38,13,25,24,88,59,2,Matches,2023-2024,Ligue-1
Bamo Meïté,ci CIV,DF,Marseille,21.0,2001.0,7.1,16,10,13,3,0,8,12,66.7,4,11,5,6,11,27,35,0,Matches,2023-2024,Ligue-1
Bamo Meïté,ci CIV,DF,Lorient,21.0,2001.0,1.6,2,1,2,0,0,0,1,0.0,1,3,2,1,3,5,9,0,Matches,2023-2024,Ligue-1
Birger Meling,no NOR,DF,Rennes,28.0,1994.0,0.2,1,1,1,0,0,1,1,100.0,0,1,0,1,0,1,0,0,Matches,2023-2024,Ligue-1
Nuno Mendes,pt POR,DF,Paris S-G,21.0,2002.0,3.0,5,5,4,1,0,4,7,57.1,3,4,0,4,4,9,2,0,Matches,2023-2024,Ligue-1
Antoine Mendy,sn SEN,DF,Nice,19.0,2004.0,4.6,7,5,4,3,0,3,7,42.9,4,4,1,3,8,15,16,0,Matches,2023-2024,Ligue-1
Benjamin Mendy,fr FRA,DF,Lorient,29.0,1994.0,7.9,3,1,2,1,0,1,5,20.0,4,8,2,6,7,10,20,0,Matches,2023-2024,Ligue-1
Formose Mendy,sn SEN,DF,Lorient,22.0,2001.0,14.0,33,19,24,8,1,20,33,60.6,13,23,12,11,20,53,59,1,Matches,2023-2024,Ligue-1
Nampalys Mendy,sn SEN,MF,Lens,31.0,1992.0,11.7,29,18,10,13,6,16,20,80.0,4,11,4,7,14,43,14,1,Matches,2023-2024,Ligue-1
Quentin Merlin,fr FRA,DF,Marseille,21.0,2002.0,7.8,13,12,7,5,1,8,20,40.0,12,4,0,4,6,19,14,0,Matches,2023-2024,Ligue-1
Quentin Merlin,fr FRA,DF,Nantes,21.0,2002.0,14.3,29,20,15,12,2,16,25,64.0,9,22,1,21,18,47,22,0,Matches,2023-2024,Ligue-1
Bastien Meupiyou,fr FRA,DF,Nantes,17.0,2006.0,0.1,0,0,0,0,0,0,0,,0,0,0,0,0,0,1,0,Matches,2023-2024,Ligue-1
Lucas Michal,fr FRA,FW,Monaco,18.0,2005.0,0.1,0,0,0,0,0,0,0,,0,0,0,0,0,0,0,0,Matches,2023-2024,Ligue-1
Georges Mikautadze,ge GEO,FW,Metz,22.0,2000.0,19.4,4,3,1,2,1,0,9,0.0,9,11,0,11,8,12,3,0,Matches,2023-2024,Ligue-1
Takumi Minamino,jp JPN,MF,Monaco,28.0,1995.0,23.5,34,17,10,13,11,16,54,29.6,38,29,1,28,11,45,8,0,Matches,2023-2024,Ligue-1
Lucas Mincarelli,fr FRA,"DF,MF",Montpellier,19.0,2004.0,10.9,29,16,19,6,4,17,34,50.0,17,17,4,13,8,37,27,0,Matches,2023-2024,Ligue-1
Ignacio Miramon,ar ARG,MF,Lille,20.0,2003.0,0.4,1,0,0,1,0,0,1,0.0,1,1,0,1,0,1,0,0,Matches,2023-2024,Ligue-1
Terem Moffi,ng NGA,FW,Nice,24.0,1999.0,21.7,7,4,0,5,2,3,12,25.0,9,14,1,13,3,10,15,0,Matches,2023-2024,Ligue-1
Mostafa Mohamed,eg EGY,FW,Nantes,25.0,1997.0,22.2,21,14,7,11,3,6,28,21.4,22,21,5,16,12,33,29,0,Matches,2023-2024,Ligue-1
Dion Moise Sahi,ci CIV,"MF,FW",Strasbourg,21.0,2001.0,7.0,5,5,1,2,2,0,3,0.0,3,11,1,10,1,6,7,0,Matches,2023-2024,Ligue-1
Florent Mollet,fr FRA,"MF,FW",Nantes,31.0,1991.0,23.1,18,11,8,6,4,10,31,32.3,21,18,5,13,13,31,17,0,Matches,2023-2024,Ligue-1
Enzo Mongo,fr FRA,DF,Nantes,18.0,2005.0,0.1,1,1,1,0,0,1,2,50.0,1,1,1,0,1,2,0,0,Matches,2023-2024,Ligue-1
Diego Moreira,pt POR,"FW,MF",Lyon,18.0,2004.0,3.0,0,0,0,0,0,0,3,0.0,3,3,0,3,2,2,5,0,Matches,2023-2024,Ligue-1
Lebo Mothiba,za RSA,FW,Strasbourg,27.0,1996.0,6.9,5,2,1,4,0,3,4,75.0,1,6,1,5,0,5,11,0,Matches,2023-2024,Ligue-1
Steve Mounié,bj BEN,FW,Brest,28.0,1994.0,19.7,8,7,0,3,5,3,11,27.3,8,13,3,10,2,10,18,0,Matches,2023-2024,Ligue-1
Samuel Moutoussamy,cd COD,MF,Nantes,26.0,1996.0,12.3,38,20,14,17,7,17,37,45.9,20,16,3,13,11,49,13,0,Matches,2023-2024,Ligue-1
Loris Mouyokolo,fr FRA,DF,Lorient,22.0,2001.0,1.0,4,1,4,0,0,1,1,100.0,0,1,0,1,0,4,3,0,Matches,2023-2024,Ligue-1
François Mughe,cm CMR,"MF,DF",Marseille,19.0,2004.0,2.0,0,0,0,0,0,0,3,0.0,3,2,0,2,1,1,1,0,Matches,2023-2024,Ligue-1
Nordi Mukiele,fr FRA,DF,Paris S-G,25.0,1997.0,8.8,12,8,6,5,1,8,15,53.3,7,17,4,13,14,26,28,0,Matches,2023-2024,Ligue-1
Marshall Munetsi,zw ZIM,MF,Reims,27.0,1996.0,24.1,61,39,18,34,9,33,61,54.1,28,21,7,14,14,75,33,0,Matches,2023-2024,Ligue-1
Yvon Mvogo,ch SUI,GK,Lorient,29.0,1994.0,34.0,0,0,0,0,0,0,1,0.0,1,0,0,0,0,0,15,3,Matches,2023-2024,Ligue-1
Joel Mvuka,no NOR,"DF,FW",Lorient,20.0,2002.0,2.2,5,3,3,1,1,3,7,42.9,4,1,0,1,2,7,1,0,Matches,2023-2024,Ligue-1
Junior Mwanga,fr FRA,"MF,FW",Strasbourg,20.0,2003.0,16.1,40,20,23,12,5,12,24,50.0,12,20,5,15,18,58,19,0,Matches,2023-2024,Ligue-1
Kévin N'Doram,fr FRA,MF,Metz,27.0,1996.0,17.8,31,22,20,9,2,17,38,44.7,21,17,8,9,27,58,38,0,Matches,2023-2024,Ligue-1
Bilal Nadir,ma MAR,"MF,FW",Marseille,19.0,2003.0,1.3,4,3,2,2,0,1,2,50.0,1,0,0,0,2,6,2,0,Matches,2023-2024,Ligue-1
Mahamadou Nagida,cm CMR,DF,Rennes,18.0,2005.0,1.2,1,1,0,0,1,0,2,0.0,2,2,1,1,4,5,0,0,Matches,2023-2024,Ligue-1
Keito Nakamura,jp JPN,"FW,MF",Reims,23.0,2000.0,15.3,28,11,9,10,9,17,37,45.9,20,15,2,13,6,34,7,0,Matches,2023-2024,Ligue-1
Keylor Navas,cr CRC,GK,Paris S-G,36.0,1986.0,4.0,0,0,0,0,0,0,0,,0,0,0,0,0,0,2,0,Matches,2023-2024,Ligue-1
Youssouf Ndayishimiye,bi BDI,"MF,DF",Nice,24.0,1998.0,19.0,31,20,17,12,2,12,23,52.2,11,19,11,8,12,43,47,1,Matches,2023-2024,Ligue-1
Bassirou Ndiaye,sn SEN,FW,Lorient,21.0,2002.0,1.7,5,2,2,2,1,3,5,60.0,2,1,1,0,1,6,0,0,Matches,2023-2024,Ligue-1
Iliman Ndiaye,sn SEN,"FW,MF",Marseille,23.0,2000.0,18.0,21,18,5,11,5,11,29,37.9,18,14,2,12,6,27,6,0,Matches,2023-2024,Ligue-1
Massamba Ndiaye,sn SEN,GK,Clermont Foot,21.0,2001.0,4.0,0,0,0,0,0,0,0,,0,0,0,0,0,0,2,0,Matches,2023-2024,Ligue-1
Rassoul Ndiaye,sn SEN,"MF,FW",Le Havre,21.0,2001.0,5.8,25,17,8,16,1,12,24,50.0,12,2,1,1,4,29,5,0,Matches,2023-2024,Ligue-1
Cher Ndour,it ITA,MF,Paris S-G,19.0,2004.0,0.3,2,2,0,2,0,1,2,50.0,1,0,0,0,0,2,0,0,Matches,2023-2024,Ligue-1
Joseph Nduquidi,fr FRA,"MF,DF",Metz,18.0,2004.0,8.3,11,4,6,3,2,1,9,11.1,8,11,3,8,11,22,15,1,Matches,2023-2024,Ligue-1
Loïc Nego,hu HUN,"DF,MF",Le Havre,32.0,1991.0,17.3,37,26,21,12,4,18,30,60.0,12,12,2,10,16,53,17,0,Matches,2023-2024,Ligue-1
Steve Ngoura,fr FRA,"FW,MF",Le Havre,18.0,2005.0,2.5,2,1,1,1,0,1,4,25.0,3,0,0,0,0,2,3,0,Matches,2023-2024,Ligue-1
Shamar Nicholson,jm JAM,FW,Clermont Foot,26.0,1997.0,16.5,6,2,0,4,2,1,4,25.0,3,6,2,4,0,6,15,0,Matches,2023-2024,Ligue-1
Rasmus Nicolaisen,dk DEN,DF,Toulouse,26.0,1997.0,32.5,50,30,39,11,0,26,44,59.1,18,44,33,11,42,92,158,1,Matches,2023-2024,Ligue-1
Arnaud Nordin,fr FRA,"FW,MF",Montpellier,25.0,1998.0,13.8,12,6,3,5,4,6,16,37.5,10,11,0,11,2,14,10,0,Matches,2023-2024,Ligue-1
Ernest Nuamah,gh GHA,"FW,MF",Lyon,19.0,2003.0,20.4,28,14,18,6,4,12,38,31.6,26,15,1,14,8,36,9,0,Matches,2023-2024,Ligue-1
Gerzino Nyamsi,fr FRA,DF,Strasbourg,26.0,1997.0,12.1,18,14,13,5,0,12,18,66.7,6,19,11,8,10,28,43,0,Matches,2023-2024,Ligue-1
Rabby Nzingoula,cg CGO,"MF,FW",Strasbourg,17.0,2005.0,1.5,3,3,0,3,0,3,4,75.0,1,4,0,4,5,8,0,0,Matches,2023-2024,Ligue-1
Jake O'Brien,ie IRL,DF,Lyon,22.0,2001.0,26.3,22,16,16,5,1,14,20,70.0,6,23,18,5,12,34,98,1,Matches,2023-2024,Ligue-1
Florent Ogier,fr FRA,DF,Clermont Foot,34.0,1989.0,10.5,19,9,13,6,0,11,18,61.1,7,25,19,6,9,28,35,3,Matches,2023-2024,Ligue-1
Joseph Okumu,ke KEN,DF,Reims,26.0,1997.0,19.4,44,28,28,14,2,24,38,63.2,14,27,19,8,35,79,112,2,Matches,2023-2024,Ligue-1
Warmed Omari,km COM,DF,Rennes,23.0,2000.0,23.0,32,19,23,7,2,16,28,57.1,12,30,20,10,33,65,77,2,Matches,2023-2024,Ligue-1
Becir Omeragic,ch SUI,"DF,MF",Montpellier,21.0,2002.0,25.7,48,29,31,13,4,20,33,60.6,13,51,29,22,27,75,65,0,Matches,2023-2024,Ligue-1
Jean Onana,cm CMR,MF,Marseille,23.0,2000.0,6.3,23,14,6,14,3,13,25,52.0,12,10,2,8,11,34,11,1,Matches,2023-2024,Ligue-1
Royce Openda Owaga,ga GAB,FW,Lorient,21.0,2002.0,0.2,0,0,0,0,0,0,0,,0,0,0,0,0,0,0,0,Matches,2023-2024,Ligue-1
Christopher Operi,ci CIV,DF,Le Havre,26.0,1997.0,27.2,55,36,37,15,3,32,59,54.2,27,45,7,38,35,90,68,1,Matches,2023-2024,Ligue-1
Gift Orban,ng NGA,FW,Lyon,21.0,2002.0,5.3,4,3,0,1,3,1,4,25.0,3,2,0,2,1,5,2,1,Matches,2023-2024,Ligue-1
Kassoum Ouattara,fr FRA,"DF,FW",Monaco,18.0,2004.0,7.1,17,12,8,5,4,9,20,45.0,11,11,0,11,13,30,20,0,Matches,2023-2024,Ligue-1
Alexandre Oukidja,dz ALG,GK,Metz,35.0,1988.0,33.2,2,1,2,0,0,1,2,50.0,1,1,0,1,3,5,24,3,Matches,2023-2024,Ligue-1
Azzedine Ounahi,ma MAR,MF,Marseille,23.0,2000.0,13.4,25,11,9,14,2,11,32,34.4,21,6,1,5,11,36,8,0,Matches,2023-2024,Ligue-1
Adam Ounas,dz ALG,FW,Lille,26.0,1996.0,4.6,4,3,2,2,0,2,7,28.6,5,2,0,2,6,10,1,0,Matches,2023-2024,Ligue-1
Patrick Ouotro,ci CIV,FW,Strasbourg,17.0,2005.0,0.1,0,0,0,0,0,0,0,,0,0,0,0,0,0,0,0,Matches,2023-2024,Ligue-1
Pablo Pagis,fr FRA,MF,Lorient,20.0,2002.0,1.8,10,6,5,4,1,6,10,60.0,4,2,0,2,3,13,1,0,Matches,2023-2024,Ligue-1
Nicolas Pallois,fr FRA,DF,Nantes,35.0,1987.0,17.7,34,19,21,11,2,19,35,54.3,16,37,26,11,26,60,111,0,Matches,2023-2024,Ligue-1
Andy Pelmard,fr FRA,DF,Clermont Foot,23.0,2000.0,33.2,51,38,41,9,1,32,40,80.0,8,37,20,17,33,84,99,2,Matches,2023-2024,Ligue-1
Aurélien Pelon,fr FRA,DF,Lorient,19.0,2004.0,1.0,1,0,1,0,0,0,2,0.0,2,2,2,0,0,1,7,0,Matches,2023-2024,Ligue-1
Faris Pemi Moumbagna,cm CMR,FW,Marseille,23.0,2000.0,6.1,2,1,0,2,0,0,3,0.0,3,4,0,4,3,5,1,0,Matches,2023-2024,Ligue-1
Danilo Pereira,pt POR,DF,Paris S-G,31.0,1991.0,22.2,22,12,14,6,2,9,17,52.9,8,29,26,3,23,45,100,1,Matches,2023-2024,Ligue-1
Mathias Pereira Lage,pt POR,"FW,MF",Brest,26.0,1996.0,13.2,21,15,7,8,6,7,28,25.0,21,14,5,9,10,31,13,0,Matches,2023-2024,Ligue-1
Romain Perraud,fr FRA,"DF,FW",Nice,25.0,1997.0,4.1,7,6,5,1,1,4,11,36.4,7,4,0,4,6,13,15,1,Matches,2023-2024,Ligue-1
Lucas Perrin,fr FRA,DF,Strasbourg,24.0,1998.0,30.3,47,30,33,14,0,28,46,60.9,18,45,32,13,28,75,113,0,Matches,2023-2024,Ligue-1
Denis Petrić,rs SRB,GK,Nantes,35.0,1988.0,0.3,0,0,0,0,0,0,0,,0,0,0,0,0,0,0,0,Matches,2023-2024,Ligue-1
Ronaël Pierre-Gabriel,fr FRA,DF,Nantes,25.0,1998.0,6.6,15,9,12,2,1,5,7,71.4,2,13,4,9,8,23,25,0,Matches,2023-2024,Ligue-1
Julien Ponceau,fr FRA,MF,Lorient,22.0,2000.0,24.9,32,15,12,14,6,9,30,30.0,21,22,1,21,19,51,20,0,Matches,2023-2024,Ligue-1
Sanjin Prcić,ba BIH,MF,Strasbourg,29.0,1993.0,1.0,0,0,0,0,0,0,1,0.0,1,2,1,1,3,3,1,0,Matches,2023-2024,Ligue-1
Gonçalo Ramos,pt POR,FW,Paris S-G,22.0,2001.0,15.8,25,15,4,12,9,6,20,30.0,14,12,2,10,5,30,16,0,Matches,2023-2024,Ligue-1
Elba Rashani,xk KVX,"MF,FW",Clermont Foot,30.0,1993.0,13.1,30,18,4,17,9,11,24,45.8,13,17,3,14,12,42,15,0,Matches,2023-2024,Ligue-1
Guillaume Restes,fr FRA,GK,Toulouse,18.0,2005.0,34.0,0,0,0,0,0,0,3,0.0,3,0,0,0,0,0,19,1,Matches,2023-2024,Ligue-1
Alexsandro Ribeiro,br BRA,DF,Lille,23.0,1999.0,24.7,32,22,24,8,0,16,31,51.6,15,25,15,10,35,67,116,5,Matches,2023-2024,Ligue-1
Amir Richardson,ma MAR,MF,Reims,21.0,2002.0,15.0,33,23,12,18,3,10,22,45.5,12,26,5,21,15,48,30,0,Matches,2023-2024,Ligue-1
Fabian Rieder,ch SUI,MF,Rennes,21.0,2002.0,4.1,13,7,2,9,2,6,11,54.5,5,3,1,2,5,18,2,0,Matches,2023-2024,Ligue-1
Rémy Riou,fr FRA,GK,Lyon,35.0,1987.0,3.0,0,0,0,0,0,0,1,0.0,1,0,0,0,0,0,1,1,Matches,2023-2024,Ligue-1
Valentin Rongier,fr FRA,MF,Marseille,28.0,1994.0,9.5,23,12,9,12,2,14,26,53.8,12,16,4,12,15,38,18,0,Matches,2023-2024,Ligue-1
Pablo Rosario,nl NED,"MF,DF",Nice,26.0,1997.0,22.3,36,25,15,16,5,23,34,67.6,11,27,13,14,29,65,39,0,Matches,2023-2024,Ligue-1
Valentin Rosier,fr FRA,"DF,MF",Nice,26.0,1996.0,0.6,1,0,1,0,0,0,0,,0,1,0,1,2,3,5,0,Matches,2023-2024,Ligue-1
Fabián Ruiz Peña,es ESP,MF,Paris S-G,27.0,1996.0,13.3,34,23,17,14,3,23,42,54.8,19,8,2,6,11,45,21,2,Matches,2023-2024,Ligue-1
Emmanuel Sabbi,us USA,"FW,MF",Le Havre,25.0,1997.0,17.6,38,19,15,15,8,16,39,41.0,23,26,2,24,19,57,7,0,Matches,2023-2024,Ligue-1
Falaye Sacko,ml MLI,DF,Montpellier,28.0,1995.0,15.4,28,16,13,10,5,21,32,65.6,11,19,7,12,24,52,37,0,Matches,2023-2024,Ligue-1
Modibo Sagnan,ml MLI,DF,Montpellier,24.0,1999.0,11.7,34,22,23,9,2,15,25,60.0,10,13,9,4,15,49,67,0,Matches,2023-2024,Ligue-1
Wesley Saïd,fr FRA,"FW,MF",Lens,28.0,1995.0,11.3,8,4,1,2,5,2,9,22.2,7,4,0,4,4,12,3,0,Matches,2023-2024,Ligue-1
Théo Sainte-Luce,fr FRA,DF,Montpellier,24.0,1998.0,3.8,17,7,10,6,1,11,19,57.9,8,9,4,5,3,20,15,0,Matches,2023-2024,Ligue-1
Mamadou Sakho,fr FRA,DF,Montpellier,33.0,1990.0,0.1,1,1,1,0,0,1,1,100.0,0,0,0,0,0,1,1,0,Matches,2023-2024,Ligue-1
Ibrahim Salah,ma MAR,"FW,MF",Rennes,21.0,2001.0,5.8,15,7,5,6,4,11,18,61.1,7,4,0,4,10,25,5,0,Matches,2023-2024,Ligue-1
Amine Salama,fr FRA,FW,Reims,23.0,2000.0,3.5,0,0,0,0,0,0,0,,0,1,0,1,1,1,1,0,Matches,2023-2024,Ligue-1
Mohammed Salisu,gh GHA,DF,Monaco,24.0,1999.0,11.5,27,12,11,13,3,17,26,65.4,9,21,12,9,22,49,44,0,Matches,2023-2024,Ligue-1
Yoann Salmier,gf GUF,DF,Le Havre,30.0,1992.0,17.4,22,10,13,6,3,13,20,65.0,7,21,15,6,21,43,57,0,Matches,2023-2024,Ligue-1
Mama Samba Baldé,gw GNB,"FW,MF",Lyon,27.0,1995.0,6.1,8,5,1,2,5,3,9,33.3,6,0,0,0,3,11,1,1,Matches,2023-2024,Ligue-1
Brice Samba,fr FRA,GK,Lens,29.0,1994.0,33.0,1,1,1,0,0,1,1,100.0,0,0,0,0,0,1,10,3,Matches,2023-2024,Ligue-1
Ibou Sané,sn SEN,"MF,FW",Metz,18.0,2005.0,1.4,6,4,2,1,3,2,2,100.0,0,3,0,3,1,7,2,0,Matches,2023-2024,Ligue-1
Sadibou Sané,sn SEN,DF,Metz,19.0,2004.0,9.4,19,12,16,2,1,6,7,85.7,1,14,9,5,8,27,64,0,Matches,2023-2024,Ligue-1
Arouna Sangante,sn SEN,DF,Le Havre,21.0,2002.0,29.9,53,33,27,23,3,24,40,60.0,16,35,18,17,66,119,93,2,Matches,2023-2024,Ligue-1
Morgan Sanson,fr FRA,MF,Nice,28.0,1994.0,21.8,26,19,12,7,7,12,31,38.7,19,34,5,29,20,46,16,0,Matches,2023-2024,Ligue-1
Baptiste Santamaria,fr FRA,MF,Rennes,28.0,1995.0,21.4,52,33,21,25,6,29,46,63.0,17,15,6,9,34,86,33,1,Matches,2023-2024,Ligue-1
Andrey Santos,br BRA,MF,Strasbourg,19.0,2004.0,9.2,29,18,15,13,1,17,26,65.4,9,8,0,8,10,39,11,1,Matches,2023-2024,Ligue-1
Tiago Santos,pt POR,DF,Lille,21.0,2002.0,26.3,63,42,31,19,13,30,52,57.7,22,24,5,19,15,78,37,0,Matches,2023-2024,Ligue-1
Amin Sarr,se SWE,"FW,MF",Lyon,22.0,2001.0,1.1,1,0,0,1,0,0,0,,0,1,0,1,0,1,1,0,Matches,2023-2024,Ligue-1
Ismaila Sarr,sn SEN,"FW,MF",Marseille,25.0,1998.0,16.1,14,8,2,10,2,6,17,35.3,11,21,6,15,13,27,11,0,Matches,2023-2024,Ligue-1
Mamadou Sarr,fr FRA,DF,Lyon,17.0,2005.0,0.1,0,0,0,0,0,0,0,,0,0,0,0,0,0,0,0,Matches,2023-2024,Ligue-1
Martin Satriano,uy URU,FW,Brest,22.0,2001.0,20.7,24,16,6,13,5,10,25,40.0,15,19,7,12,7,31,28,0,Matches,2023-2024,Ligue-1
Téji Savanier,fr FRA,MF,Montpellier,31.0,1991.0,30.7,37,20,16,15,6,14,63,22.2,49,36,8,28,33,70,28,1,Matches,2023-2024,Ligue-1
Niklas Schmidt,de GER,MF,Toulouse,25.0,1998.0,14.1,36,21,13,19,4,16,33,48.5,17,14,7,7,4,40,13,0,Matches,2023-2024,Ligue-1
Jérémy Sebas,mq MTQ,"FW,MF",Strasbourg,20.0,2003.0,4.4,7,1,2,3,2,3,5,60.0,2,3,1,2,1,8,1,0,Matches,2023-2024,Ligue-1
Alidu Seidu,gh GHA,DF,Rennes,23.0,2000.0,6.6,21,9,17,3,1,14,19,73.7,5,11,3,8,10,31,13,0,Matches,2023-2024,Ligue-1
Alidu Seidu,gh GHA,DF,Clermont Foot,23.0,2000.0,12.6,32,24,17,15,0,24,31,77.4,7,15,7,8,25,57,37,0,Matches,2023-2024,Ligue-1
Matz Sels,be BEL,GK,Strasbourg,31.0,1992.0,19.0,0,0,0,0,0,0,0,,0,2,0,2,0,0,13,1,Matches,2023-2024,Ligue-1
Marvin Senaya,tg TOG,"DF,MF",Strasbourg,22.0,2001.0,23.8,72,53,38,25,9,42,68,61.8,26,40,13,27,41,113,68,0,Matches,2023-2024,Ligue-1
Sofiane Sidi Ali,fr FRA,MF,Marseille,28.0,1995.0,0.2,2,0,0,2,0,1,2,50.0,1,1,0,1,2,4,0,0,Matches,2023-2024,Ligue-1
Vincent Sierro,ch SUI,MF,Toulouse,27.0,1995.0,25.1,41,24,15,20,6,27,77,35.1,50,37,13,24,27,68,33,0,Matches,2023-2024,Ligue-1
Caio Henrique Oliveira Silva,br BRA,DF,Monaco,26.0,1997.0,6.9,13,7,3,7,3,6,9,66.7,3,8,2,6,6,19,9,0,Matches,2023-2024,Ligue-1
Moses Simon,ng NGA,"FW,MF",Nantes,28.0,1995.0,19.9,7,5,2,5,0,2,8,25.0,6,9,1,8,3,10,5,1,Matches,2023-2024,Ligue-1
Wilfried Singo,ci CIV,DF,Monaco,22.0,2000.0,24.3,34,25,18,14,2,17,26,65.4,9,27,14,13,51,85,81,2,Matches,2023-2024,Ligue-1
Ayanda Sishuba,be BEL,"MF,FW",Lens,18.0,2005.0,0.7,3,1,0,2,1,1,2,50.0,1,1,0,1,0,3,0,0,Matches,2023-2024,Ligue-1
Ibrahima Sissoko,ml MLI,MF,Strasbourg,25.0,1997.0,18.2,47,33,13,25,9,23,30,76.7,7,21,8,13,19,66,30,0,Matches,2023-2024,Ligue-1
Moussa Sissoko,fr FRA,MF,Nantes,33.0,1989.0,20.2,27,16,13,8,6,12,25,48.0,13,8,2,6,12,39,31,0,Matches,2023-2024,Ligue-1
Milan Škriniar,sk SVK,DF,Paris S-G,28.0,1995.0,18.1,24,18,17,7,0,14,22,63.6,8,19,10,9,12,36,51,2,Matches,2023-2024,Ligue-1
Naatan Skyttä,fi FIN,"MF,FW",Toulouse,21.0,2002.0,1.3,4,4,2,1,1,1,1,100.0,0,0,0,0,0,4,0,0,Matches,2023-2024,Ligue-1
Eduard Sobol,ua UKR,DF,Strasbourg,28.0,1995.0,0.3,0,0,0,0,0,0,0,,0,0,0,0,0,0,1,0,Matches,2023-2024,Ligue-1
Emran Soglo,eng ENG,"MF,DF",Marseille,18.0,2005.0,1.2,2,1,0,2,0,1,3,33.3,2,6,0,6,1,3,3,0,Matches,2023-2024,Ligue-1
Carlos Soler,es ESP,"MF,DF",Paris S-G,26.0,1997.0,12.1,15,10,9,2,4,6,21,28.6,15,10,3,7,5,20,11,1,Matches,2023-2024,Ligue-1
Florian Sotoca,fr FRA,"MF,FW",Lens,32.0,1990.0,28.9,33,22,9,21,3,17,38,44.7,21,41,4,37,20,53,34,0,Matches,2023-2024,Ligue-1
Issa Soumaré,sn SEN,"FW,MF",Le Havre,22.0,2000.0,2.6,2,0,2,0,0,0,4,0.0,4,0,0,0,0,2,2,0,Matches,2023-2024,Ligue-1
Saidou Sow,gn GUI,DF,Strasbourg,21.0,2002.0,8.0,20,12,17,3,0,9,13,69.2,4,7,4,3,12,32,36,3,Matches,2023-2024,Ligue-1
Stijn Spierings,nl NED,MF,Toulouse,27.0,1996.0,16.8,53,40,26,20,7,29,52,55.8,23,22,5,17,26,79,32,0,Matches,2023-2024,Ligue-1
Stijn Spierings,nl NED,MF,Lens,27.0,1996.0,1.3,1,0,0,1,0,1,1,100.0,0,2,1,1,2,3,1,0,Matches,2023-2024,Ligue-1
Benjamin Stambouli,fr FRA,MF,Reims,32.0,1990.0,3.2,9,7,3,5,1,6,11,54.5,5,3,1,2,2,11,8,0,Matches,2023-2024,Ligue-1
Gabriel Suazo,cl CHI,DF,Toulouse,25.0,1997.0,26.2,66,32,40,19,7,38,86,44.2,48,37,4,33,26,92,33,0,Matches,2023-2024,Ligue-1
Abakar Sylla,ci CIV,DF,Strasbourg,20.0,2002.0,19.9,54,23,30,19,5,29,40,72.5,11,40,11,29,26,80,70,2,Matches,2023-2024,Ligue-1
Dembo Sylla,gn GUI,DF,Lorient,20.0,2002.0,0.5,1,1,0,1,0,0,0,,0,0,0,0,1,2,2,0,Matches,2023-2024,Ligue-1
Issiaga Sylla,gn GUI,"DF,FW",Montpellier,29.0,1994.0,16.2,28,17,20,6,2,16,34,47.1,18,21,7,14,23,51,53,0,Matches,2023-2024,Ligue-1
Musa Al-Taamari,jo JOR,FW,Montpellier,26.0,1997.0,21.4,20,16,10,5,5,9,21,42.9,12,18,2,16,4,24,5,0,Matches,2023-2024,Ligue-1
Nicolás Tagliafico,ar ARG,DF,Lyon,30.0,1992.0,23.6,54,34,23,22,9,22,49,44.9,27,25,8,17,28,82,43,0,Matches,2023-2024,Ligue-1
Montassar Talbi,tn TUN,DF,Lorient,25.0,1998.0,24.5,38,22,23,13,2,19,32,59.4,13,39,23,16,32,70,114,0,Matches,2023-2024,Ligue-1
Oussama Targhalline,ma MAR,MF,Le Havre,21.0,2002.0,11.4,23,11,16,7,0,15,25,60.0,10,9,3,6,20,43,14,2,Matches,2023-2024,Ligue-1
Enzo Tchato,cm CMR,DF,Montpellier,20.0,2002.0,12.5,26,17,18,4,4,11,25,44.0,14,20,7,13,11,37,25,0,Matches,2023-2024,Ligue-1
Arnau Tenas,es ESP,GK,Paris S-G,22.0,2001.0,5.9,0,0,0,0,0,0,0,,0,0,0,0,0,0,0,0,Matches,2023-2024,Ligue-1
Martin Terrier,fr FRA,"FW,MF",Rennes,26.0,1997.0,17.0,14,9,3,8,3,6,14,42.9,8,21,4,17,9,23,17,0,Matches,2023-2024,Ligue-1
Benjamin Tetteh,gh GHA,"FW,MF",Metz,26.0,1997.0,3.1,6,6,1,5,0,4,7,57.1,3,0,0,0,0,6,1,0,Matches,2023-2024,Ligue-1
Teddy Teuma,mt MLT,MF,Reims,29.0,1993.0,23.5,54,36,19,21,14,25,62,40.3,37,33,4,29,20,74,6,0,Matches,2023-2024,Ligue-1
Arthur Theate,be BEL,DF,Rennes,23.0,2000.0,25.5,30,17,19,6,5,24,37,64.9,13,40,23,17,31,61,90,2,Matches,2023-2024,Ligue-1
Adrien Thomasson,fr FRA,MF,Lens,29.0,1993.0,13.3,25,14,4,16,5,11,34,32.4,23,14,0,14,9,34,10,1,Matches,2023-2024,Ligue-1
Khéphren Thuram,fr FRA,MF,Nice,22.0,2001.0,23.4,42,29,13,23,6,20,40,50.0,20,21,10,11,18,60,37,0,Matches,2023-2024,Ligue-1
Cheikh Tidiane Sabaly,sn SEN,"FW,MF",Metz,24.0,1999.0,15.3,40,20,23,12,5,16,40,40.0,24,19,2,17,10,50,14,0,Matches,2023-2024,Ligue-1
Jean-Clair Todibo,fr FRA,DF,Nice,23.0,1999.0,29.5,58,28,35,17,6,34,56,60.7,22,34,15,19,38,96,97,1,Matches,2023-2024,Ligue-1
Corentin Tolisso,fr FRA,MF,Lyon,28.0,1994.0,19.3,33,21,13,11,9,14,33,42.4,19,26,9,17,10,43,18,0,Matches,2023-2024,Ligue-1
Abdoulaye Touré,gn GUI,MF,Le Havre,29.0,1994.0,25.4,47,28,22,22,3,30,60,50.0,30,30,8,22,25,72,33,0,Matches,2023-2024,Ligue-1
Souleymane Touré,fr FRA,DF,Lorient,20.0,2003.0,22.8,25,12,16,9,0,8,14,57.1,6,38,20,18,36,61,101,2,Matches,2023-2024,Ligue-1
Bénie Traoré,ci CIV,"FW,MF",Nantes,20.0,2002.0,5.6,8,4,2,5,1,3,7,42.9,4,3,0,3,1,9,1,0,Matches,2023-2024,Ligue-1
Daouda Traoré,fr FRA,MF,Nice,17.0,2006.0,0.2,0,0,0,0,0,0,0,,0,0,0,0,0,0,0,0,Matches,2023-2024,Ligue-1
Ismaël Traoré,ci CIV,DF,Metz,36.0,1986.0,24.7,19,12,13,6,0,8,21,38.1,13,33,20,13,30,49,86,0,Matches,2023-2024,Ligue-1
Adrien Truffert,fr FRA,DF,Rennes,21.0,2001.0,23.8,39,21,23,10,6,25,40,62.5,15,31,5,26,19,58,49,0,Matches,2023-2024,Ligue-1
Matthieu Udol,fr FRA,DF,Metz,27.0,1996.0,30.0,55,37,38,12,5,38,56,67.9,18,62,16,46,50,105,108,0,Matches,2023-2024,Ligue-1
Manuel Ugarte Ribeiro,uy URU,MF,Paris S-G,22.0,2001.0,21.5,98,57,39,43,16,43,89,48.3,46,27,6,21,40,138,25,2,Matches,2023-2024,Ligue-1
Samuel Umtiti,fr FRA,DF,Lille,29.0,1993.0,2.1,1,1,0,1,0,1,4,25.0,3,0,0,0,2,3,4,0,Matches,2023-2024,Ligue-1
Kévin Van Den Kerkhof,dz ALG,"FW,MF",Metz,27.0,1996.0,21.3,31,24,11,13,7,13,32,40.6,19,15,2,13,11,42,32,1,Matches,2023-2024,Ligue-1
Vanderson,br BRA,DF,Monaco,22.0,2001.0,18.2,60,41,20,30,10,32,70,45.7,38,29,2,27,35,95,37,1,Matches,2023-2024,Ligue-1
Jordan Veretout,fr FRA,MF,Marseille,30.0,1993.0,24.3,38,22,19,13,6,18,39,46.2,21,20,4,16,13,51,25,0,Matches,2023-2024,Ligue-1
Alan Virginius,fr FRA,FW,Lille,20.0,2003.0,0.8,1,1,1,0,0,0,1,0.0,1,0,0,0,0,1,0,0,Matches,2023-2024,Ligue-1
Alan Virginius,fr FRA,FW,Clermont Foot,20.0,2003.0,10.4,9,5,4,4,1,4,11,36.4,7,7,0,7,3,12,7,0,Matches,2023-2024,Ligue-1
Vitinha,pt POR,FW,Marseille,23.0,2000.0,10.3,14,8,3,5,6,3,12,25.0,9,11,2,9,5,19,8,0,Matches,2023-2024,Ligue-1
Vitinha,pt POR,MF,Paris S-G,23.0,2000.0,23.6,39,24,12,16,11,16,48,33.3,32,29,11,18,23,62,30,2,Matches,2023-2024,Ligue-1
Elye Wahi,fr FRA,FW,Montpellier,20.0,2003.0,0.2,0,0,0,0,0,0,0,,0,0,0,0,0,0,0,0,Matches,2023-2024,Ligue-1
Elye Wahi,fr FRA,FW,Lens,20.0,2003.0,18.8,6,4,1,3,2,2,10,20.0,8,5,1,4,3,9,3,0,Matches,2023-2024,Ligue-1
Mateusz Wieteska,pl POL,DF,Clermont Foot,26.0,1997.0,1.9,4,1,3,1,0,3,5,60.0,2,4,2,2,5,9,8,0,Matches,2023-2024,Ligue-1
Josh Wilson-Esbrand,eng ENG,"DF,MF",Reims,20.0,2002.0,5.1,5,4,2,3,0,2,8,25.0,6,5,2,3,6,11,7,0,Matches,2023-2024,Ligue-1
Christopher Wooh,cm CMR,DF,Rennes,21.0,2001.0,15.4,18,12,12,6,0,8,15,53.3,7,19,9,10,18,36,51,0,Matches,2023-2024,Ligue-1
Yusuf Yazıcı,tr TUR,"MF,FW",Lille,26.0,1997.0,14.6,19,11,6,9,4,4,15,26.7,11,10,1,9,5,24,5,0,Matches,2023-2024,Ligue-1
Kelvin Yeboah,it ITA,FW,Montpellier,23.0,2000.0,3.1,4,2,2,2,0,1,3,33.3,2,3,2,1,1,5,3,0,Matches,2023-2024,Ligue-1
Bertuğ Yıldırım,tr TUR,FW,Rennes,21.0,2002.0,5.2,7,5,2,3,2,3,8,37.5,5,8,0,8,0,7,4,0,Matches,2023-2024,Ligue-1
Darlin Yongwa,cm CMR,DF,Lorient,22.0,2000.0,12.9,30,23,17,11,2,14,25,56.0,11,14,2,12,15,45,36,0,Matches,2023-2024,Ligue-1
Leny Yoro,fr FRA,DF,Lille,17.0,2005.0,29.7,36,25,27,7,2,17,31,54.8,14,20,14,6,36,72,97,1,Matches,2023-2024,Ligue-1
Etienne Youte Kinkoue,fr FRA,DF,Le Havre,21.0,2002.0,21.6,15,9,13,2,0,7,11,63.6,4,21,16,5,44,59,104,0,Matches,2023-2024,Ligue-1
Yoram Zague,fr FRA,DF,Paris S-G,17.0,2006.0,4.1,18,8,11,4,3,11,24,45.8,13,3,0,3,4,22,9,1,Matches,2023-2024,Ligue-1
Warren Zaïre-Emery,fr FRA,"MF,DF",Paris S-G,17.0,2006.0,21.8,51,28,18,24,9,28,51,54.9,23,32,8,24,15,66,22,2,Matches,2023-2024,Ligue-1
Denis Zakaria,ch SUI,"MF,DF",Monaco,26.0,1996.0,23.7,38,27,11,20,7,12,30,40.0,18,39,13,26,47,85,41,0,Matches,2023-2024,Ligue-1
Mehdi Zeffane,dz ALG,"DF,MF",Clermont Foot,31.0,1992.0,13.7,31,20,17,11,3,17,34,50.0,17,14,3,11,16,47,34,0,Matches,2023-2024,Ligue-1
Nathan Zeze,fr FRA,DF,Nantes,18.0,2005.0,11.4,11,6,9,2,0,7,14,50.0,7,12,3,9,12,23,47,1,Matches,2023-2024,Ligue-1
Edon Zhegrova,xk KVX,FW,Lille,24.0,1999.0,25.4,32,18,9,15,8,14,36,38.9,22,17,1,16,8,40,8,0,Matches,2023-2024,Ligue-1
Luc Zogbé,ci CIV,DF,Brest,18.0,2005.0,0.1,0,0,0,0,0,0,1,0.0,1,1,1,0,1,1,0,0,Matches,2023-2024,Ligue-1
